Schlos Neuhaus Böhmen leben sechzehnt Jahrhundert -- Anfang siebzehnen -- alt reich Baron -- dermal Besitzer rosenbergisch Gut -- Tod Menge Enkeln Urenkel -- Vettern Schwäg teilen -- bemitteln -- 
  ungeachtet rechnet ableben alt Herr -- Baron liebt Sippschaft -- Kind sein -- hinwiederum Vater lieben -- 
  -- -- Witwer -- Herkommen -- allemal Osterzeit Neuhause Rosenberge Kind Schlos versammelt -- fröhlich Woche verleben beschenkt dannen ziehen -- 
  alt Burg fassen -- Baron Matthias reich bewirt begaben -- 
  Herr Matthias munterer jovialisch Herr -- Achtzige Freude lieben -- Kind -- wissen -- jeder fröhlich Fest -- Familie vorfiel -- Osterzeit versparen -- Schloß Neuhaus -- Auge gemeinschaftlich Vater feiern -- 
  binnen geboren Kind Familienbesuch gut Greis vorstellen -- 
  Jüngling -- Heer kommen Heer ziehen -- -- tragen Waffe -- Mann Familiennamen führen -- -- Baron Auge feierlich bewillkommt entlassen -- Verlobung Hochzeitfest feiern -- jung Vetter Muhmen Liebesbündnisse -- schreiben Osterbesuch -- Jünglinge Mädchen Familie sehen bekommen -- nirgend günstig Umstand treffen -- 
  alt Herr ungemein -- jung Zweig Stamme verflochten -- Feind anderweitig Verbindung -- 
  Trug Männlein Fräulein Haus Neigung würdigen Gegenstand -- Grenze Familie -- fremd Einkömmling herzlich willkommen -- brauchte weder Gut -- allzustreng Ahnenprobe auszustehen -- 
  Frau Sittsamkeit Tugend -- Mann Edelmut Tapferkeit hinlänglich Empfehlung Auge Baron -- -- Gericht streng Väter Mutter appellieren -- Schritt -- Folge -- 
  jung Fräulein -- Namens Bertha Neuhaus -- befinden diesmal Fall -- 
  alt Herr Grade verwanden -- leiben leiblich Enkel Urenkel -- 
  sowohl persönlich Vorzug geben blond Bertha Vorzug -- ungeachtet schön Mädchen -- Umstand -- eigentlich beitragen -- Glück danken -- 
  Mutter siebzehn klug Einfall -- Wochenbette Osterzeit -- Familienbesuchs -- Schloß Neuhaus aufschlagen -- 
  fest Mauer alt Herr Geburt Kind erhören -- 
  Freude Geschäftigkeit vergleichen -- setzen gut -- -- Kindlein Vater -- Pat schworen -- Knabe -- Kind Sohn erziehen -- 
  -- Fräulein -- vorteilhafen Schwor verlieren -- leiben wert -- zeigen Name Bertha -- -- Benennung -- Familie Alter sonderbar heilig Deutung -- 
  Bertha -- Baron Matthias -- Pate Liebling -- -- -- siebzehn -- verheiraten -- Wahl -- Fräulein mächtig hervorstechend Reiz -- wählen -- -- Liebe fallen Herr Beter wiegen -- Edelmann -- Adel kürzlich geendigt Religionskriege erkämpfen -- Seite Vermögen wünschen Eltern berthen zurückstand -- Seite Herkunft -- 
  jung Offizier -- Gewählte innig lieben -- besitzen böhmisch Grenze -- allenfalls fähig -- Bertha standesmäßig unterhalten -- Wunsch einschränken -- seinigen -- fortfuhr Wirtlichkeit Stille lieben -- 
  heiraten -- Gott Name -- alt Herr -- Sache zweifelnd Eltern Entscheidung vorlegen -- heiraen -- künftig Oster Hochzeit Burg -- 
  erwünscht Oster erscheinen -- 
  Fräulein Bertha Bräutigam halten Einzug Schloß -- Vermählungstag übermorgen ansetzen -- Nacht -- jung Held Ruhe -- Krankheit befallen -- Leben schnell -- 
  -- Vollendung Glück ansetzen -- schließen Auge ewig -- Bertha weinen verzweifelnd Bahr -- 
  verlieren -- lieb verwandte standswidrig Wahl verscherzen -- Hoffnung übrig -- -- obgleich unglücklich Gegenstand Zwist -- erlangen -- 
  Träne verblichener sünd -- höhnten -- Braut Witwenschleier verhülln -- 
  Baron Matthias Mitleid unglücklich Bertha -- -- elend Zukunft Kreis verwandte -- beschließen -- behalten -- 
  alt -- -- Gast sehen Schloß -- brauchen Haushälterin -- Hauswese versorgen -- brauch Gesellschafterin -- Gespräch kürzen -- Wein Becher schenken -- Krankheit pflegen -- Tod -- ben Wein -- Bertha schicken -- -- bleiben -- 
  Verwandtinn alt Herr Äusserung -- nämlich Dienst erbon -- bleiben Wahl -- Bertha bleiben Schlos -- Einsamkeit leiben -- Kummer suchen Raum -- heilend Träne ergießen -- finden -- Klage höhnten -- Flur Hain -- Wald Gebirge aufnahmen -- melancholisch Schloß engen -- 
  müssen -- gewöhnlich Gang -- Gram süß wohltuend Schwermut verwandeln -- fühlend Herz Freude tauschen -- 
  -- Fräulein Wunsch Baron schicken -- versammelt Base Schwägerinn -- Abschied allerlei -- Verhaltungsregel Zukunft -- Ohr raunen -- alt Herr hindern -- -- wissen -- deutungsvoll -- Not wissen -- -- -- Tod Fall -- erfahren -- 
  Bertha verstehen hören -- spitzfindig Grübeln frommen truglos Seele denken -- 
  beginnen einförmig Lebenslauf -- größtenteils Zimmer führen -- Mittag Abends -- Tafel gut Baron präsidieren -- Hintansetzung Kummer streben -- Laune Wein würzen -- 
  -- Wirtschaft bekümmern -- -- Baron -- versorgen -- kennen Hälfte Schloßgesindes -- zahlreich -- Besucher vollends -- 
  geschehen zuweilen -- munter Greis -- Achtzige merken beginnen -- alt -- Gesellschaft -- 
  Tafel beliebt benachbart Adel -- Stand ansehen -- Königreich behaupten -- Besuch Prag erhalten -- fürstlich Person einsprachen -- sittsam Bertha allemal Vergunst Zimmer bleiben -- Spinnrocke Sticknadel -- weniger Buch -- Fräulein lesen pflegen -- Laute Stunde geschwind vertreiben -- 
  Bertha Meisterin Instrument -- nützt böse Geist vertreiben -- Schmerz Podagra Baron -- braucht ähnlich Endzweck -- Einsamkeit Gram mächtig -- Bild verloren geliebter lebhaft Seele emporstieg -- 
  Abends -- Baron Gesellschaft -- Bertha einsamen Zimmer wechselsweise weint lautiert -- klopfen leise Finger Tür -- stehen öffnen -- sehen -- fein ältlich Frau stehen draußen -- gewohnt Freundlichkeit hereinnötigen -- erstenmal -- einsamen Spaziergang Schloßgarten -- weit Galerie Burg umher -- Matrone begegnen -- -- reinlich weiß Anzug -- Bund Schlüssel Seite -- Oberaufseherin wohlbestellt Wirtschaft Baron halten -- gegenseitig höflich Verbeugung erfolgen allemal -- sprechen -- 
  Matrone Gesicht berthen gefällig -- 
  Zug Alter sanft Schwermut Rest ehemalig Schönheit verwischen -- Kleidung äußerst simpel -- -- -- wissen -- Schnitt -- Art -- womit tragen -- zeigen -- beide altmodisch -- gemein Stande -- lassen denken -- Mann -- Baron -- gering Frau Haushofmeisterin wählen -- müssen Berthen Vorstellung unbekannte -- Tür stehen -- Herein nötigen -- 
  Fremd weigern -- Bertha Hand ergreifen -- Schwelle ziehen -- 
  O Umstand -- rufen -- Umstand -- lieb Frau nennen -- -- Bertha -- Fräulein -- 
  lieb Frau Bertha -- -- 
  -- euer Hand kalt -- Spiel -- hoffen -- herbei ziehen -- müßt Tür -- Zimmer hören -- 
  klopfen -- begehren Einlaß -- antworten lächelnd -- 
  -- zugedacht Besuch -- 
  willkommen -- 
  hoffen öfter sehen -- einsam -- Gesellschaft gut Matrone -- -- erwünscht -- 
  Frau Bertha lächelen -- stellen Stuhl -- deuten Laute -- Fräulein neu Ergriff spielen beginnen -- Stück halb endigen -- bewegen Besucherin Tür -- jung Namensschwester verbindlich Bewegung Hand -- verlassen Zimmer -- 
  dergleicher abgebrochen Besuche bekommen Fräulein fleißig -- groß Kummer -- sprechen -- Laute -- Matrone hören scheinen -- selten Stück auswarten -- müssen Hauptrolle spielen -- 
  jung Bertha sprechen -- glaubten Wirtschafterin verwandt Redseligkeit wünschen -- geschäftig Klirr schlüsseln -- allemal Ankunft verkündigen -- Schied -- allemal hörbar -- überredet Fräulein -- -- Geschwätziger -- -- alt Herr -- Eigenheit -- Verkehr Leute verwandte -- Besuch eigentlich Verstande heimlich abgestohlen -- Ursache -- Bertha Wort erwähnen -- 
  Matrone Fräulein leiben -- Laute herbeizulocken suchen -- mißmutig -- -- geschehen -- erscheinen -- stellen Stuhl Wand -- setzen -- unterbrach jung Bertha Spiel -- Frage -- meistens bloß Pantomime beantworten -- 
  -- artig -- Frau Bertha -- einerlei Name führen -- 
  Bewegung Hand -- sagen -- Ähnlichkeit Geschmack -- 
  euer Geschäft -- 
  sehen selten -- 
  leis Klirr schlüsseln -- Bejahung Sache -- 
  lassen fast -- euer besuch Heimlichkeit -- -- 
  Mund gelegt Zeigefinger -- bejaht Vermutung -- 
  -- schwermutsvoll Miene -- euer Farbe blaß -- glücklich -- 
  tief Seufzer -- Blick Himmel -- 
  einsmals fragt Fräulein -- tun -- 
  lieb Frau Bertha -- -- edl Anstand -- unmöglich gemein Person -- 
  geboren Rosenberg -- 
  O -- ahndet Herz -- schreien Bertha feurig -- erlauben -- verwandter umarme -- 
  Matrone treten -- 
  O zürnen -- 
  entziehen Vertraulichkeit -- -- kenn -- schenken -- 
  fragen -- wissen -- unser Haus gehören -- 
  Geschichte alt Herr Rosenberg seltsam -- erfahren -- 
  Frau Bertha ziehen Tür -- winken Fräulein -- folgen -- 
  Weg Menge schallend Galerie Flügel Schlosses -- jung Bertha unbekannt -- 
  stehen doppelt Flügeltür -- 
  Matrone suchen Bund Seite Schlüssel -- öffnen -- finden -- 
  drehen dreimal Schloß -- schlagen zwölf -- Kerze Hand Fräulein verlosch -- dick Finsternis -- 
  verdrußlich Zufall -- rufen -- beginnen -- 
  euer Hand -- Frau Rosenberg -- 
  Zweifel -- -- 
  strecken leitend Hand Hand arm Bertha -- entfernt Klirr Schlüssel -- Matrone entfernen -- 
  Bertha Unwiss verwandte -- enthalten lauter Äusserung -- 
  unhöflich -- -- Dunkel Rückweg tappen -- unhöflich ist_es -- Finsternis verlassen -- Licht gehen -- 
  Frau Bertha -- 
  Frau Bertha -- Eurer warten -- 
  antwortet Widerhall -- 
  Fräulein harren -- lassen einigemal Name Matrone ertönen -- ungeduldig -- helfen -- Schauer überfiel -- vermögen -- Zimmer -- 
  schlagen Eins -- erreichen -- zurückgelassen Kerze Verlöschen -- werfen eilig Kleid Bette -- 
  Spaziergange -- fragt Weile -- Pochen Herzen nachlassen -- 
  halten -- 
  fragt alt rosenbergisch Geschichte -- Bibliothek -- Archiv südlich Flügel Schlosses gehören -- Zweifel Schlüssel -- fatal Umstand verloschen Licht -- voll Befriedigung Neugier befinden -- glücken -- geschehen andermal -- 
  wiederkommen -- bitte erneuern -- Unwille merken lassen -- erzürn -- 
  Bertha schliefr -- verträumt Nacht Bild alt Manuskript -- Vorstellung selten unerhört Geschichte -- besonderer Freundin -- 
  tages harrt abendstund -- Matrone erscheinen pflegen -- Laute -- singen -- psalmodiert künstlichsen -- leis Klopfen gehören -- Besuch lassen sehen -- 
  -- drauf folgend -- Winkel Garten -- Schloß durchstrichen -- rosenbergisch Frau Muhme begegnen -- lassen sehen -- denken -- Baron Hauswesen Aufseherin geben -- wissen -- dergleich Änderung -- Herr Diener Schloß Neuhaus -- Tod trennen -- 
  Gedanke -- Matrone können krank -- fragen -- wissen -- Bekanntschaft Person dürfen merken lassen -- Besuch -- beherzigen -- Verstohlen Geheimnisvoll -- 
  begnügt Frage -- Burg krank -- fühlt Antwort -- -- befriedigen -- 
  anderer Wunsch beunruhigt gedoppelt Stärke -- Begierde Innerst Saal -- Tür Matrone Nächten führen -- 
  -- -- angefangen Werk ausführen -- sehen abhalten -- Befriedigung Verlangen Baron erbitten -- 
  Oheim -- tags drauf -- Mahlzeit Wein fröhlich -- 
  Solltet glauben -- euer Bertha Zeit Weile -- 
  -- Kind -- 
  deinen Zeitvertreib -- Spinnrocke -- Nadel Buch -- 
  -- Phönix -- erhalten -- 
  -- Lücke Beschäftigung -- 
  all Flachs versponnen -- all Tapetenarbeit geendigen -- all Buch Mal hindurch lesen -- Gedulde -- Fest Tür -- diesmal fehlen -- -- gegenwärtig Dame unser Haus -- schlechterding Wirtin mußt -- Abänderung Einförmigkeit dein Leben bringen -- -- -- Oheim -- hass Gesellschaft -- sehen -- 
  Gast fallen -- alt Freund -- arme -- 
  Bertha wissen -- ehrwürdig verwandte arme Mahlzeit -- jedesmal rosenbergisch Dame Wirtin präsidieren -- Sache gefiel -- Rolle wünschen -- danken Oheim tief Verbeugung zugedacht Ehre -- eigentlich Punkt -- wohin Gedanke meister lenken -- 
  wünscht Vertreibung vorgeschützt Langeweile Zutritt rosenbergischen Archiv -- wagen Kühnlich -- bitten -- ansehen -- Hüterin Schlüssel -- erregt Neugier vergessen -- 
  Baron lacht Begehren -- 
  Schade -- -- Knabe -- Mönch verderben -- Staube alt Manuskript wühlest -- 
  Schlüssel -- Freude versagen -- Haus kennen -- entsprossen -- 
  Verwirrung finden -- letzter Mal -- Familiennachricht suchen -- Schrecken aufgejagt -- könntest Geist Ordnung -- -- Pergamente übertragen -- danken -- tun Gefallen -- arbeiten Mittagsstunde -- weißt -- Mahlzeit verschieben lassen -- nachts -- Feuersgefahr -- 
  übrig Stunde sicher -- tun fällen -- 
  Bertha verstehen Hälfte -- Oheim -- vermutlich Meinung -- verstehen -- deutlich sprechen -- 
  Schlüssel -- küssen Hand Greises -- hüpfn -- 
  Sachte -- sachen -- Bertha -- rufen -- zurecht finden -- Büchersaal Gegend Burg -- -- 
  Nimm Leute -- einer -- gehen südlich Nebenkabinett -- -- Gelegenheit nehmen -- deinen gelehrt Arbeit besuchen -- 
  Bertha -- stehen bleiben -- antwortet Verbeugung verschwinden -- 
  Leute -- Ort zurecht finden -- -- Oheim meinen -- erstenmal Betrat -- 
  wunderen -- äußerer Tür säle Galerie -- müssen -- Nacht -- verschlossen finden -- Schlüssel eröffnen jeder Schloß -- stehen doppelt Flügeltür -- zwölfen Glockenschall Kerze verlosch -- rosenbergisch Matrone Händen -- Neugier täuschen -- 
  schließen -- Saal öffnen -- geräumig Anzahl Buch -- Wände aufstellen -- Name Bibliothek -- Ausdruck Zeit bedienen -- Librarey geben -- hundert Band damalig Zeit Sammlung Edelmann -- Abt zufrieden -- 
  neugierig Bertha werfen Auge Vehikel Weisheit Torheit Jahrhundert -- eilt Tisch Eibenholz gedreht Säule -- Mitte stehen -- -- Baron -- auftürmen finden -- Familienkunder gehören -- -- Wille Greise -- fein ordentlich vergoldet Wandschränk legen -- Tür stehen -- nehmen -- 
  Oheim eilig -- Zimmer zuletzt verlassen -- Bertha -- silbern Leuchter Erde aufhieben -- fallen -- 
  Unordnung -- Staub -- scheinen -- 
  Haushälterin Schlüssel -- Schlos herum -- Rost öffnen vermögen -- 
  Bertha beginnen Pergament wühlen -- endlos Arbeit -- Vergnügen gewähren -- stoßen Anfangs alt Stammbaum -- Schenkungsbrief -- Vertrag -- Kontrakt -- Menge Ding -- sicher Beleg Reichtum Adel Haus -- sonderlich interessieren -- 
  Nahrung Neugier suchen -- Schoß Amm sonderbaren Geschichte alt Herr Rosenberg gehören -- erfahren -- täuschen -- übertragen Amt -- rosenbergisch Archivarin augenblicklich aufgeben -- Oheim -- Einfall spottet -- schämen -- 
  -- fassen Entschluß -- Stück Stück mustern ordnen -- rüstig an Werk -- 
  dauern Arbeit -- übernehmen -- Baron sicher -- verboten Stunde Librarey finden -- 
  finden -- suchen -- emsig -- 
  Baron fragt Fortgang Geschäft -- lachen herzlich -- Unzufriedenheit merken -- 
  aufbehalen -- gut Genug leisten -- 
  Vormittag arbeiten -- verdrußlichen Arbeit quiten -- 
  golden Wandschränk füllen wohlgeordnet urkunden -- Tisch leer -- stoßen dicht beschrieben Blatt -- minder enthalten -- berufen Mähr -- kurz heutig Welt Name Geschichte Grafen Rosenberg an Licht stellen -- erzählt umständlich Abenteuer alt Familienschloß Böhmewalde -- fesselen aufgeregt Phantasie Fräulein -- erstenmal vergessen -- Mittag -- Tafel warten -- 
  schlagen zwölf -- Tür -- hereinkommen -- -- emsig Geschichteforscherin Höhe -- rosenbergisch Haushälterin -- eintreten -- streichen eilig Saal vorbei südlich Kabinett -- 
  O Frau Bertha -- schrie Fräulein -- Aufsprang -- zugehen -- sehen -- 
  Fürwahr glauben -- Matrone lassen ausreden -- 
  zwölf schlagen -- -- Türe deuten -- 
  gebietend Winke -- jung Bertha augenblicklich gehorchen -- Verbeugung -- nämlich Augenblick äußern Tür hinaus -- Frau Base innerer Verschwand -- 
  Zugwind Pfiff -- Tür Hand reißen -- krachend zuschließen -- 
  bestürzt -- wissen -- langen Tafelzimmer -- 
  Baron -- Stuhl stehen -- dampfend Schüssel entgegen -- drohen aufgehoben Finger -- -- warten lassen -- 
  Leute begegnen -- fahren fort -- schicken -- 
  Haushälterin -- Oheim -- 
  Haushälterin -- 
  Meinst -- 
  ansehnlich ehrbar Frau Schlüsseln -- -- glauben -- Rosenberg -- 
  Baron bleich -- klirrt Löffel Teller -- 
  nah Base -- fahren Fräulein fort -- -- Ausgeberin -- 
  bekümmeren ordentlich -- Tafel -- Stelle gebühren -- 
  Bertha -- gehören -- Ding urteilen -- verstehen -- 
  Bertha schweigen erröten -- Baron sprechen Mahlzeit Wort -- still Nachdenkend -- 
  erheben -- fordern Fräulein Schlüssel Bibliothek -- 
  -- Oheim -- bitten -- hoffen fertig -- 
  Mädchen -- 
  Mädchen -- erwidern -- Ding treiben -- begegnen -- gönnen -- 
  Hüte Nacht -- 
  -- Neugier lebhaft reizen -- Zimmer nehmen -- 
  Bertha gehorchen -- 
  furchtbar Geschichte abenteuerlich Schloß Garten -- lesen Nachmittag Abendmahlzeit -- diesmal -- Gast vorhanden -- Zimmer halten -- 
  Rest endigen -- -- Manuskript Ort Stelle bringen -- 
  schönsten längsten -- Licht Hand hell Dämmerung fast unnötig -- dennoch lassen brennen -- setzen Tisch Bibliothek -- nützen -- Hin- herwerfen übrig Papier finden -- aufmerksam -- Wachskerz -- Eintritt Saal Boden finden -- Anzuzünd -- zunehmend Finsternis heller Licht -- 
  -- fesselt Aufmerksamkeit -- stehend lesen -- Entschluß -- Endigung nächster Abschnitt entfernen -- bequem -- setzen Armstuhl -- schnäuzen sämtlich Kerze -- Las Las Aufhör -- Gestirn Horizont herauf -- Nähe Mitternacht verkündigen -- 
  Bertha finden Nahrung Geist Fabel -- Nachmittag beschäftigen -- 
  Kindheit -- abergläubigen Zeitalter trotz -- mährchen gehören -- gänzlich Unbekanntschaft Ideenwelt -- gänzlich Furchtlosigkeit Ereignissen -- beleben -- -- nachdenken -- Schauer erregen -- 
  Geprag Fabel tragen -- behagen -- Phantasie Stunde fesseln -- 
  finden Wahrheit -- 
  Blatt -- -- enthielt Geschichte alt Herr Rosenberg -- nötigen -- Leser Folge Wille nuce mitteilen -- freilich kraftvoll Sprache Chronikon -- jung Bertha -- unser Zeit Stande -- verstehen -- Schönheit schätzen -- Fräulein schätzen -- -- körnigter Rührender lesen Seite -- 
  Wilhelm Ulrich Rosenberg -- laut Legende -- Zeit Kaiser Wenzel -- Ruprecht Siegmunds -- Mann -- Königreich Böhmen Aufsehen -- Reichtum -- Weisheit -- Tapferkeit all Beherrscher deutsch Reich lieben Diener -- 
  schenken borgen -- helfen Gerechtigkeit reformieren -- ziehen wider Erbfeind -- Türke -- 
  Herr Ulrich wacker -- weidlich Mann -- gefiel schön Aussenseit Dame -- Mann tadellos Innere -- 
  schön vornehmst Jungfraue hing Blick -- hoffen wählen -- Wunsch -- Frau Rosenberg heißen -- Zittern fühlen -- Ulrich Gemahlinn weissagen -- bewunderrinner tragen sonderlich verlangen -- -- 
  Wilhelm Ulrich hoch Adel -- fürstlich Reichtum -- besitzen -- stolz -- Fürstengunst Kriegsglück ziemlich kühn -- 
  dachen Auge gemein Person werfen -- ausgezeichnet Schönheit -- Liebe wecken -- Hoheit fürstlich Rang -- künftig Gemahlin wünschen -- geschehen -- Gemahl Prinzessinn -- 
  Liebe schön Oligarde Braunschweig -- Gemahlin -- Glück -- Seite genießen -- berechtigen Tod -- erfolgen -- niedrig wählen -- 
  Brandenburgisches -- Baadensch Bernstädtisch Fräulein Nachfolgerinnen -- Tod brechen lieblich Blume frisch hinweg -- Herr Ulrich Weibernehmens gewohnen -- Wahl Gemahlin schier Sorge -- Wahl Rüstung -- 
  letzter Wahl kühn glücklich -- 
  Fräulein Mathilde Bernstädt -- Enkelin Kaiser Siegmunds -- Engel Schönheit Tugend -- alternd Herr Rosenberg fast jung -- 
  treten Hochzeitstage siebzehnt -- freilich ziemlich Wahrscheinlichkeit mutmaßen -- letzter -- Herr Ulrich Altar begleiten -- einst Witwe Grab weinen -- 
  Wahrscheinlichkeit täuschen -- vierjährig glücklich Ehestand Opfer Tod -- sterben -- Tochter Leben -- Verlust -- fühlen -- doppelt verwaist -- 
  Herr Rosenberg halten -- fünftenmal frei -- ewig Trauer reizvoll Gemahlin ergeben -- 
  Ehrgeiz Liebe -- verbinden -- zerrissen Band schmerzt Ursache -- 
  kaiserlich Verwandtschaft Hoffnung -- Fürstenstand empor schwingen -- abgestorben -- müssen Ehre begnügen -- kaiserlich Feldherr Oberburggraf Böhmen bleiben -- 
  Unmut -- Mitte Laufbahn stehen bleiben sollen -- Satansengel -- -- -- -- Skorpione geißelen -- 
  Burg Hölle -- müssen hinaus Feld -- Geräusch Waffe gescheitert Entwurf -- vergessen -- 
  Bertha -- Mathild traurig Vermächtnis -- halten Landen -- liebt Mutter lieben -- 
  zart Fräulein Bedenken Hand Burgvoigts überlassen -- Geratewohl Anheim stellen -- vernachlässigt Zucht -- Eltern Geschwister -- schier Väter Mutter -- nehmen -- hülflos Waise Schutz nehmen -- 
  vermählt Schwester -- Herr Heinrich Rosenberg -- ältest Bruder -- teilen Sorge -- Schutz wachsen Vollkommenheit heran -- Folge Bewunderung ziehen -- unglücklich Schicksal Gegenstand Mitleids -- 
  Fräulein Bertha lesen -- inne -- Schrift ändern -- Erzählung Person fortsetzen -- 
  Schriftzug schön -- ungemein klein -- schnäuzen Licht -- hell sehen -- 
  umh schaut -- gewahr -- draußen dick Nacht Rabenfittich ausbreiten -- Schloßuhr schlagen halb -- Gedanke Warnung Baron -- übernachten -- fliegen Sinn -- fassen Deutung -- denken bloß Feuersgefahr -- treffen nötig Vorkehrung -- Fall -- Lese entschlummern -- besorgen -- 
  Schlaf denken -- Heldin Geschichte -- interessiert -- Feder ergreifen -- rührendst Ton Leiden sprechen -- einst erduldet -- Jahrhundert überstand -- still Denkerin Stoff Gefühl Betrachtung geben -- beschreiben lassen -- 
  Schwärmerin Bertha fast zweihunderen rührend vorkommen -- gefühlvoll Träne entlocken -- gleiten verändert Ausdrück Herz heutig Leser -- kühlend Wasser -- -- 
  Anspruch Märchenerzähler klein -- befremden dürfen -- 
  Tochter Oberburggrafen Böhmen knüpft Fade Erzählung folgendermaßen Stelle -- Vorgänger endigen -- 
  Gegenstand Mitleiden -- 
  -- Trauriger Vorzug -- Anlage -- Glück Geburt -- hoffen -- entgegengesetzt Empfindung erregen -- 
  Urenkelin Kaisers -- Tochter Eltern -- Schwester Geschwister meinigen -- Aussicht -- -- täuschen täuschen -- 
  Vater fallen Feind -- ehe Mal Glück -- Knie umarmen -- 
  Kind -- hinterlassen -- zahlreich -- Vermögen -- fallen -- Verhältnis unser Stand mittelmäßig -- zahlreich fürstlich Heirat -- Aufwand Hofe Feld schwächen -- 
  Eltervater Kaiser Tod -- mütterlich verwandte -- rosenbergisch Heirat zufrieden -- achteten -- Stelle Hofe -- gebühren -- Dunkelheit düstern Waldschlosses einschränken -- täglich vorsagt -- arm Fräulein -- Wahl Kloster -- 
  Frühlingstag schön -- -- -- traurigen Rest ehemalig Reiz gleichgültig -- gewahr -- 
  Anlage hoch Mut Frohsinn Seele vorhanden -- all Vorzug verheert Hand Unglücks -- ehe voll Blüte kommen -- 
  Trübsinn der -- umgaben -- traurig Licht -- unablässig Schicksal vorstellen -- rauben Hang Freude -- schwermütigen Träumerin -- 
  Gram loszureissen -- beschäftigen Studie -- Geschlecht -- finster Mystik -- Erlernung tot Sprache -- Zeitvertreib Einsamkeit -- bringen vollends Bestimmung -- 
  taugt Kloster -- Begriff -- Schleier nehmen -- wider Wille Gemahlin Freiherrn Lichtenstein -- 
  reich Herr -- hoch Abkunft -- Schimmer Schönheit -- Zwanzigst besitzen -- Wahl bestimmen -- 
  glänzend Sphär öffnet -- Vorzüge Freude genießen -- fähig -- 
  glücklich -- Glück -- begegnen -- eher betreffen -- Erwartung erziehen -- einst -- 
  O Gott -- 
  glücklich -- klösterlich Eigensinn -- Einsamkeit angewöhnen -- Abzulege vermochen -- 
  Gemahl liebenswürdig -- lieben -- vielmehr -- Zuneigung -- ersiegen -- düstr Hülle -- umgeben -- Anging -- 
  -- glücklich -- leuchten -- spät -- 
  verlassen lieben -- 
  zürnen -- zürnen unversöhnlich -- -- wiederkehren -- Fuß Vergebung flehen -- stolz verlassen -- Zuflucht arme Bruder suchen -- -- 
  O Gott -- 
  Richter -- 
  richten -- 
  sterben -- 
  Gemahl sterben -- 
  Welt flucht Andenken -- vergehen -- 
  fluchen -- 
  wissen -- schuldig Vergehung -- 
  Reue -- bittersen Selbstvorwurf -- halb Verzweiflung Tod -- Meinig -- 
  Leserin Träne übermochen -- vermögen Schrift lesen -- richten -- Licht hell brennen -- 
  stehen rosenbergisch Matron geschlagen arme -- starr geheftetem Blick -- 
  Fräulein -- Schrecken Gesellschaft sehen -- strecken Arm -- Hand fassen -- schluchzen -- 
  Bas -- 
  les Ding -- 
  Urteil -- antworten -- 
  Urteil -- -- 
  -- Geschichte neu -- wissen -- unschuldigst Büsserin -- geben -- aufgezeichnen -- 
  Lichtenberg Böswicht -- Bertha Rosenberg duldend Heilige -- -- -- fließen Träne -- nämlich Wort -- Sage rosenbergisch Matrone lateinisch Sprache -- Mund legen -- geübt -- Sprache Land -- 
  unaussprechlich Blick schlagen Matrone Auge gen Himmel -- 
  -- leise -- -- tote Lebendig richten -- wissen -- Gericht bevorstehen -- 
  gnädig Gericht -- Bertha -- schuldlos -- euer Namensschwester -- Geschichte lesen -- 
  lassen laut vollenden -- Wort -- denken -- wichtig -- 
  erfolgt Antwort -- Leserin fahren fort -- -- 
  bleiben gebeugt Gewissensbisse zernagt Herz Linderung übrig -- Wohltun -- 
  reich -- Hang geben beglücken -- Fessel anlegen müssen -- frei Lauf lassen -- 
  Herz -- Reichtümer achten -- geben allzu -- fühlen -- schwerer Pflicht -- 
  unmündig Kind Schwester erziehen -- schön Heranwachse Tugend Glück -- -- einzig Freude -- tränenvolel Leben -- 
  baut Schloß -- 
  Umwohner -- Untertan -- dient -- schwer Bau -- lieben -- denken -- drücken -- hart -- 
  Fest -- Andenken geendet Arbeit stiftet -- Nachkomme meinigen ewig Zeit genießen -- hören Fluch -- hören Segen Mund ertönen -- 
  gut Leute bat -- Andenken Tage abbilden lassen -- halb Witwentracht -- beständig Kleidung -- umherging -- Brot austeilen -- 
  gewillfahren -- hoffen -- Eitelkeit -- irren -- Spreu Weizen sondern -- 
  -- Bild finden südlich Saal Morgenseit -- 
  Bild -- schreien Bertha -- 
  -- Bild -- -- sehen -- 
  O -- Base -- Zweifel sagen -- -- 
  -- 
  Zuhörerin leise entfernen -- 
  Bertha rufen Mal Name Namensschwester -- erheben -- Antwort erfolgen -- Licht -- ausgehen -- umzuseh -- Neugier rege -- Kontrefey heilig -- 
  südlich Saal -- -- finden -- 
  brechen Fenster -- 
  Hinweg Kerze -- nützen -- 
  -- Nacht scheiden -- -- laut alt Sage -- Geistererscheinung günstig schwarz Mitternachtstund -- 
  furchtlos Bertha -- Nacht scheuen -- fühlt grauen -- gesollen -- Phantasie Gespensterideen einheimisch -- erfahren glauben -- gemein Sag Ding begünstigen -- 
  Bertha Fenstergardin zurückziehen -- rötlichen Morgenlicht Wand Saal genau betrachten -- -- Bild ähnlich -- stehen Tür südlich Kabinett -- Rückerinnerung -- Eintritt Oheim verbieten -- öffnen -- hinein -- 
  schnell umh geworfen Blick zeigen -- meinen -- tief Zimmer Freundin -- Matrone -- 
  freudig zueilen -- Näherkommen Bild Lebensgrösse -- Frau berthen voll Ähnlichkeit tragen -- täuschen sehen einer -- 
  Fräulein fühlen -- wissen -- Anblick Schauer -- 
  Augenblick -- lang Unwissenheit Wahrheit voll Licht Seele strahlen -- gegenwärtig -- 
  berthen Zittern vermehrt Sekunde Sekunde -- Mut -- Bild weiß Frau -- Schloß Neuhaus sehen -- nähern -- 
  -- Empfand -- vorurteilfreeisen Gemüt -- ihrig -- klein Fassung -- Vorstellung allerlei Möglichkeit schnell hinweg hauchen -- Frau Bertha Person -- schattenartig übergliten -- hohl unartikuliert Geisterstimm zutönen -- Bertha -- Kennst -- 
  müssen Zweifel schwinden -- hell -- wogegen blind -- 
  schreckensvoll Gefühl -- denken lassen -- übermochen -- sinken empfindungslos Bild weiß Frau Boden -- 
  Sonne völlig herauf -- Mittag heran -- Fräulein Schloß vermissen -- 
  Baron äußerst unruhig -- lieben sanft Bertha vollkommen -- verdienen -- 
  -- durchsuchen -- Nachricht Verlust zeitig schrecken -- 
  denken -- 
  Flucht Entführung auf Tapet bringen -- Unsinn -- eingezogen Bertha -- fast kennen -- entführen -- 
  arme Vater fliehen -- 
  hastig fragt alt Herr -- Librarey -- -- 
  -- 
  heilig bewahrt Schlüssel Ort Hand -- wagen Schloßgesind -- -- weiß Frau hauptsächlich Aus Eingang pflegen -- Gegend -- 
  Baron stellen schreckensvoll Möglichkeit -- Fräulein können Verbot ungeachtet verspätigen -- können zustoßen -- mehrere Tod bringen -- 
  Schloßgespenst sehen -- kennen -- gestrig Rede mutmaßen -- Folge -- -- 
  mehrere ätherisch Dame unversehens begegnen -- Unwissenheit Mutwille gering versahen -- Rache empfinden -- 
  Herr Peter Wocken -- berthen verblichen Bräutigam -- -- wissen Schloß -- obgleich -- Anblick weiß Frau -- Tod nehmen -- -- Hinterlassene nämlich begegnen -- 
  alt Herr rang Hand -- weint Kind mutmaßlich Schicksal liebenswürdig Nicht -- 
  Gewißheit verschaffen -- Verunglückt Hülfe leisten -- braucht -- verdächtig Ort verfügen -- Überwindung gehören hierzu -- 
  schloßgesind schaudert bloß Gedanke -- fürwahr -- Herr fühlt Lust -- Ort sehen -- wohin -- Leben Schloßgespenst sehen -- mutig verfügt -- unvermuten Anblick Schrecken Eile scheuchen -- Bertha Spur sehen -- 
  Liebe gut Fräulein überwand indessen Bedenklichkeit -- 
  Schloßkappellahn Kreuz treten -- folgen Baron -- Dienerschaft allerlei Wehr Waffe besorglich Angriff versehen -- 
  Dahint gelassen -- 
  Frau Bertha Laune -- befürchten lassen -- 
  nötig Weihwedel Reliquie sein Nachsucher arm Bertha Flasche starkriechend Essenz -- angebrannt Feder -- Lanzette Wundarzt -- Leben rufen -- 
  finden Zustande -- tote Ohnmächtig ähnlich -- furchtbar Bild ausstrecken -- 
  denken -- Hülfe liegen -- -- 
  Zwischenräume erholen -- schrecklich Bewußtlosigkeit sinken -- wissen -- -- bringen Zeichen Leben Zimmer ziemlich spät Abend -- Kunst Arzt Wundarzt bringen -- Baron beruhigen -- 
  -- -- matt sprechen -- minde Bewegung -- 
  Schwäche folgen Anfälle Phantasie -- Vorgäng vergangen Nacht ausreden -- hergebracht Sitt Geisterseher vertragen -- Hitze tun -- zurechnen -- Fehler Ding unerfahrenen Bertha ungestraft -- 
  Oheim sitzen Bette -- bewacht Anschein Besserung zärtlichst Ängstlichkeit -- -- völlig retten heißen -- hüten -- kühn Frage -- ähnlich -- gewärtig -- begünstigen -- 
  Nacht -- Bertha Wiedergenesen -- unbewacht schlafen -- Genoß -- Gesicht -- schlummernd Zofe -- Gesellschaft nötig halten -- vernehmen -- Freund mitteilen -- rosenbergisch Matrone stehen -- -- sehen -- sterblich halten -- 
  Bertha -- -- geschrecken -- -- 
  war_es -- -- vertraut -- dergestalt völlig Kenntnis erschüttern wurdest -- 
  sterblich -- verzeihen -- 
  wachend sehen -- lieben -- Anblick Leben Gefahr setzen -- -- wachen -- aufhören -- 
  einst Liebstes verlieren -- -- Vergütung schuldig -- sollsten -- 
  Feiere nahbevorstehend Gedächtnisfest -- Stiftung süß Brey' -- -- rosenbergisch Dame Namensschwester zukommen -- zählen fünfzehn -- sehen bekommen -- Verlust dein Bräutigam ersetzen -- 
  Bertha erwachen -- fühlen merklich stärken -- Versprechen weiß Frau -- wachend erscheinen -- 
  bloß Gedanke übermenschlich Wesen -- gemein -- Gleichen -- sehen -- Grauen verursachen Genesung verzögern -- unglückselig Person -- Zeitgenosse Name Träumerin auszeichnen -- bringen -- gehäuft Abenteuer Geisterwelt -- verstand zweifeln -- verlieren -- 
  Ehrenwort gespenstisch Dame sichern -- ruhig Zukunft blicken -- reißen Gewalt Andenken an -- Genas zusehens -- 
  Entzück schließen Oheim frisch blühend arm -- doppelt Munterkeit gewöhnlich Anstalt alt rosenbergisch Stiftungsfeste Bertha Seit -- rüsten -- übertragen Ehrenrolle Anstand spielen -- 
  Leser Entstehungsart Festes -- Wort Benennung -- wiewohl schier Unmöglichkeit dünken -- Märchenfreund deutsch Nation Mahlzeit süßen Breie beschreiben wissen -- 
  rosenbergisch Dame -- Schicksal -- ungebüßen Schuld Tod Gespenst -- arme -- Erbauung Schlosses Neuhaus helfen -- Ergötzung Gastmahl ordnen -- Hauptschüssel süß Milchbrei -- 
  Gericht Fisch -- 
  Laib Brot Honig -- Krüglein Wein -- silbergroschen machen übrig Teil köstlich Bewirtung -- Wiederholung Folgezeit Enkel weiß Frau Sache -- Zeit glauben -- zahl arme -- müssen reich großmütig -- Baron Matthias -- Stiftung eher vermehren schmälern -- 
  Genesung geliebt Bertha Ehre fest diesmal verschwenderisch feiern -- 
  Fräulein Engel Gast umh -- grün Matte Burg lagern -- teilen Bestimmter -- -- Freigebigkeit Baron bereichern -- heimlich Gabe vermehrn -- 
  tönen laut Seegenswünsche -- Verfertigung Konterfeis sprechen -- ungeachtet Nachwelt dienen -- Bild weißgeschliert rosenbergisch Witfrau Anblick gefällig finden -- gutherzig Bertha -- Mitleid Wohlbehag annehmen -- 
  Geschichte Abenteuer Fräulein -- obgleich Beschaffenheit vollkommen wissen -- ausbreiten -- jung Person -- Hauptrolle spielen -- allgemein Gegenstand Neugier Bewunderung -- 
  rosenbergisch Vetter -- schön Muhme kennen -- österlich Familienbesuch schön reichergekleidet Base Bässlein übersehen -- Osterzeit -- ohnedem fern -- erwarten -- Fräulein Bequemlichkeit Schlos alt Oheim beäugeln -- faßt romantisch Entschluß -- arme mischen -- Berthen Milde speisen -- Gabe Hand erhalten -- 
  Bertha unbefang Unschuld dicht Reihe Gast einher -- teilen rechts links -- drauf -- vollwangicht krauslockig Bube -- lebendig Gegenbild Dürftigkeit Milde drängen -- 
  kühn -- weiß wohltätig Hand -- Laiblein Brot darreichen -- fass Lippe ziehen -- 
  Fräulein beleidigen -- Armut Freiheit verzeihen -- damalig streng Jungfernsitte -- Fürst gestatten -- 
  fehlen -- Mann -- fragt mitleidig Blick -- bedenken -- Inhaber Gesicht fehlen -- besonderer Anliegen -- 
  O -- gnädig Fräulein -- rufen unbekannt Vetter -- Bertha Augenblick Tugendübung verschönern -- Engel vorkommen -- o -- Welt geben -- entdecken -- 
  sehen -- antworten freundlich -- aufhalten -- suchen Gelegenheit -- Schlos sprechen -- -- begehren -- Vorbitt Oheim erhalten -- soll_es -- 
  drauf ziehen ziemlich Silberstück Säckel -- lauschend Geselle mild Gabe Wacker höhnen -- Jungfernsöldner nennen -- 
  Spottet -- -- spend liebenswürdig Bertha Unterpfand groß Milde -- Bestellung auf Schloß -- 
  erbiet vorbitte Oheim -- -- 
  -- -- Liebhaber Gespräch groß Gunst Dame rühmen -- -- 
  Sache belacht kommentieren -- wissen jung Geselle -- Geschlecht Jahrhundert -- 
  Begabte -- Fräulein Herz Wohlgefallen -- Sache ernstlich -- bekennen frei Eile -- schön Bertha sehen Richtigkeit -- -- fahren fort -- -- 
  österlich Besuchzeit Baron fern -- zudem Haufen Vettern Muhmen selten eingefunden -- kennen -- Fremd behandeln -- wagen -- heimzusuchen -- 
  Fräulein bekommen -- hören -- sehen -- einsprichen -- -- Mann wichtig -- freundlich Aufnahme -- berthen Anblick verschaffen -- 
  Rat Ding pflegen -- Jünglinge verliebt Gefährt -- Ausweg finden -- Scharfsinn -- denken -- zutrauen -- 
  fest süßen Breys vierzehn vorüber -- erhalten Baron Matthias Botschaft Prinz B -- mehrere Fürst Haus verwanden -- gefällig -- Gefolge nächster Burg einsprechen -- 
  Fräulein Losung -- Zimmer ziehen -- Einsamkeit pflegen -- ungestören -- -- Gelegenheit genießen hoffen -- 
  -- -- weiß Frau letzter Erscheinung -- Aufmerksamkeit geliehen -- nachgerechnen -- funfzehend rosenbergisch Spende -- fremd Herr Burg einritn -- gemutmassen -- Mal Gesellschaft gehören müssen -- sehen -- bestimmen -- Stelle verblichen Bräutigam ersetzen -- 
  Bertha beweinen geliebter redlich -- Ersatz wünschen -- scheinen Traumgesicht vergessen -- Gedanke losriß -- Beziehung gespenstisch Matrone -- 
  diesmal Toilette nachlässig -- setzt spinnrocken -- Mittagszeit Ruhe umtreiben -- Dirne -- Tisch dienen -- Hereintrat -- Tafel bereiten -- Erzählen lieben jung schön Prinz B -- wacker Ritter -- begleiten -- 
  Bertha antworten hierauf -- Arbeit Tisch setzen -- podagrisch Schritt Baron Galerie hören -- hereintreen -- 
  heilig Maria -- Oheim -- schreien Bertha -- entgegen treten -- bewegen -- euer Gast verlassen -- 
  hoch Notwendigkeit -- Kind -- 
  Mußt entschließen -- unten Tafel erscheinen -- ankündigen -- -- denken -- abschlägig Antwort geben -- 
  Himmel -- Anzug -- rufen Bertha -- Spiegel -- 
  weiß häuslich Gewand -- 
  ungeflochten Locke -- 
  Ließ Eile ändern -- 
  unmöglich -- Oheim -- 
  braucht Viertelstund -- indessen erkalten Gericht -- 
  kommen -- 
  findest lauter Familie -- Prinz B -- verwandte -- Begleiter -- Herr Rosenberg -- Vettern -- 
  Gott -- welcher Forderung -- 
  Komme -- bat Vergunst -- Muhme sehen -- unmöglich sagen -- 
  Glühend Scham vernachlässigen Toilette -- unaussprechlich liebenswürdig Verlegenheit -- treten Bertha Seite Oheim Tafelzimmer -- vollkommenst Modeputz verschöneren -- kunstlos Tracht -- Auge Vetter darstellen -- 
  Mode Jahrzehnt steif -- Gesicht -- hoch Staat Vorteil erscheinen -- Klasse berthen unschuldig hervorstechend Zug gehören -- 
  bewillkommen damalig Sitt -- setzen Tafel -- Bertha Wirtin -- sprechen -- -- 
  Auge überall -- Wohlsein Gast vernachlässigen -- bemerken Beschäftigung -- Gast -- -- Auge -- -- 
  Tafel spazieren -- 
  Bertha müssen Gesellschaft bleiben -- Vettern Seite -- Schloßgesind -- ungewohnt -- Sage erheben -- 
  Brautkranz schweben Haupt Fräulein -- Ritter sicher heimführen -- -- Frage -- gut Bertha hoch Glück -- hoch Ehre gönnt -- fallen Stimme einhellig Prinz -- 
  Grund Wahrheit -- still Bertha Liebe hören -- Leben -- 
  verblichen Bräutigam -- Herr Peter Wocken -- schlicht geradsinnig Kempe -- Liebchen Herz meinen -- Minute zehnerlei Art verstehen geben -- 
  Höfling -- Berthen Glück -- gespenstisch Namensschwester Gesellschaft bringen -- wissen Kunst Minne fein Art treiben -- Herz jung Fräulein verlieren -- gewöhnlich Alltagsherz gehören -- anklopfen einlassen -- 
  berthen Herzenstür Andenken verstorben geliebter Hüter -- bestech -- verschließen fest -- heftig bestürmen -- -- 
  Abend heran -- Fräulein froh -- Gast -- Überlast versehen -- Abschied nehmen -- Kämmerlein zurückziehen -- 
  -- ehe geschehen -- ernst Vorhaltung Oheim auszuhaln -- Hartherzigkeit -- erweisen -- Tode vergessen -- Glück Lebendig denken müssen -- 
  Vettern -- Prinz Ritter -- Baron dergestalt Vorteil ziehen -- wissen interessiert Person -- Leser Ohr sagen -- alt Herr Rosenberg -- stattlich Ritter -- Welt sehen -- durch Schwert Ruhm Ehre erwerben -- Weise liebens- wählenswürdiger Gegenstand -- blond fünfzehnjährig Fürstensohn -- jung Herr -- jugendlich Leichtsinn Hauptrolle spielen -- indes übrig -- böse -- Anlage -- 
  Jüngling ernst still Bertha schicken -- Trinklied hoch Messe -- denken -- Besuch alt Vetter -- Freund -- Herr Heinrich Rosenberg -- liebe veranstalten -- Gelegenheit Rendezvous geben -- unschuldig Bertha Fest süß Breie bescheiden -- -- entdecken -- versprochen Vorbitt Oheim hören -- 
  weiß Frau Wort halten -- berthen Auge sehen lassen -- Traum Meinung Ding zuflüsteren -- genau sagen -- -- begnügen -- Leser mitteilen -- Sage Last legen -- ungeachtet Vorurteil -- Klugheit Gutmütigkeit -- räumen wissen -- 
  rosenbergisch Matrone -- lauten Tradition -- Fräulein Bertha Neuhaus Affektion nehmen -- wünschen -- Niedrigkeit hoch allenfalls erreichbar Staffel Ehre erheben -- 
  fürstlich Heirat Favoritin -- dachen Ernst -- jung Prinz B -- Gemahl geben -- 
  bejahrt Heiratsstifterinne ziehen selten Geschmack wahr beide Teil -- wahnvollen Eigensinn Rate -- -- 
  Bertha fürstlich Jüngling paßen -- Gedanke Liebe Sinn -- letzterer geschäftig Frau Base gewahr -- Empfand -- Teil rächen trachten -- 
  Bertha Liebling gespenstisch Matrone -- leer ausgehen -- weiß Frau -- Sitte Geschlecht ziemlich kundig -- urteilen weislich -- Fräulein lieben -- Lieb auffordern -- Verschmäht billig Kaltsinn Kaltsinn belohnen -- 
  desto strenger Gericht ergehen arm Prinz -- 
  Warnende Traum machen Anfang -- anmahnen -- aufbürden -- 
  sinnbildlich schwer deuten -- 
  Prinz Erdmann verstenden -- Traumgott unaufhörlich Schloß Neuhaus versetzen -- Hand Muhme Bertha Kränze Ring nehmen lassen -- 
  finden jung Fräulein schön liebenswürdig -- -- Nacht Traume sehen -- begreifen -- wachend denken -- Herr Rosenberg schläfrig Fortgang Liebe unterhalten -- 
  Lament hören höchst ungern -- schlechterdings zart Minnetrieb erfahren -- unmöglich Mitleide verliebt Duld -- 
  Ritter -- Tag trauernd Jüngling -- Linderung Eurer Qual Traum gönnen -- mal Nacht euer Bertha schön freundlich -- wünschen -- erscheinen -- 
  -- Prinz -- antworten Herr Heinrich Rosenberg -- Gefühl euer Brust übergehen -- 
  welch gefährlich Mitbuhler -- 
  übermütig Jüngling beantwortet lachen -- eilt Pferd -- -- nebst Jagd -- Hand einzig -- Leidenschaft Beständigkeit lieben -- 
  berthen ungebeten Versprecherin -- Widerspenstische nah treten müssen -- ohned Art kleinstädtisch Frau Base -- klein Grad Verwandtschaft Vorwand -- Haus zuzudringen -- 
  Brandenburg -- Baden -- Hannover Familie verwandte Haus -- genießen längst Ehre -- zuweilen sehen -- Haus B -- Erscheinung öfter -- 
  rumort Vorratsböd -- streichen Schlüsselbund weit Säle lassen Pferdestall herab -- 
  öftesten lassen Zimmer Prinz sehen -- unsichtbar -- desto fürchterlich Kammerbedient -- wissen -- gebärden -- Äusserung Furcht entsetzen Hofetikette vereinigen -- 
  Anregen Reise Neuhaus -- schön Bertha sehen -- deutlich -- 
  Voll Unmut reißen gequält Jüngling einst Mitternacht Träum empor -- eilen an Fenster -- deutlich weiß Frau -- beschreiben -- Leibroß Stalle -- mondbeglänzt Hof leiten -- Ecke verschwinden -- zaum- zügellos Tier unerhört Tobe Rückweg Stalle -- 
  Prinz wecken Leute -- finden Stall verschließen -- Pferd unruhig -- 
  Klügst schüttelt Kopf meinen -- Sache leicht Achsel nehmen -- Zweifel Unglück Anzug -- 
  Erscheinung weiß Frau -- blicken lassen -- deuen -- Prinz raten -- morgend ausgehen -- Roß besteig -- nächtlich Abenteuer Gift bekommen -- bös Geist mehrmals Rossen Hafer spritzen -- verderben Herr bewirken -- 
  Schrecken Prinz Anblick Schloßgespenst neu -- wider -- Diener sagen -- einwenden -- legen Entschluß -- Rate Folge leisten -- Bette -- Schlaf überfiel -- fest traumleer Schlaf -- Schreckbild verwischen -- Seele eingepragen -- 
  dünkn -- erwacht -- Nachtgespenst -- erheben Gewohnheit -- auszurein -- 
  stellen -- Nacht sehen stillschweigend eingestehen -- umsonst -- bestehen Sinn -- 
  Bestieg Roß -- Stunde Hand weiß Frau bäumen -- geduldig Lamm dastehen -- Schloßbrücke -- zähmen -- verhängt Zügel Weg -- Prinz gedingen -- 
  Weg Schloß Neuhaus -- mutwillig Reuter -- Gefährt Herr Heinrich Rosenberg behilflich -- unbändig Tier Räson bringen -- 
  Weg Bertha -- setzen -- Freund -- weiß Frau Rosse Nacht Wort Ohr -- Reuter Minute Ort bringen -- -- 
  Herr Rosenberg antworten hierauf -- raten jung Übermütig -- Rückweg Haus nehmen -- ohned Wetter weder Jagd Spazierritt begünstigen -- 
  -- Vorwand Wirkung -- störrig Jüngling schwerlich Heimzug bereden -- 
  -- feindselig Wesen Mensch -- Frevel schirmend Schild Schutzengel berauben -- 
  Prinz Erdmann tun -- streng Gericht Geist entschuldigen lassen -- ehe Stunde verging -- vergehen -- Untergang unvermeidlich -- 
  fürstlich Haus -- -- leben alt Markgräfin -- venerabel Matrone neunzig -- Großmutter Großtante lebend Geschlecht -- munter hoch Alter -- dasbey gefällig -- jung Hitzkopf -- Urenkel -- besagt Prinz -- lieb Achtung versagen -- Weisung beleidigen finden -- 
  diesmal Herr Rosenberg kurz Spazierritt -- Frühstück -- jung Ritter gehen -- Pferd steigen -- Gesellschaftssaal -- sämtlich Dame Haus Morgensuppe versammeln -- 
  O -- Kind -- rufen alt Dame Prinz entgegen -- Gott -- sehen -- 
  Todesangst deinetwegen ausgestanden -- 
  Unglück stehen unser Haus bevor -- 
  nächster Tag Leiche sehen -- 
  ausgehalten -- dein Tod erleben -- 
  Meinig -- gnädig Frau -- fragt Jüngling ziemlich übereilen -- 
  Meinst -- erwidern Matrone -- -- warnen -- sterben reifer -- -- 
  O -- Kind -- lernen -- alt Lehnstuhl sicher Tod -- unvorsichtig Jugend Lustwege -- -- 
  Wild Pferdebändiger -- -- rasen Untergang bringen -- 
  erfahren -- fragen Prinz Schwester leise -- Predigt kommen -- 
  Fräulein weinen -- 
  Unserem Haus -- schluchzen -- stehen Unglück bevor -- 
  Mann schwarz Rocke bringen Post -- Tod weissagend Leichenstein unser uranherr -- Kirche stark schwitzen -- 
  weißen -- bedeuten -- 
  -- erwidern Tollkühne -- -- Tuch Vordeutend Todesschweiße netzen -- Markgräfin bringen -- sterben lerne -- 
  ausgereden -- Verschwand Zimmer -- fliegen Stieg hinab -- werfen gesattelt Roß -- Hof abführt -- vorig Erhitzung erholen -- 
  dampfen lechzen -- Stallmeister bitten -- schön Tier schonen -- -- nämlich Dämon -- vorig Nacht Roß Gift Hafer spritzen -- Hirn Eigentümers verrückt -- 
  Warnung -- Pfeil sehn -- fliegen Tier -- gleich Trieb Verderben fühlen -- -- Meile entlegenen Kirche -- Gegend versammeln -- fürstlich Leichenstein schwitzen sehen -- Deutung Wunder alt Markgräfin -- 
  Herr Rosenberg Prinz eilig folgen -- verlangen fürstlich Dame -- Besorgnis jung Unvorsichtig nötigen -- Schicksal überlassen -- langt Minute -- steigen -- finden dicht Haufen -- schwarz marmorn Denkmal stehen -- 
  Gelehrter nahgelegen Stadt -- Gerücht Mirakel herbei ziehen -- gesellt -- erklären weitläuftig -- Feuchtigkeit -- weinend Stein herabtroff -- keineswegs Übernatürlich -- Ursache herleiten lassen -- 
  Demonstration Art -- Erzähler Mährchen -- ungläubig Jugend jederzeit willkommen -- 
  Prinz horchen -- lacht Hirngespinst -- Urahnfrau -- 
  Herr Rosenberg unaufmerksam -- enthalten unvorsichtig Äusserung -- edl bescheiden Mann -- Grund Hand still Bertha verdienen -- 
  Demonstrator sagen -- -- gaffend Menge herabfallend Tropfen feucht Gewölbe -- Entschloß reuen -- 
  Herr Heinrich schlagen Prinz -- Pferd wechseln -- Beschimpfung -- 
  gestehen -- toll Tier Herüberreut Not mehrmals Sturz bedrohen -- stark nervig Arm Ritters Rosenberg regieren wissen seinigen -- erkennen -- 
  lassen Taschentuch sogenannter Todesschweiß Leichenstein einfangen -- steckt obgemeldet Vorhaben -- verlassen Gefährten Kirche -- schwingen Roß -- geduldig Hut Bauer Pforter gestehen -- -- Last fühlen -- rasen neu beginnen -- -- -- vielmehr Reuter -- Haar Berg stehen -- Sturz unvermeidlich scheinen -- 
  Herr Rosenberg verlieren unglücklich Jüngling -- schnell folgen -- Auge -- 
  Gefahr stürzen -- stoßen Roß unaufhörlich -- unsinnig Flug nah bleiben -- 
  Augenblick Prinz Ferne -- nächster Horizont verschwinden -- 
  -- fürstlich Burg nahe -- Rosenberg Prinz -- Viertelstunde -- bügellos Schloßhof jagen kommen -- Zügel Hand -- 
  halten Mähne fest -- 
  Gefahr eilt Hülfe -- -- spät -- 
  Ehe nähern vermögen -- Unglücksroß -- Boden fallen -- letzter Hauch ausblies -- abgeworfen -- 
  Unfall geschehen dicht Stieg -- 
  heben arm Jüngling -- -- erschüttern -- begehrn hinauf leiten -- 
  Unmöglichkeit -- Strom Blut stürzen Mund -- 
  Rosenberg kläglichen Schauspiel -- 
  fassen fürstlich Freund Arm -- schwächlich lehnen -- versichern -- bedeuten -- vorüber -- 
  Leit hinauf -- setzen lallend hinzu -- sterben -- sagen -- Schweiß Leichensteines deuten -- 
  -- unglücklich jung Prinz Kraft -- Weg Rosenberg Arm zurückzuleg -- Kraft vereint Folge tödlich Erhitzung gewaltsam Sturz überstehen -- -- 
  sterben nämlich arme verzweifelnd Familie -- jung Wüstling lieben -- verlieren glauben -- 
  tragisch Geschichte -- -- bloß Folge jugendlich Unbesonnenheit -- Rechnung rosenbergischen Matrone schreiben -- Pflegt herbeizuziehen -- Fehler Fürst entschuldigen -- 
  berth Name hinein verflochten -- Herr Rosenberg -- verstorbenen Prinz zuweilen Träum -- nachher Sage ausgekommen -- nutzen -- weiß Frau -- gehässig Name -- Name unglücklich Heiratsstifterin geben -- 
  unser Teil -- Dame liebsn schriftlich hinterlassen Zeugnisse -- Leser mitteilen -- beurteilen pflegen -- erklären -- Tücke unfähig halten -- wenden Favoritin -- Fräulein Neuhaus -- Schlos alt Baron gewohnt still Leben fortsetzen -- beunruhigen lassen -- dauernd Liebesverfolgung Herr Rosenberg -- schriftlich Mund Oheim wenden -- endlos Trauer verblichener -- Verbindung bereden -- 
  jährig -- Geliebten verlieren -- Ausdruck -- endlos Trauer anbringen -- 
  -- treu Bertha Bräutigam an Leben beweinen -- Freiheit gönnen -- Schicksal eingemischen Herz anfangs Mitleid -- zärtlich Empfindung aufgenötigt -- innig Teilnehmung Kummer erwächsen -- 
  Prinz B -- Tod -- vornehm verwandte -- sich_es geziemt -- rosenbergisch Haus betraueren -- lassen -- Trauer bekommen -- 
  Herr Heinrich Rosenberg forciert Märsche -- Stunde -- fürstlich Freund Liebe unternehmen -- Gesundheit nehmen -- 
  Ritter ausstehen -- Held früh Jahrhundert Rosenberg liegen gefährlich Folge tödlich Erhitzung -- 
  Fräulein Bertha erhalten Nachricht Krankheit -- Ursache erfahren -- zuvor -- höchst lamentabl schreiben erhalten -- Wort -- Grab Tod -- sparen -- glauben aufrichtig -- Mädchen Stück starkgläubig -- -- Herr Heinrich sterben -- Mörderin -- 
  Schmerz Gewissensbissen -- Wahn verursachen -- Gelübde Fall Genesung -- inbrünstig Himmel erfleht -- fern Grausame spielen -- -- wünschen -- Oheim befehlen -- sagen -- -- 
  Gelübde laut tun -- Wort halten -- österlich Familienbesuchs -- Herr Heinrich Rosenberg -- völlig wiederherstellen -- eintreffen -- Hand Hand Baron empfangen -- 
  fehlt -- alt Einwohnerin Mauer -- weiß Frau -- lieb teuer -- 
  Schloß Neuhaus gebären -- deutungsvoll Name Bertha empfangen -- groß Verlust zärtlich Mädchen -- Verlust Bräutigam erleiden -- wichtig jungfräulich Leben verleben -- Bündnis treffen -- -- Prinz B -- Bewandtnis -- -- voll Beifall geistig Patronin beehren -- 
  sichtlich Zeichen Wohlgefallen -- 
  -- hauswirtlich Gespenst -- Geschäftigkeit bloß bevorstehend Trauerfälle zeigen -- Leichentücher verschlossen Truhe holen -- Licht Sarge Voraus ordnen -- -- verwanden Haus Hochzeit Kindtaufen Tür -- nämlich Lärmen Schlössern Schlüsseln -- 
  fleißig Hausfrau mächtig -- silbern Tafelgeschirr herauszugeben -- köstlich Leinengerät ausbreiten -- 
  Finden vorwitzig Wirtschafterin Schloß -- Hut anbefohlenen Kostbarkeit unnötig besorgt -- rosenbergisch Matrone Hindernis Geschäft bringen -- selten Tätigkeit -- freilich sterblich allemal Schwächere -- Leben bezahlen -- 
  Frau Bertha allemal treiben pflegen -- Hochzeit Familie -- -- Ding arg -- fast Schritt Treppe Säl -- Furcht begegnen -- 
  jung Braut begegnen -- Folge getan Versprechen wahr Edeldame treu bleiben -- 
  Person -- Fräulein raten -- gutwillig fallen -- folgend Ursache -- bekannt golden silbern Pokal -- Schüssel Kann Schloß -- -- Gefässen ungeheur selten Kostbarkeit tragen -- zuvor sehen -- sogar alt Talern füllen -- urteilte uneben -- können Hochzeitgeschenke Braut -- Hand -- Hand Patronin empfangen -- Bertha Welt Preis nehmen -- ehemalig Gesellschafterin sehen -- Bräutigam -- Hang Geiz -- wider Wagnis schnöde Gewinst Wille -- 
  indessen schreiben Zeit Sage Schatze -- Schloß Neuhaus glücklich Finder aufbehalen -- Hüterin weiß Frau -- 
  Abend Morgendämmerung verfallen türm alt Burg -- wachsend Gespenst hervorkommen sehen -- Mut -- hineinzugeh -- morsch Treppe nachzusteig -- möglich Bedingung Schatz heben -- geliebt Bertha zugedenken -- 
  erhalten -- Herz besitzen -- Hand gespenstisch Matrone nehmen -- Pathengeschenk bekommen -- Schloß Neuhaus -- Gemahl alt Baron lieb hauster -- Herrlein gebar -- 
  geschäftig weiß Frau Wochenstube -- Kindbetterin schlief -- 
  -- Peter Rosenberg -- nennen Bertha geliebter -- -- mehrmals arme -- wissen Verwandtschaft Kind nachdrücklich verteidigen -- einst Wärterin kühnlich entreissen -- fühlt Unhöflichkeit beleidigen -- nachher erscheinen -- begnügen -- geliebter unsichtbar Weise Obacht halten -- 
  obbenannt neuhausisch Türme -- Schloß Hannover -- Zimmer königlich Schloß Rittersaal Hauptgegenden -- eignen -- Verbindung Haus zahlreich -- -- gewohnen -- überall zeigen -- verschwägert -- 