Inhalt -- I. Sophie G. Seite 1 -- 
  II. Graf L. Seite 61. III -- 
  Hans K-- -- Bauer M-- -- 
  Seite 179. IV -- 
  steinern Brantbett -- -- Hugo Klette -- 
  Seite 213. Sophie G-- -- 
  berühmt bekannt Markgraf B-- -- Name tun Sache -- Fürst -- klug Regent -- Rücksicht Vater Volk Land -- 
  Tausend loben -- Wohltat -- beglücken -- erzählt -- fassen zahlreich Zirkel -- verdient Lob einstimmten -- 
  gut Fürst Mensch -- gut Mensch fehlerfrei -- 
  Leidenschaft -- lieben pflegen -- Ursache -- einzeln Vater murrten -- einzeln Mutter hart grausam nennen -- 
  System stehend Kriegsheer herrschend Deutschland -- 
  Wilhelm -- Preußen König -- Urbild -- klein Fürst Verhältnis gemäß -- nachzuahmen suchen -- 
  erster sammelt Europa groß Kolosse menschlich Geschlecht -- Gnarderegiment bilden -- 
  Markgraf durchspäht Land -- ähnlich Riese finden -- Granadier Schloß Gemächern Wache stehen müssen -- 
  untertanen entging Forscher -- Körper erforderlich Größe erreichen -- Kamm -- frei Bürgerssöhne -- Freiern Kandidat Priesterstandes wider Gewohnheit Annahme Waffe zwingen -- 
  lebt Hauptstadt reich -- arm Bürger -- einzig Sohn -- 
  -- Pappel wasserreich Flusse empor wachsen -- prophezeit Freund verwandte kummervoll Blick -- einst Granadier fürstlich Schloß Wache stehen -- 
  sorglos Jünglinge Weissagung gleichgültig -- Gegenwärtig Genüssen suchen -- Zukunft gedingen -- liebend Vater -- zärtlich Mutter verbittert froh Stunde -- 
  Wohlstand erster Hing tätig Betrieb Handwerk -- hoffen Sohne Gehilfe erziehen -- alt übergeben -- -- ernähren -- ruhig Alter Genüsse -- 
  Aussicht schwehen -- künftig Schicksal Sohnes dachen -- 
  bestimmen -- hundert glücklich Zufall drohenden Gefahr entgehen -- fahren fort -- Vorteilen Handwerk verknüpft Handel unterrichten -- gefällig -- Jüngling emsig Geschäft anhalten -- Freude gönnen -- verweigern -- Gedanke -- Soldat nützen -- nachgebend -- 
  arbeitsam Vater allzu nachlässig Sohn streng Arbeit anhalten -- zärtlich Mutter Fürbitterin -- suchen erster überzeugen -- hart grausam -- Junge jeder Vergnügen rauben wollen -- höchst wahrscheinlich -- künftig Stand ohnehin Sklave -- 
  sträflich Nachsicht wecken Herz Jüngling Hang Müssiggange Vergnügen -- Körper ähnlich Verhältnis wachsen -- Grundlage Charakter -- Führer Handlung -- 
  kennen Haus -- tanzen spielen -- -- gehen -- letzter -- Gesellschaft verlassen -- 
  neunzehn alt -- Rose blühen -- lernen einst Tanzsaale schön Tochter arm Bürger kennen -- Markgräflich Schlos Laufmädchen dienen -- Reiz -- sittsam Betragen übrig Tänzerinn auf vorteilhafte auszeichnen -- 
  führen heim -- gestehen Liebe -- erhalten Erlaubnis -- besuchen -- 
  Beweis Liebe Kuß erhalten -- wandeln -- fühlend Genüssende -- Schloßhof -- plötzlich Fenster öffnen -- Markgraf stehen -- rückwärts rufen -- 
  zagend erscheinen Jüngling -- langsam Trauernd dannen -- Markgraf Gebot Hauptwache führen -- nachher Granadiermütze aufsetzen -- 
  Weinend empfangen Mutter -- seufzend grüßt Vater -- untrüglich Kennzeich künftig Stand erscheinen -- 
  vernahmen -- Markgraf -- einzig Sohn -- kurz -- dauernd Kapitulation zugestehen -- nebenbei versichern -- Handwerke nötig Wanderschaft anrechnen sollen -- trocknen Mutter Träne -- Vater blicken heit Zukunft -- 
  Wilhelm -- nennen Jüngling -- lieben Mädchen Feuer brausenden Jugend -- 
  Kaserne Granadiere stehen nahe Schloß -- Liebling Markgrafen -- Granadier -- ungehindert eingehen -- Mädchen öfters sehen sprechen -- 
  Vorzug mindert Härte Stande -- Hoffnung -- kurz dauern -- tilgt Trauer -- 
  fröhlich Wilhelm -- tröstet Mädchen -- tränend Blick Rocke hängen bleiben -- Kuß verweigern -- Flatterhaft gewöhnlich Soldat können -- stehen dazumal Rufe -- Standquartiere Mädchen verwechselten -- 
  Sophie Gegenstand vollkommen beruhigen -- ewig Treue geschworen -- Verlauf Dienstzeit heiraen loben -- langt Hof Markgrafen einzig Tochter Besuch -- 
  Erbprinz K -- heiraten -- leben glücklichst Ehe -- führen Frucht dreijährig Prinzessin mütterlich Hand -- entzückt Vater froh Willkommen entgegen eilen -- 
  Markgraf Kinderfreund -- Spaziergängen Haufen spielender Kind antreffen -- treten mitten -- beschenken -- Anblick zerstreuen -- ungehindert fortspüln -- 
  Anblick Prinzessin -- süß Überzeugung -- Enkelin -- Ebenbild geliebt Tochter -- vermehrt Freude -- Engel arme -- jubeln -- Holde arm Nacken schlingen -- Furcht freundlich küßen -- 
  Herz hing Augenblick -- schreiben Vater -- bitten Mutter -- müssen Liebe Kind Wunsch ehrwürdig Vater opfern -- versprechen -- Tochter Hof lassen -- Freude gönnen -- Umgang freuen -- erziehen -- 
  zärtlich Mutter verbergen Träne -- hernach Kind trennen -- arm Gatte Rückehr müssen -- Markgraf versprechen Überwindung lohnen -- jubeln auf -- Prinzessin Abschied Mutter bekümmeren scheinen -- munt fröhlich Fuß spielen -- 
  ordnet vollkommen Hofstaat -- ernennt verehrungswürdigst Dame Land Obristhofmeisterinn Prinzessin -- überlassen -- übrig Diener Dienerinn Gefallen wählen -- 
  Dame Wahl vorzüglich treu Redlichkeit -- 
  Sophie -- Kammermädchen Prinzessin bestimmen -- 
  Dienst bringen hoch Lohn Gewinn -- Pflicht -- stets Prinzessin -- Führerin -- verhindern -- geliebt Wilhelm sprechen sehen -- 
  Verfloss -- Woche -- weiten grüßen -- höchstens Vorübereile paar Wort Liebe zuflüstern -- 
  Zwang Hindernis echt Unkraut feten -- fruchtbaren Acker -- vertilgen suchen -- stark vielfältig Keimt empor -- 
  Wilhelm Sophie empfanden Wahrheit -- glauben ehe Innig zärtlich lieben -- sehen -- -- trennen -- stark -- heftig lieben -- 
  Sophie suchen Sehnsucht geliebter treu Erfüllung Pflicht -- rastlos Beschäftigung minderen -- Wilhelm -- Wache Woche treffen -- geschäftlos umher wanderen -- Tilgung bangen Sehnsucht wählen -- Müßiggang Nachdenken vermehrt Marter -- unausstehlich -- suchen -- stundenlang Blick geliebter lauern -- Zerstreuung -- Erholung -- finden Trink Spielhause -- 
  vergönnen -- Sophie sehen -- sprechen -- Haus äußerst sparsam besuchen -- mächtig Leidenschaft Mensch -- allmächtig Liebe Leidenschaft besiegen -- rächt Sieg -- keimten listig Vorstellung -- Vergnügen Qual Liebe minderen -- mächtig empor -- Wilhelm trank spielen stark vorher -- 
  Aufwand bestreiten -- langt Löhnung -- Eltern geben freilich monatlich Zulage -- Abend verspielen -- dienen Vergrösserung Liederlichkeit -- 
  Spielsucht mehren täglich -- befriedigen -- Stand namhaft Schuld -- quälte ängstigten -- Hoffnung -- glücklich spielen -- stets neu Spiel verleiteten -- 
  schuld Gulden äußerst drängen -- Klage Hauptmann befürchten -- wissen -- bezahlen -- treffen Reihe Wachtparade -- 
  müssen Türe Saal Wache stehen -- Markgraf Hofes spei -- Geburtstag feiern -- 
  Wilhelm glücklich Sophie einigemal sehen sogar vorübergehen sprechen -- 
  heit fröhlich -- Schuld gedingen -- düster traurig -- 
  Markgraf spielen selten -- spielen -- spielen gerne -- verlieren gewinnen namhaft Summe -- 
  finden Abends Vergnügen Spiel -- 
  Wilhelm gierig Blick -- Karte Haufen Golde stehen -- 
  reizend Anblick weckt Spielsucht -- endet Vorstellung -- einzig Karte glücklich -- Verlegenheit retten können -- 
  ablösen -- Vorstellung Ruhezeit hindurch einzig Beschäftigung erhitzt Einbildungskraft -- 
  Wache Türe Saal führen -- spielen Markgraf -- obgleich Mitternachtsstunder beginnen -- 
  enden -- stehen -- wickelt Gold -- wel- Markgraf verlassen spät Bette -- Granadiere Wache beziehen -- Prinzessin -- Schlafgemach erscheinen müssen -- eintreten -- 
  erblicken -- gedacht gestrig Gewinn -- Geschenk bestimmen -- suchen finden -- erinnern deutlich -- Gold Schnupftuch fassen -- Gespräch Tisch legen -- 
  saal -- Durchsuchte finden -- 
  wahr erweisen -- Gold stehlen -- beginnen Untersuchung -- 
  Dien -- gegenwärtig -- Granadier -- saal Wache stehen -- arretieren -- 
  letzter befinden Wilhelm -- Hauptwache Quartier zurückkehren -- Arrest führen -- 
  untersuchen sogleich Wohnung Sache Arretiert -- finden gering -- visieren Schubsäcke -- finden Wilhelm Gold -- Schnupftuch Markgrafen -- unverkennbar -- Krone Name zeichnen -- 
  Wilhelm gestehen sogleich -- zeigen Ort -- Gold Holzstosse alt Topfe vergraben -- 
  Folge sagen -- geschehen -- verräterisch Tuch vernichten -- werfen -- schüttet Gold Tuche Topf -- stecken -- Folge bedenken -- wahrscheinlich mechanisch Bewegung Sack -- 
  -- Markgraf -- Kerl hängen -- sprechen Markgraf zornig -- melden -- Täter entdecken -- Granadier -- 
  befehlen -- Standrecht halten -- Stunde nachher versammelen -- Wilhelm Tod aussprechen -- 
  erfahren liebend Sophie Verbrechen unvermeidlich Schicksal geliebter -- 
  Verzweiflung kennen Schranke -- überspringen -- jenseits Hilfe erblicken -- 
  eilen -- Raub -- Eltern unglücklichen Wilhelm -- gestehen -- vorher Geheimnis -- Sohn auf innigst lieb -- Rat -- Hilfe Trost erwarten -- 
  unglücklichen geben -- besitzen -- jammern trostlos -- suchen Freund -- Hilfe Rat -- finden Kein -- 
  Vater Mutter knieten nachh Schloßtreppe -- Garten führen -- fleht Erbarme -- Markgraf herabstiegn -- winken ernst Blick -- Trostlose weggeführen -- 
  eilen Minister -- erhalten überall tötend Versicherung -- solch Verbrechen Mitleid verdien -- Welt Markgrafe bewegen -- teur Schwor brechen -- 
  Beschäftigung naht Abend -- wanken Wohnung -- bringen Gewißheit heim -- Standrecht einzig Sohn Tod aussprechen -- Stunde Hand Henker dulden -- 
  Sophie hindurch harren -- Jammer Grenze -- schrecklich Nachricht hören -- eilt Hauptwache -- Wilhelm sehen -- Priester bereiten nah Tod -- vorgelassen -- 
  zerrauft Haar -- starr Blick blutig gerungen Hand erscheinen Zimmer Obristhofmeisterin -- ungewöhnlich Abwesenheit bemerken -- vergebens fragen -- 
  Sophies Schmerz Worte fähig -- Obristhofmeisterin brauchen Mühe Geduld -- ehe Ursache schrecklich Zustand erfahren -- 
  äußerst sanft menschenfreundlich Dame -- Sophies Jammer rühren Herz mächtig -- suchen tröst -- Grund Religion überzeugen -- Gott Weg unerforschlich -- stets Weise gerecht sein -- verzweiflungsvoll Sophie dreist versichern -- Gott Barmherzigkeit zweifle -- Hilfe Rettung senden -- sucht Vorstellung aufzurichten -- hoffen -- -- 
  Sophie ergriff schwach Stab Trost Begierde -- werfen Fuß Trösterin nieder -- fleht Hilfe Erbarme -- 
  -- vermögen -- sprechen Holde -- Gnade Markgrafen Unglücklichen Leben retten -- sehen -- Bitte vermögen -- hoffen -- Fürbitterin finden -- hören -- 
  deutet Wort Prinzessin -- Pnppe spielen -- teilnehmend fragen -- 
  lieb Sophie weinen -- 
  Sophie springen hoffend ahnungsvoll empor -- Wort Trostes hören -- kennen Liebe Markgraf Kind -- glauben überzeugt -- versagen -- 
  gewöhnlich stehen Markgraf morgens -- sobald Prinzessin erwachen -- gemeiniglich geschehen -- müssen Obristhofmeisterin bringen -- 
  muntere bleiben Stunde Kabinette -- zwingen -- manchmal spielen -- 
  verabreden -- Prinzessin folgend wecken -- Markgrafe führen -- sogleich Wilhelm Leben bitten -- 
  Ausführung schwer -- anfangs glauben -- 
  alt Prinzessin plauderen stets -- meistens einzeln -- abgebrochen Wort -- aussprechen -- 
  Indes Sophie wahrscheinlich Trost Wilhelm Eltern eilt -- zerstörend Verzweiflung entreißen -- Hoffnung Toden Herz wecken -- versuchen gutherzig Obristhofmeisterin -- Eleven Wort lehren -- Gunst unglücklichen Wilhelm Herz Markgrafen rühren -- mühen -- Bitte abzukürzen -- Wort ausdrücken -- mengen Plauderin weniger untereinander -- erregt gegründet Furcht -- Markgraf Bitte verstehen -- -- 
  hoffen gute -- tragen Prinzessin Bette -- wecken -- Lektion wiederholen -- 
  Sophie -- Auge schließen -- wacht Nacht Bette Engel -- Erlöser -- beten inbrünstig Gott -- stärken -- Wort Kraft verleihen mögen -- 
  weckt Prinzessin -- Schlaftrunk -- weinen anhaltend -- Schlief auf -- 
  denk leiden arm Sophie -- einzig möglich Retter schlafend erblicken -- indes Geliebte Herzens nahe Todesangst dulden -- Glockenschlag mehren -- 
  _ vorüber -- Prinzessin munt fröhlich erwachen -- 
  rührend ansehen -- hastigen Eilfertigkeit zitternd Sophie anzukleid suchen -- allzu Eile Anzug verzögert -- gutherzig Obristhofmeisterin Beistand leisten -- Geschäft vollenden -- 
  beginnen neu Unterricht -- Prinzessin Bitte halb Wort stammeln -- ergriff Obristhofmeisterin Hand -- führen Kabinett Markgrafe -- 
  Sophie folgen weit gefaltet Hand -- jeder Glied zittert nah Entscheidung entgegen -- 
  Obristhofmeisterin öffnet Türe Kabinett -- lassen Prinzessin eintreten -- lehnen Türe langsam -- horchter offen Spalte Wirkung entgegen -- 
  Sophie drängen nah hinzu -- heben Hand Gott empor -- 
  Markgraf sitzen Schreibtische -- blicken Kommend -- 
  Mitte Kabinett -- knien nieder -- heben Hand Bittend empor -- 
  Liebe Großpapa -- stammeln -- Ganadirl schenken -- 
  Liebe Großpapa -- wiederholen -- Ganadirl schenken -- 
  gerührt Markgraf stehen hastig -- heben Prinzessin empor -- schließen Arm -- 
  verlangen -- sprechen -- küßen -- Bitte -- erfüllen -- 
  Granadier -- 
  Gnade -- -- -- Gnade -- flüstert horchend Obristhofmeisterin harrenden Sophie -- 
  Gnade -- schreien laut -- Vorgemach widerhalln -- stürzen fort -- Verkündigerin -- 
  wagen -- Jubel Eltern schildern -- atemlos Sophie allmächtig Wort Trostes erscheinen -- flehend Gebet -- stammelnd Bitte Ewig freudig Zurufe unterbrechen -- nebenbei erzählen -- Kammerjunker -- Hauptwache vorbeieilen -- Gnade arm Wilhelm Name Markgrafen verkündigen -- 
  Jammer Lebenskraft mächtig schwächen -- schnell Freude scheinen Überrest rauben -- 
  müssen unglücklich alte auf Bette legen -- Glied durchbeben heftig Fieberfrost -- Tod nahe -- nähern -- hernach hören -- Markgraf Sohne Leben schenken -- Versöhnung Gerechtigkeit Zuchthausstrafe verurteilen -- 
  achtet -- Haus dulden müssen -- unehrlich -- 
  Bürger sprechen unglücklich Opfer Gerechtigkeit -- 
  Strafe enden -- Erlöst bürgerlichen Gesellschaft Innung dulden müssen -- bleiben unvertilgbar Fleck -- rein Glanz Familie verdunkelt -- Gelegenheit geheim -- öffentlich Vorwurf dienen -- 
  Vorstellung -- wahrscheinlich Bewußtsein -- Sohn Strafe doppelt verdienen -- verbittert Freude glücklich Rettung -- 
  Folge ausgestandenen Schrecken Jammer -- finsteren -- trübe Blick Zukunft nagt morsch Körper -- ehe Mond verflossen -- schlummert Grab -- 
  Erbe -- Sohne hinterlassen -- gerichtlich Verwahrung nehmen -- Duldende -- Genüsse -- verwalt -- zinsbarer Kapital verwandeln -- 
  Sophie lieben -- lieben warm Jugendfeuer -- innig -- wahr Zärtlichkeit -- 
  _ verdenken -- wenigste finden -- Bürger Stadt -- Wilhelm Eltern denken -- 
  Allgeliebte retten -- müssen hart Strafe -- -- ewig dulden -- 
  Einbildungskraft überhüpft selten Fertigkeit kurz Zeitraum -- Wilhelm kettenlos Mensch umh wandeln -- arbeiten emsig anhaltend -- finden Unterstützung Nahrung fremd Stadt -- ehemalig Verbrechen kennen -- Bürger -- Gattin wählen -- reichen Hand -- sinken woune- freudefühlend Arm -- 
  angenehm Vorstellung -- trösten suchen -- Wehmut ergreifen -- schwarz Tiefsinn Herz nagen -- 
  Wilhelm schweres Verbrechen verüben -- Gelegenheit reizend einladend -- hinreichend -- echt Rechtschaffen Fall locken -- 
  Gedanke schrecken -- bang Sorge Zukunft erregen -- verzeihen -- entschuldigen stark -- Liebe -- 
  Mäntel -- abwechselnd tragen -- -- -- Auge undurchdringbar -- klein -- eng dünst Flore weben -- 
  ersteren bedeckt Mangel Fehler geliebt Gegenstand -- nahen -- letzter hüllen -- Abschied nehmen -- Reizender finden -- 
  Wilhelm Prinzessin führen -- Befehl Markgrafen Fürbitte -- Leben danken -- stehen Sophie Gemache -- 
  rotgeweint Auge -- tränend Blick überzeugen deutlich -- leiden -- Jammer -- -- Retterin Leben -- Mitwirkung Prinzessin schwerlich bitten -- 
  Beweis Liebe ermuntert Dankbarkeit -- treten nah -- 
  _ vergesse -- flüstert leis -- verdanken -- Gott schnell rauben -- wunderbar schenken -- 
  vergessen indes Unglücklichen -- Mitleids würdig -- 
  Sophie antworten -- Blick sprechen stark -- Wilhelm Gewißheit dannen -- lieben -- harren -- 
  Obristhofmeisterin kurz Gespräch bemerken -- Sophie redenden Blick sehen -- achten nötig -- letzterer unangenehm Folge warnen -- 
  Liebes Kind -- sprechen -- untersuch -- unglücklich -- strafbar Jüngling Liebe würdig -- _ hindern -- künftig Zustande deinen Kraft Wohltat erzeigsen -- Verlust dein Dienst Gnade streng verbieten -- Zuchthaus besuchen -- Gasse sprechen -- 
  deinen Ruf kränken -- Befehl übertreen Wolltest -- schwarz Schatten werfen -- dulden -- 
  ford fest Versprechen -- ruhig -- strafen -- erfülltest -- 
  Sophie Billigkeit Forderung -- versprechen -- streng gehorch -- bitten flehend -- einzig Erlaubnis gönnen -- Verbot kund -- Unglückliche Verachtung Seite halten -- Verzweiflung reizen -- 
  obgleich Obristhofmeisterin Schritt billigen -- großmütig -- verbieten -- fordern ausdrücklich -- Sofi -- geschehen müssen -- Zukunft Briefwechsel dürfen -- 
  Sophie danken -- eilt nämlich Wilhelm Mutter -- Teilnahme Wille innig lieben -- herzlich gerne Schwiegertochter umarmt -- 
  schreiben Wilhelm -- fügen -- Tröste erquicken -- hinzu -- 
  alt Frau -- Mutter Wilhelm sanden -- bringen mündlichen -- innigen -- vergönnen -- Antwort schreiben -- 
  Arbeit verbrech Zuchthause schwer anhaltend -- entkräftend hart schmal -- äußerst schlecht Kost -- reichen -- 
  Unglücklichen -- Freund Anverwandte -- Wohltäter Stadt finden -- müssen hungrig schlafen -- 
  schlecht Kost Strafe -- wahrscheinlich Folge Habsucht Vorsteher -- -- Haus duldeen -- erlauben -- gut Speise kaufen -- Geld außen erhalten -- 
  Wilhelm Eltern leben -- sandt unglücklich Sohn täglich Speise -- kurz sterben -- fühlen Wilhelm voll Last Schicksal Größe -- 
  Jugend gut Kost wohnen -- unüberwindlich Ekel hindert -- Genüsse -- reichen -- 
  Matt kraftlos taumelen umher -- bekommen Schlag -- vorgeschrieben Arbeit vollenden -- hoffen -- Tod marter enden -- alt Weib erscheinen -- nahrhaft Speise bringen -- 
  schützt streng Verbot -- Name Wohltäter fragen -- lächelen Geheimnisvoll -- -- Anverwandt nennen -- 
  Woche alt -- täglich Speis erscheinen -- dringend Bitte Gehör -- gestehen -- Sophie Wohltäterin -- Kost Teil -- stets Speis sättig -- übrig senden -- 
  Dankbar Träne rollt Nachricht Wang -- blicken gen Himmel -- scheinen Gott fragen -- 
  solch Liebe lohnen vergelten können -- 
  Sophie hoffen -- Wilhelm Strafe Fürbitte abzukürzen -- wenden -- Strafzeit verflossen -- auf Obristhofmeisterin -- helfen nützen -- Markgraf ausdrücklich Verlust Gnade untersagen -- Prinzessin ähnlich Bitte auffordern -- Lauf Gerechtigkeit hemmen -- 
  Nachricht liebend Herz äußerst weh -- Hoffnung -- übrig schwinden müssen -- süß Trost -- Schicksal Unglücklichen verborgene beweinen -- 
  Gedanke tröstet Vorstellung -- hindurch geliebter Wohltäterin -- hart viele erleichtern können -- senden täglich meister Speise -- bestimmen -- legen Woche Geld -- wissen -- Wilhelm gerne Tobak rauchen -- Vergnügen rauben -- 
  verfloss letzter Strafzeit -- 
  schnell anhaltend klopfen Sophies Herz -- letzter Monde -- letzter Woche -- letzter Nahte -- 
  rötet Wange -- rein Freude glänzen Auge -- Wilhelm Überbringerin Speise nochmals auf wärm Wohltat danken -- melden lassen -- Haus Strafe verlassen -- 
  -- fügen alt hinzu -- alt Muhme ziehen -- anständig kleiden -- wagen -- einladen -- mündlich danken -- 
  Sophie harrt Nachricht Ungeduld Liebenden entgegen -- 
  Wilhelm volle sehen -- müssen Hofe Zuchthauses arbeiten -- wagen -- jung Mädchen Zutritt verweigern -- Verlust Dienst sicher erfolgen -- Versuch Art verraten -- 
  denken Sehnsucht -- peinigend -- heischend Verlang liebend Mädchen -- 
  _ Sonntag -- Kirche -- andächtig beten -- suchend Auge umher blicken -- Mädchen Schloßhofe harren -- Brief überreichen -- 
  Wilhelm -- dankbegierig Wilhelm schreiben -- enthieln Einladung folgend Nachmittag alt Muhme -- liebreich aufnehmen -- wider Vermut Sophie Glück gründen versprechen -- 
  Sophie eilt bestimmt Stunde Wilhelm -- 
  zitternd Türe Gemach öffnet -- wankt Träne Auge entgegen -- Unglück wahrscheinlich Kummer Wang bleichen -- Auge glänzen Feuriger -- Mund sprechen -- beweisen deutlich -- Vergehen innig bereu -- ewig dankbar -- 
  alt -- geschwätzig Muhme stört Gefühl Liebenden -- loben Sophie Wohltat -- hindurch Vetter erweisen -- Wort -- 
  aufrichtig gestehen -- sprechen -- gottlos Bube -- Eltern Grab stürzen -- Freund schand -- vergessen -- 
  hören -- fremd Mädchen Leben retten -- ernähren -- denken -- Handelst hart -- Mußt vergeben vergessen -- 
  Gelübde halten -- künftig Glück gründen vermehren suchen -- künftig luderlich Streich begehen -- treu Mädchen Liebe lohnen -- 
  sprechen Tone fort -- nahen Turm Glocke Nachmittagspredigt raufen -- ergriff Gesangbuch -- eilen fort -- gönnt Liebenden selten Glück -- ungestört sprechen -- ungehindert Küssen -- 
  Bund ewig Treue Liebe wenige erneuern -- sogar Plan künftig Erfüllung entwerfen -- 
  Wilhelm erzählen Sophie -- väterlich Erbe nahe zweitausend Gulden betragen -- -- fügen hinzu -- hoffen erwarten können -- reich Muhme ähnlich Summe erhalten -- Summe hinlänglich -- Städtchen benachbart Fürstentum Handelsmann etablieren -- glücklich vorwurfsfrei leben -- 
  Sophie -- innig lieben -- gerne glücklich Zukunft träumen -- billigen Plan Herzen -- bitten sogar -- ausführen -- 
  besuchen Wilhelm öfters -- vorzüglich Sonntage -- Nachmittag arme durchleben -- 
  Wilhelm -- schand Sorge kränkend Vorwurf echt -- wahr Reue Zimmer fesseln -- gesellschaftlich Vergnügen hindern -- gewinnen voll Zutrau gutherzig alte -- Bitte erfüllen -- hinlänglich Summe unterstützen -- jäh Schlagfluß treffen -- Lebensfrist gönnt -- voll Bewußtsein reif Vernunft Vetter Universalerbe einsetzen -- 
  Wilhelm reich Mann -- Vermögen grenzen nahe fünfzehn tausend Gulden -- bestehen lauter sicher Kapitali -- jederzeit aufkündigen erheben -- 
  erstern -- Wand Sophie arme -- Ort suchen -- künftig ruhig leben -- Glück Liebe Genüsse können -- 
  Ehe scheiden -- fordern schlechterdings -- Sophie Dienst entsagen -- Eltern Rückkunft erwarten -- 
  arm Eltern -- zeitlich Glück Kind sehen -- billigen Sophie Wahl Entschluß -- fordern -- Wilhelm Abreise verloben -- willig -- Forderung erfüllen -- Sophie verlassen Schloß Wilhelm Abreise -- 
  verloben -- scheiden -- versprechen -- binnen Mondensfrist kehren -- sogleich heiraten -- 
  _ liebend Mädchen verdenken -- voll Gewißheit nah Glück dankbar wünschen -- minder streng Freiheit verweigern -- unvermerkt Flut brausenden Strom geraten -- fortreißen -- Welle nahen -- 
  Wilhelm scheiden -- mischen Träne Abschied Träne Reue -- verloren Unschuld -- Hoffnung baldig Wiederkehr trockenen -- 
  Liebenden verabreden -- Wilhelm Posttage schreiben -- Gesundheit Erfolg Unternehmen berichten sollen -- 
  erfüllt Versprechen streng -- Sophie erhalten Woche zweimal Nachricht -- trauert -- Brief laß -- Reise -- nirgends behagen -- 
  Monat verflossen -- Frankfurt letztenmal schreiben -- erfolgt Brief -- Nachricht -- 
  Sophies Kummer -- Folge unerträglich -- schwanger fühlen -- 
  Monat harren vergebens Nachricht -- Eltern Wilhelm Stillschweigen ebenfalls traurig -- Vorwurf beginnen -- schlecht Mensch Liebesverständnis einlassen -- gut Dienst leichtsinnig entsagen -- Rang ingeheim Trost Hilfe -- 
  erinnern -- Wilhelm Abreise rechtschaffen Advokat Verwaltung Vermögen anvertrauen -- eilt -- erfahren -- Wilhelm hindurch ebenfalls schreiben -- Tod beweinen -- -- fünfzig Dukat nehmen -- lang Geld verlangen -- 
  Todesbläs verbreitet Wang -- zittert bebt -- ehrlich Mann sogleich erzählen -- Wilhelm stets schreiben -- schreiben -- letzter Post letzter Rest Vermögen Frankfurt übersanden -- 
  -- fahren fort -- ersehen -- etablieren reich Mädchen heiraten -- 
  -- setzen hinzu -- gönn Glück herzlich gerne -- wünsch -- Dauer -- 
  kennen Vogel -- gelingen -- reich Braut heimzuführen -- 
  Sophie zentnerschwer Last -- Erzähler schnell -- unbarmherzig wälzt -- ertragen -- sinken kraftlos Boden -- 
  alte wecken laben -- forschen Name Ursache Schrecken -- ersteren stammeln -- erriet sogleich Ursache letzteren -- 
  erinnern -- Wilhelm Brief dringend bitten -- Aufenthalt Frankfurt -- vorzüglich gewiß Mädchen -- Sophie G -- nennen -- geheim halten -- 
  -- schreiben Undankbare -- Ursache bitte denken -- -- Granadier -- -- Mädchen hing klettenmäßig -- gewähren -- Genoß -- 
  Habsucht Eigennutz reizen -- ehemalig arm -- reich Liebhaber nachlaufen -- Art kühn Kreatur äußerst vorteilhaft -- glücklich machend Heirat hindern -- Stillschweigen namhaft Summe verkaufen -- 
  Advokat -- Fall Wilhelm schändlich Lüge voll Glaube beimaß -- mutmaßen -- Nachfrage ähnlich Ursache Absicht -- offenherzig -- leidend Sophie trocken Wort kund -- nebenbei wohlmeinend raten -- Klient Glück hindern mögen -- Fall spät -- Zorn -- Großmut reizen -- 
  Sophies Zustand schrecklich -- erbarmungswürdig -- 
  Blick hoffend fest Zukunft gehangen -- verfinstert glücklich Aussicht -- Abgrund öffnet Füßen -- schauderen -- Gräßlicherer liegen -- 
  fühlen verstoßen -- verlassen -- nirgends Trost -- nirgends Hoffnung -- Hilfe -- Sinn starrn wirkungslos umh -- Rad Einbildungskraft stockt -- tätig Seele drehen -- wenden -- 
  Undank Grausamkeit tödlich verwunden -- Schmerz durchbeben Nerve -- durchzittert Faser verlaßen Mädchen -- 
  Tropfen Blut rolln zentnerschwer Gedanke langsam Ader -- strömn hastig Herz -- vergebens Raum suchen -- 
  reden -- wanken -- verlassen Zimmer Advokat -- verlassen -- irren Gasse Stadt umher -- wissen -- wohin wollen -- 
  Abend finden suchend Mutter Garten entlegenst Vorstadt -- sitzen Gipfel hoch Linde -- breitet arm Himmel empor -- 
  Mädchen -- hinauf klettern -- verraten Aufenthalt -- 
  Mutter staunen selten Unternehmen -- staunt -- Tochter ängstlich Rufen hören -- willig herabstiegn -- deutlich beweisen -- Vernunft schlummeren -- Raub Wahnsinues -- 
  Folge bestätigen traurig Gewißheit vollkommen -- bleiben jammernd Eltern Geheimnis -- welch schrecklich Unglück arm Kind Abgrund stürzen -- entdecken Zufall Besuch -- Advokat -- erfahren gräßlich Meineid treulos Wilhelm -- 
  wahnsinnig Sophie Vernunft Gebrauch Sprache verlieren -- beantwortet Frage -- Uiemand hört Wort -- 
  -- daheim -- gefalteten Hand -- gesenkt Auge langsam nieder -- versuchen stets tief Seufzer -- drückend Last Herzen lösen -- 
  umgürtet Körper lang Flore -- heften linker Brust -- verlaßen Herz ruht -- schwarz Fleck -- 
  zittert beben -- wütet rast -- Zierat rauben -- schütteln langsam traurig Kopf -- trösten -- 
  entwischt Aufmerksamkeit Eltern -- eilt freie -- 
  suchend Mutter gewiß -- hoch Linde wiederfinden -- treffen Gipfel -- hocherhaben Hand beten scheinen -- 
  Wehmut füllen Herz -- teilnehmend Träne treten Auge -- leiden Unglücklichen denken -- Ursache nachforsch -- 
  hoch linde ersteigen -- andächtig beten -- 
  wahrscheinlich unendlich Schmerz -- übergroß Jammer Ewig klagen -- wahrscheinlich glauben Wahnsinne -- Gipfel Linde nah -- Höhe hören -- 
  -- schaudernerregend Bild -- Unglückliche -- nirgends Hilfe -- nirgends Trost weiten -- Erde finden -- hoch Baum erkletteren -- Höhe Ewig rufen -- Fleh Tiefe hören scheinen -- 
  Beweis hoch Drang -- groß Jammer -- fühlbar Schmerz -- 
  Monat sehen unglücklich Eltern unglücklichst Kind -- Jammer Ziel erreichen -- Folge mehren müssen -- erkannen deutlich -- Sophie schwanger -- 
  gerecht Klage schändlich meineidigen Verführer -- laut -- sprechen Stadt Sophies Unglücke -- Obristhofmeisterin erfahren -- Markgraf -- 
  staunt schrecklich Undank Jüngling -- Nachmittage Sophie Wohnung -- Wahrheit Geschichte überzeugen -- 
  unglücklicher -- Träne treten Auge -- beschenken Eltern reichlich -- versprechen -- 
  Stunde Rückkunft Schloß -- Kurier Frankfurt -- gemeßenen Auftrag -- Wilhelm Heirat hindern -- fürchterlich Drohung Rückkehr Ersatze leidend Unschuld bewegen -- 
  Abgesandte finden Wilhelm Frankfurt -- benachbart Städtchen schön -- reich Kaufmannstochter heiraten -- leben aufwande -- Zeugnis Sachkundig -- größeres Vermögen verschlingen -- 
  Bedenken -- Heirat Sofi -- reist Abgesandte Städtchen -- Freude lebend Wilhelm Schreckenspost Markgrafen kund -- 
  scheinen erschüttern -- zittert beben -- versprechen Abgesandt schriftlich Rechtfertigung Summe Gelde Unterstützung leidend Sophie überbringen -- 
  abgesandt Mittag Tag vergebens beide harren -- Wilhelm Wohnung -- finden groß Bestürzung -- erfahren -- Wilhelm Abende vorher Haus verschwinden -- mitgenommeu Sache urteilen -- entflohen -- 
  treulos Undankbare Land jemals betreten -- sprechen Markgraf -- Nachricht hören -- harren ewig Zuchthausstrafe -- 
  menschenfreundlich Fürst Vater Verlaßenen -- setzen jährlich Pension zweihunderen Talern -- versprechen -- Kind versorgen -- gebot Eltern -- Unglückliche Vorwurf kränken -- vielmehr sorgfältig Pflege schrecklich Zustand möglich Art erleichtern -- 
  sandte speis Tafel -- schütteln nachdenkend Kopf -- selten Liebe Mädchen -- schrecklich Undank Jüngling denken -- 
  fürstlich Fürsorge reizt Nahrungssorge befreit Eltern groß mehrere Aufmerksamkeit -- 
  Unglück verhüten -- Zustande -- verhinderten streng -- Sophie Garten -- hoch linde besteigen -- Meinung Ursache schrecklich Tod unglücklich Kind -- 
  Sophie beten -- Unglück -- äußerer Linderung fähig -- fordern innerer Trost Heftigkeit -- Wahnsinn verleitet Gedanke -- erhaben Ort beten können -- 
  alt Vater -- nötig Geschäft -- abwesend -- Mutter Nachbarin Haustür sprechen -- verlassen Sophie Zimmer -- eilt Boden Haus -- erklettert Dachfenster -- au Fenster Haus empor klimmen -- 
  Nachbar sehen -- ehe zn Hilfe eilen -- verlieren Körper Gleichgewichte -- stürzt Höhe herab -- liegen zerschmettert starrend Auge bebend Mutter -- 
  Wende nass Auge schrecklich Szene -- Markgrafen -- seufzen tief -- legen Hand fühlend Herz -- 
  nachher -- leich Ruhestätte begleiten -- Beispiel folgen Hof Stadt -- 
  rührend sehen -- Zug Gasse krumm Linie Sarge Unglücklichen nachwalln -- 
  Hofprediger müssen Leichenrede halten -- wählen Text -- 
  verlassen -- Herr -- 
  Auge trennen -- beginnen -- wankend Tugend lüsternen Mädchen vortrefflich Rede stark siegend Kampfe ermuntern -- 
  Markgraf lassen Grab Unglücklichen Leichensteine zieren -- zahlen trauernd Eltern zweihunderen Taler Tod -- 
  nachher -- Körper redlich Fürst Gruft Vater schlummern -- langt Rathause Stadt sogenannter Bettelfuhr -- 
  Sterbend ächzen Bund Stroh -- 
  Schrift -- Fuhrmann Rate überreichen -- überzeugen letzter sogleich -- sterbend undankbar -- treulos Wilhelm -- 
  Bettler benachbart Land Straße krank finden -- gemäß Aussage -- Geburtsort nötig Versorgung abgesandt -- 
  Spital tragen -- fürchterlich Todeskampf vollenden -- Gottesacker Zuchthauses beerdigen -- Leiche -- weint Grabe -- 
  ruhen -- dulden büßen -- 
  O gerne Vorhang lüften -- unendlich Jenseits blicken -- Verführer -- Meineidigen Gewißheit zurufen -- 
  büßen -- verbrach -- 
  Graf L-- -- 
  selten -- gemein Sprüchwort -- Ehen Vornehmen glücklich -- selten echt Liebe Neigung -- meistens Eigennutz Nebenabsicht Gehilfin wählen -- Hand Hand durch Leben wandern -- Kummer Freude -- Glück Unglück teilen -- 
  Graf L-- Wenig -- bloß Neigung Liebe wählen -- Glücklichste -- 
  sterbend -- reich Vater jammernd Sohne Erfüllung einzig wunsche -- verheiraten sehen -- Wehmut heischen -- führen Gehorsame arm -- schön tugendhaftes Mädchen Sterbebette -- 
  Stunde alte leben -- wichtig -- Untersuchung Stammbaum Braut verwenden -- segnen verlobten -- Genoß letzter Stunde Leben Freude -- einzig Sohn verheiraten sehen -- 
  zahlreich Adel Hauptstadt staunen selten schnell Heirat -- 
  Mutter Ursache -- hoffen -- ahnen- geldreich Graf Töchter Gemahlin wählen -- Vater glauben Zuversicht -- Glanz zahlreich Ahn erkennen -- Verschwendung arm gemacht Tochter reich glücklich -- 
  Aussicht vernichten verschwinden -- unbekannt -- arm Mädchen -- Assemblee erscheinen -- Gräfin -- Glanz Pracht verdunkeln -- 
  achtet streng Etikett Ahnenprobe -- zanksüchtig Neid wirken stark -- Achtung -- Dame beschließen -- -- damalig Sitt Gewohnheit -- jung Gräfin Gesellschaft aufführen wollen -- Gatt vorher Zirkel Mann deutlich klar erweisen -- echt Adel abstammen -- apartmentmässig -- 
  kennen Gesinnung Graf Erfahrung -- wissen -- Stolz Adel lustig -- hoffen -- Ursache -- vermögen -- Probe leisten -- herrlich rächen -- 
  Graf L-- alt -- vermählt -- Reichtum berechtigen -- frei unabhängig schön Landgütern leben -- tätig Geist verachten Müßiggang lästig Ruhe -- achtzehnt Alter treten Dienst Monarch -- steigen Verdienst -- Fürsprache -- hoch -- Monat -- Tod Vater -- Präsident Landesregierung ernennen -- 
  äußerst liebend Gattin still -- häuslich Ruhe leben -- Trauer öffentlich Ort erscheinen -- wahrscheinlich erscheinen -- neu Amt Pflicht auferlegen -- 
  empfangen Präsident Monarch sogenannter Tafelgelder -- müssen täglich gewiß öffentlich Tafel geben -- -- wahrscheinlich Name Monarch -- hoch Adel bewirn -- 
  Ehe Monat verfließen -- erscheinen -- sandte gewöhnlich Einladungsbillet umher -- staunen -- Entschuldigung erhalten -- 
  glaubt Ursache erraten -- Monarch -- 
  Fürst -- sprechen offen Tone -- bitte -- Tafelgelder auszahlen lassen -- benutzen -- Einladungsbillet leer Entschuldigung zurückgesendet -- 
  Fürst -- 
  Zurückgesendet -- 
  Ursache -- 
  Graf -- 
  ausdrücklich vermögen angeben -- höchst wahrscheinlich Ist -- arm Mädchen heiraten -- Tugend -- vortrefflich Denkungsart bewunderten -- Bewunderung selten Vorzug fragen vergaß -- 
  malten -- sechzehn Name beschrieben Baum Vater erben -- 
  Fürst -- 
  -- lächelnd -- _ -- Geheim munkeln -- Graf L-- -- angesehen Kavalier Land -- Bürgerliche heiraten -- 
  Graf -- 
  -- warm Empfindung -- 
  Adel Seele groß -- Schönheit Körper -- 
  sehen -- Unterschied Dame finden können -- Grafe L -- s -- fürstlich Präsident Gattin -- 
  Fürst -- 
  sprechen Wärme -- 
  Graf -- 
  glauben -- Wahrheit -- Fürst -- 
  Vater Gattin -- 
  Graf -- 
  nennen -- -- stehen Hauptmann Dienst Königs -- -- sterben Schlachtfelde L-- -- Fürst -- 
  kurz -- ehrenvoll Biographie -- 
  Graf -- 
  ruhmvoll -- lebensgeschicht Domherrn -- deutsch Ritter Dreissig dokumentiert stiftsmäßig Ahn -- 
  Fürst -- 
  -- lachend -- Graf -- Sonderling -- Sonderlinge Art gerne Präsident -- Verdienst -- Geburt Zufall sehen -- 
  Graf -- 
  Antwort euer Durchlaucht Fürst -- sein -- 
  Fürst -- 
  danken -- Graf -- nehm Schmeichelei -- rein Empfindung Wahrheitsliebe -- 
  -- -- 
  Tafel gewöhnlich geben -- 
  Graf -- 
  -- lächelnd -- Gast -- 
  Fürst -- O ausbleiben -- 
  warten -- -- Sache ordnen -- 
  Tafel geben -- Einladungsbillet Entschuldigung zurücksenden -- 
  Graf -- 
  O gewiß -- 
  Fürst -- 
  -- nebst unbekannt Gemahlin Gast -- 
  Graf -- 
  abermals Etikett versündigen -- 
  weib betrauert Verlust geliebt Vater -- letzter Augenblick Hand meinig legen -- Verbindung kräftig segnen -- 
  durchlauchtigst Fürstin vorstellen -- ohnedies Hofe erscheinen -- überdies -- -- Fürst -- 
  O wissen -- sagen -- 
  entschuldigen -- Fürstin sprechen -- erschein Gattin bestimmt zwölf Kabinett Fürstin -- 
  Ausrede finden -- 
  erscheinen -- 
  Graf -- 
  euer Durchlaucht ausdrücklich befehlen -- 
  Fürst -- 
  -- befehlen -- 
  leben -- 
  Graf -- Gattin Befehl Fürst kund -- lästig -- lieben Einsamkeit Ruhe -- fürchten Hohn Verachtung hoffärtig Dame -- fügen Wille Gatten -- Befehl Fürst -- 
  Indes geschehen -- Gesellschaft Assemblee Gespräch leer Tafel Präsident Tagesordnung -- 
  Witzling -- stets jung Kavalier -- erschöpfen lustig Einfäll -- 
  lachen -- sprechen -- sogar alt Dame billigt Herz Rache -- Präsident üben -- übel Folge ziehen -- unerfahren Junker bürgerlich -- reizend Gesicht schön -- ahnen- fleckenreich Gesicht stiftsmäßig Fräulein finden -- Zahl schreckensvoll Meßallianze vermehren können -- 
  Rachetriumph mehren -- kund -- Fürst wichtig Grund bewegen -- Tafel -- Präsident Name geben müssen -- geben -- Ursache Einladung -- 
  seht Folge schrecklich Meßallianz -- sprechen alte -- blicken warnend Auge Sohn -- Bürgerhause schlichen -- häuslich Ruhe Glückseligkeit zerstören suchen -- 
  stolz frei blickt ahnenreich Fräulein umher -- danken ingeheim Gott -- stand Welt setzen -- appartementmäßig Tafel geben -- Heiducke halten -- öffentlich Aufzüg Pferd fahren -- 
  geben -- rufen alt Rat -- Vorsitze jung Präsident fleißig Rate erscheinen -- tätig arbeiten müssen -- verlieren nächster Präsidentenstelle -- 
  gewisses -- antwortet Dame -- vornehm Pflicht erfüllen -- Tafel geben -- Kränkung Ehre erscheinen -- 
  arm -- unselig bürgerlich Reiz verführt Graf _ bereuen -- verachten verlassen auf Land ziehen -- unerträglich Langenweil -- Gesellschaft roh Bauer junge verleben -- 
  Rache schrecklich -- verdienen -- kühn Schritt beleidigt Gesetz Natur -- ausdrücklich gebiet -- verbinden -- Folge ausbleiben -- 
  Geschwätz stolz Unsinn -- Eile wichtigeren -- schöneren Begebenheite -- 
  Graf erscheinen bestimmt schön Gattin Kabinette Fürstin -- 
  gnädig -- lieben Fürst Leidenschaft Wärme -- ausdrücklich fordern -- Fürstin eilt offen arme jung Gräfin entgegen -- 
  müssen Platz Toilette nehmen -- bescheiden Art -- unerwartet Glück annehmen -- verdienen suchen -- Richtigkeit -- sprechen -- Wärme -- Gespräch Wahrheit verteidigen -- Kenntnis -- Gespräch verraten -- erwerben wirklich Achtung Freundschaft Fürstin -- 
  Seele finden -- wissen schnell schätzen -- 
  Fürstin aufrichtig -- Fürst Kabinett treten -- lächelnd fragen -- 
  Gesellschaft behagen -- 
  Freundin -- antworten Fürstin -- hoffen angenehm Stunde Gesellschaft Genüssen -- 
  Wahl Herz verstand Ehre -- sprechen Fürst vergnügt Blick Grafe -- reichen Gräfin Arm -- voran -- Speisesaal führen -- Fürstin folgen arm Grafe -- 
  hoch Adel Hauptstadt Speisesaale versammeln -- Tür öfueten -- Gesicht bleichn -- verziehen mächtig Falte -- verhaßen Bürgerin arm Fürst erblicken -- 
  kannen -- ehe forsch Frage -- 
  fremd Dame -- 
  Ergriff Fürstin Hand Gräfin -- führen Dame Hof Bemerkung -- würdig Gemahlin Herr Präsident Grafe L-- -- glücklich schätz -- Bekanntschaft -- 
  Mitleids würdig -- staunend Dame Fassung erhalten suchen -- freundlich -- freundlich müssen -- 
  Fürst -- lächelen -- 
  Platz Tafel -- Gräfin sitzen Seite Fürst -- Graf Fürstin -- 
  schweigen -- sprechen -- Gräfin -- innerer Wert fühlen beginnen -- zeichnen äußerst vorteilhaft Art -- 
  Tafelnde suchen Schicksal fügen -- Wunde -- Stolz empfangen -- fühlbar -- eilt -- geschwind -- fühlbar -- verbind verhehlen -- 
  anwesend Kavalier stammelten Gräfin aufgehoben Tafel Verehrung -- Dame Stahl -- Ingeheim zuflüstern -- glücklich schätzen -- Besuche erfreuen -- 
  Tafel sitzen -- sprechen Fürst -- apropos -- Präsident -- fallen _ -- Vergnügen berauben -- groß angenehm Gesellschaft Name bewiren -- Pflicht entbinden -- 
  Bestimmen -- beisammen -- -- erfüllen -- 
  Graf -- 
  überlass Bestimmung euer Durchlaucht -- 
  Fürst -- 
  künftig Montag -- Frau Geburtstag feiern -- hoffen -- laden -- willig erscheinen -- schön Gesellschaft gewiß angenehm zubringen -- 
  Wahl übrig Gesellschaft überlassen -- gewiß -- Freund wählen -- 
  Donnerwort wirken mächtig -- wünschen herzlich Tafel nehmen -- Freund Fürst achten -- Kamm -- Verachtung schnell Verehrung verwandeln -- groß Begierde Freundschaft Grafe Gattin suchen -- 
  großmütig -- Gegenrache üben -- genießen verdient Triumph stille -- kommen -- naht -- Freundlichkeit entgegen -- 
  -- laden wünschen -- laden -- verpflichtet äußerlich Hochachtung -- innerlich Danke -- 
  Fürst Fürstin bemühen -- bestimmt Gräfin auf Dame auszuzeichnen -- Bemühung Ursache -- vergessen scheinen -- 
  einst -- 
  achteten -- 
  -- 
  Graf Genoß Präsident voll Zutraun Fürst -- Tafel zahlreich besuchen -- Gräfin erscheinen -- aufführen -- öffentlich Ort -- Gesellschaft Hof -- überall schätzen ehren -- Fürstin Freundin lieben -- 
  freilich heimen -- vertrauen Zirkel Name gut Gräfin eitel nennen -- bitter allzu leutselig Betrag fürstlich Paar glossiert -- 
  freilich _ hochadlig Herr Dame -- Handlung Verlezzung teuer beeidet Landesverfassung -- Eingriff Adel -- despotisch Machtspruch schildern -- kommen überein -- reißend Strome widerstehen können -- gelegen harren müssen -- unverdienen -- höchst kränkend Demütigung rächen können -- 
  Verflossen -- gewünscht -- sehnlich erwartet Gelegenheit Rache erscheinen -- 
  mehren Vertrauen Fürst Grafe -- Freundschaft Fürstin Gräfin -- 
  geduldig zusehen -- Fürst unadlig Bastarde -- Gräfin Gatten erfreute -- Hand Taufe tragen -- Name adeln -- 
  gerne Ruf Gräfin Verdacht beflecken -- Fürst Ursache auszeichnend Handlung müssen -- Gräfin möglich Scheingrund Vermutung liefern -- letzterer außerordentlich -- überall hervorleuchtend Liebe Gatte geradezu widersprechen -- 
  -- -- -- 
  bemühen -- eingebilden -- geduldet Unrecht vergessen -- sehnlich erwartet Gelegenheit nahen scheinen -- schlafend Rache wecken -- Kämpfer Kampfe vereinen -- 
  fremd Kavalier erscheinen Hof -- schön reizend Schwester suchen Fürst Wohltat erlangen -- reich Erbschaft Form rechtens verloren Prozeß erneuern -- groß -- Beweis Vorteil lenken -- 
  Fürst begegnet öffentlich Gesellschaft fremd Kavalier -- schön Schwester besonderer Achtung -- -- ungeachtet Präsident wiederriet -- Beweis geringfügig verwerfen -- ausdrücklich Erlaubnis -- Prozeß beginnen -- völlig Entscheidung vorbehalten sollen -- 
  ungewöhnlich Entscheidung Fürst Ursache Nachdenken -- vermehren stark -- deutlich gewahren -- Fremde samt Schwester Aufwand machen -- allgemein -- arm sein -- Hoffnung -- unsicher Prozeß leben -- 
  spüren eifrig Quelle unerwartet Aufwand -- eilen -- entdecken glauben -- groß Begierde anscheinend Favoritin -- teils Bekanntschaft künftig Nutzen ziehen -- teils Gelegenheit finden -- mächtig Kanal Präsident Gattin nachdrücklich rächen -- 
  fremd Dame scheinen Komplott einstimmen -- weit -- Erde auszeichnend anderer Eigentum ahnenreichen Adelsbrief besessen -- einzig Reichtum schätzen -- Gelegenheit glorreich Vorfahre sprechen -- 
  fremd Beweise erschöpfen -- Adel Vaterlaut dulden -- Witze beigefügen -- Ursache einsehen können -- 
  Präsident uralt -- ansehnlich Familie reich Erbschaft -- gering -- ahnenärm Familie zugesprochen -- treten Bruder zahlreich Zirkel -- versammeln -- 
  -- sprechen bramarbasierend Tone -- Herr Dame insgesamt -- 
  edl Stolz besitzen -- Beleidigung ahnden rächen -- 
  -- 
  -- Wille Fürst handeln -- 
  Fremd -- 
  -- Bürgermädchen -- gewaltsam eur geschloßen Gesellschaft eindrängen -- ehrliebend Ausländer verhindern -- nehmen -- 
  abscheulich Meßallianz Wort erfahren -- Präsident tisch Bisse gegessen -- Haus Karte anrühren -- 
  Gewalt vermögen -- List siegen -- 
  Mitglied eur Bund -- längst Bürgerliche Gesellschaft weichen -- daheim tief fühlen -- hoch Treppe überspringen -- Stufenweisse ersteigen -- 
  -- Anwesende zuckt Achsel -- -- 
  Warten -- warten -- _ lehr -- dergleich Fall handeln -- 
  Spiel Hofe -- _ -- Tisch Frau Bürgerin drängen -- sollen eur Freude erleben -- bloß Witz treffend Anspielung stolz Ding demütigen -- 
  weten -- -- -- fühlen -- bürgerlich Haut fein Stiche reizbar -- wiederholen stark -- _ fühlen -- demütig Schneckenhaus zurückziehen -- 
  lachen -- freut herrlich Szene -- geben absichtlich fremd wohlmeinend Rat -- überlegen bedenken -- solch Scherz Ungnade Fürst Fürstin ziehen können -- Fremde bemerkbar Seitenblick Schwester versichern -- Fürst Bagatells -- Gnade entziehen -- Schwester überdies impertinent -- Bruder Behauptung geheimnisvoll Lächel bestätigen -- wissen -- wissen -- überzeugen -- Rache gelingen -- 
  Auge ruht fremde -- kühn Spieltisch Präsidentin drängen -- Gefällig sogleich Erlaubnis erhalten -- Spiel nehmen -- 
  wider Gewohnheit wnrde benachbart Tisch äußerst zerstreut spielen -- sprechen Wort -- gerne hören -- stolz Fremde Wort erfüllen -- 
  Tarockspiel dazumal Bürger Bierhäuser verbannen -- spielen häufig Hof -- Präsidentin spielt Gesellschaft -- 
  still durchspielt Partien ereignet Zufall -- Präsidentin skisirt Kavallerie ansagen -- Fremd wirklich natürlich besitzen -- 
  Verzeihung -- sprechen lächelnd Tone -- vorzeigen -- diesmal Bruder Monsieur Skis Vorzug gönnen -- natürlich Kavallerie -- 
  Präsidentin -- 
  -- lächelnd -- unschuldig Tone -- Skis Bruder -- 
  Fremd -- -- Karte ordnend hingeworfen Tone -- Madam -- 
  Präsidentin -- 
  -- 
  Fremd -- 
  -- gleich Tone fortsprechend -- 
  Monsieur Skis rechtkühn Kerl -- mengen -- Dame -- gemein Geselle -- Notfalle brauchen -- 
  herzlich leiben -- Hoffärtige demütigen -- beweisen -- wirklich Dame -- skisiren Dame -- 
  -- Präsidentin anblickend -- Madam -- spielen -- 
  _ -- Wort sprechen -- 
  Wang röten -- niedergeschlagen Auge ruht Karte -- 
  vermehrt Triumph anwesend -- Gespräch deutlich gehören -- still Hohngelächter Tisch verbreiten -- 
  Präsidentin spielen fort -- endigen Spiel Vorwande gewöhnlich -- 
  gebraucht verloren Marke Geld auswechseln -- entfiel merkbar zitternd Hand Dukat -- bücken -- suchen Tisch -- 
  Fremd -- Prahlsucht Pack Bannkut herausgezogen -- Spielschuld bezahlen -- ergreifen sogleich Banknot hundert Taler -- drehen Gegenwart vieler stehend Kavalier Gestalt Fidibus -- zünden behend Wachskerze -- leuchtet Dukat suchend Gräfin -- 
  schreien lachen -- sogar kühn -- Gräfin herrlich Gedanke erzählen -- Noble Erhabene loben -- 
  Präsidentin entfernen stillschweigend -- eilt Haus -- 
  Gatt -- lang Partie spieltisch fesseln -- heimkehren -- wischen Träne Auge -- gewöhnlich Freundlichkeit entgegen -- 
  Suchst -- sprechen ernst Tone -- vergebens Träne verbergen -- fließen gerecht -- Pflicht -- still -- Schimpf rächen -- 
  ungeachtet Gräfin Mühe -- Gatte besänftigen bewegen -- Wille Zank Streit suchen -- Genugtuung fordern mögen -- bestehen hartnäckig letzterer -- verschweigen Art -- fordern -- 
  anbrach -- verlassen Lager -- Nacht schlaflos durchwachen -- Vorwande -- wichtig Geschäft -- Kabinett -- 
  schreiben Brief -- senden Kammerdiener fort -- Stunde Rückantwort überbrachen -- 
  Las merkbarem vergnügen -- bleiben Kabinett -- Kind besuchen -- Leibhusar Fürsten erscheinen -- schnell Hof berufen -- 
  Fürst empfangen ernst Blick -- 
  -- sprechen -- fremd Grafe R-- herausfordern -- 
  Graf -- 
  -- euer Durchlaucht -- 
  -- fest Tone -- 
  _ leugnen -- 
  Fürst -- 
  versprechen erscheinen -- 
  Graf -- 
  -- euer Durchlaucht -- 
  Fürst -- 
  verbieten -- verbiet groß Ungnade -- schärfst Ahnung -- 
  fremde verdenken -- _ zusagen -- fordern -- -- _ doppelt verdenken -- 
  kennen Gesetz Land -- 
  wagen -- Chef verteidig Art fragen -- gestehen -- fest Vorsatze verletzen wollen -- 
  unbedingt Gehorsam vergessen -- müssen ahnden rächen -- 
  Graf -- euer Durchlaucht -- fühlen _ -- Amt kränken -- unwürdig -- 
  bitte euer Durchlaucht untertänigst -- Amt entlassen -- 
  Fürst -- 
  -- zornig -- ernstlich Bitte -- 
  Graf -- 
  bitten dringend -- ernstlich -- 
  Fürst -- 
  gewähren -- 
  Graf -- 
  danken innigst demütigst -- 
  Fürst -- 
  glauben etwan -- stolz Entsagung Dienst berechtigen -- Gedanke Duelles ausführen -- 
  Untersage auf -- versich Wort Ehre -- ernst Maßregel ergreifen -- zeitlebens Festung setzen -- Min -- streng Verbot übertreten -- 
  Graf -- 
  Ah -- hart -- 
  Ah -- rastlos Eifer Dienst Fürst verdienen -- 
  Fürst -- 
  sprech würdig Präsident Land -- Kühne -- Gesetz Füßen treten -- 
  angenehm -- Fürst warnen -- strafen -- 
  Graf tun -- verwegen Rache schreiten -- 
  Graf -- 
  Gattin beleidigen -- Fürst -- 
  wissen -- -- Graf -- 
  Gattin tief beleidigen -- 
  Fürst -- 
  gegenwärtig Zeuge -- glauben glauben -- erfahren -- _ Begierde -- Witz glänzen -- eigentlich Absicht -- Gattin beleidigen -- 
  Rücksicht verdienen Sache Vergessenheit -- dringend anempfehlen -- 
  Graf -- 
  -- vergessen -- 
  Ehre erlauben -- 
  Fürst -- 
  wahres Vorurteil -- 
  Graf -- 
  Seies Vorurteil -- Welt achten -- einzig -- _ vernichten wagen -- 
  Fürst -- 
  Sonderling -- 
  verzeihen -- sagen -- Undankbarer -- 
  kühn stärk Vorurteil hinweggesetzen -- heirateten -- kosten Mühe Arbeit -- Schritt verteidigen -- -- billig Vergeltungsrecht -- Überwindung klein obendrein sträflich Vorurteil ford -- bestehen Vorsatze -- 
  Graf -- 
  entfernen -- 
  Fürst -- 
  -- hören -- 
  Graf -- 
  Fürst sprech -- treu Untertan hören -- 
  Fürst -- 
  erwarten -- 
  fremd Grafe verdenken -- Vorurteil stolz -- verteidigen suchen -- 
  Graf -- 
  O verdenke -- hoff gleich Billigkeit -- 
  Fürst -- 
  wandeln verboten Schleichweg -- 
  Graf -- euer Durchlaucht zwingen -- 
  Fürst -- 
  -- Güte -- Straße zurückführen -- vergeben vergessen -- Gelegenheit Versöhnung -- 
  ausschlagen -- 
  Graf -- 
  -- 
  Graf R-- zahlreich Gesellschaft -- Gattin beleidign -- öffentlich Vergebung bitten -- 
  -- -- Fürst -- 
  O verlangen Unmöglichkeite -- 
  Graf -- 
  leicht Möglichkeit -- Leben gleichgültig -- 
  Fürst -- 
  -- zornig -- übergenug -- 
  binnen Stunde Residenz verlassen -- Frau folgen -- 
  -- -- Angesicht erscheinen -- 
  -- Reue anwandelt -- Bedenken -- Strafe Hartnäckigkeit verdienen -- 
  Graf -- 
  danken -- 
  danken -- 
  entfernen -- 
  Fürst -- 
  -- 
  -- 
  Graf -- 
  Unterdrückter -- gehemmt Zorn Begierde Rache leiten Schritt -- Meister Vernunft -- schrecklich Folge erwägen -- 
  eigentlich Vorsatz -- -- treten Wohnung fremd Grafe -- Zimmer zahlreich Gesellschaft befinden -- kommen -- Glückwünsch heroisch -- glänzend Witz -- ferner Tat anzufeuern -- 
  schworen teuer -- rasen -- ruh -- bürgerlich Präsidentin Gesellschaft verdrängen -- Präsident Zimmer stürmen -- 
  stolz Bramarbas erbleichen -- niedrig denkend Schmeichler ziehen -- 
  Graf L-- -- 
  Brief erhalten -- Graf R-- -- 
  -- antworten -- Fürst _ ausdrücklich untersagen -- -- -- Graf L-- -- 
  feigherzig Schurk -- wehrlos Weiber beleidigen -- Manne Rede stehen -- Graf R-- -- 
  Herr Graf -- 
  Herr Präsident -- 
  Graf L-- -- 
  Ausforderung absichtlich -- Fürst erfahren verhindern -- 
  zaghaft Bube -- Rächen Schimpf -- Mut -- Graf R-- -- 
  -- Gästen -- 
  Herr -- verhindern Unglück -- -- Graf L-- -- 
  Schurk -- zieh -- 
  Drang Deg -- Graf R-- ziehen seinigen -- verteidigen schwach -- furchtsam ungeschickt -- ehe anwesend Mut faßn -- Streitender hindern -- sinken Graf R-- röchelnd Boden -- Stich Lunge rauben Stunde Leben -- 
  wagen -- wütenden Grafe L-- anhalten -- -- Graf R-- Boden sinken -- eilend entfernen -- 
  Blut Wunde Ermordeten hervorströmen -- entfloh hohnlachend gesättigt Rache -- Zorn Wut folgen -- überließen Täter rückkehrend Vernunft -- 
  raten schnell Flucht -- -- ehe Fürst berufen -- satteln geboten -- erinnern Befehl -- eilt Haus -- schwingen bereitstehend Roß -- jagen unaufhaltsam dannen -- 
  lieben Weib auf innigst -- zärtlichster Vater Kind -- Furcht -- Angst Reue erlauben -- sehen Herz drücken -- überzeugen -- trennen -- Fleh hören -- wissen -- Rabenstein Totenbett müssen -- bleiben -- eilt Fort -- schmählichen Tod retten -- Weibe groß Jammer -- Kind schand ersparen -- 
  Stunde erfahren Fürst Grafe R -- -- Tod -- 
  wütet raste -- schwor teuer -- beide streng rächen -- 
  Gerechtigkeitslieb -- heftig Leidenschaft Urheberin Schwurs -- 
  Späher Handlung weise urteilen -- lieben fremd Gräfin innig zärtlich -- suchen Gegenliebe prächtig Geschenk -- groß Versprechung gewinnen -- 
  beide -- Widerstand -- facht Flamme hell -- 
  Wohnung schlich -- Geschenk Kuß erbetteln -- treten Bruder -- Graf R-- -- bleich Angesichte Zimmer -- sprechen heimlich -- übergeben schreckbar Ausforderungsbillet Grafe L-- -- 
  versprechen Furchtsam Vermittlung -- leicht Herz dannen -- 
  fort -- erzählt Listige verliebt Fürst -- versprechen freiwillig Küs -- lassen mehrere hoffen -- Sache vermittle -- Präsident schweigen müssen -- Bruder Scherz Todesgefahr entreißen -- 
  Fürst Wort -- glauben Entfernung Präsident erfüllen -- Gräfin eilen -- Frucht Bemühung ernt -- schrecklich Nachricht -- 
  Unschuld beweisen -- darzutun -- Wort getreu erfüllen -- betrübt Schwester trösten -- fahren erstenmal öffentlich Wohnung Gräfin -- 
  weinen -- Fürst erblicken -- stockt Träne -- ergriff Hand -- führen stillschweigend Zimmer ermordeter -- 
  -- sprechen furchtbar Tone -- Bruder -- Präsident Mörder -- 
  Rabenstein bluten -- Weib samt verflucht Brut fremd Tür Brot betteln -- -- 
  Fürst -- sprech -- Ihrig -- 
  Ruchlose bluten -- Weib Kind betteln -- Wort -- ferner sprech -- letzter -- Mund aussprechen vermögen -- 
  schwör Leiche geliebt Bruder -- _ halten all Lebelang -- 
  Wort entschlüpft Hand Fürst -- bewegen -- Türe verschloßen Kabinett öffnen -- 
  gütig -- menschenfreundlich Fürst lieben Innig -- lieben äußerst heftig -- 
  Leidenschaft -- schmachten -- rasen wüten -- Widerstand finden -- leiten Handlung -- überdies Eile Hitze ausüben -- 
  sitzen arm Gattin -- unbekannt -- Zimmer -- Spiel Kind -- abgesandt Fürst eintraten -- Schonung rasch Gatte -- streng Befehl Fürst machen -- Haus durchsuchen -- Täter Schonung arretieren -- Fall Hab Eigentum versiegeln -- 
  arme zittert beben -- vorher weinen -- Graf heimkehren -- Vorsatz ahnden -- bitten innig Gott -- Schritt entfernen mögen -- danken inbrünstig -- treu Diener -- Sorge erriet -- heimlich zuflüsteren -- Graf Stunde vorher schnellst Reitpferde ausgeriten -- wahrscheinlich entfliehen -- 
  untersuchen Streng -- erstatten -- finden -- Bericht -- 
  Wut Fürst reizen -- husaren müssen aufsitzen -- Steckbriefen Hand Land durchjagen -- 
  Post Pferd -- Kurier fördern -- dringend Ersuchschreibe benachbart Staat abgesandt -- Mörder anhalten ausliefern -- 
  Haus Stadt sein streng durchsuchen -- Zeuge auftreten sein -- aussagen -- Graf durch Tor jagen -- 
  Ehe Stunde verfließen -- erscholl Stadt Nachricht -- Unglücklichen -- halb Stunde Stadt Pferde stürzen -- Fuß verrenken -- Bauernhütt -- verbergen -- entdecken Gefängnis zurückführen -- 
  schrecklich Nachricht Freund -- schrecklich Gattin -- Ohnmacht wecken -- stark sinken -- 
  Bürger lieben gerecht Präsident -- Adel müssen verehren -- bemitleideten -- kommen -- 
  Trauer still Ernst Stadt allgemein -- Fürst -- ehemals Beschützer -- Freund -- jubelt -- Gefangenschaft vernehmen -- vergessen -- verlassen Tafel -- sitzen -- Schwester Ermordeten eilen -- Erfolg Bemühung kund -- 
  wider Vermut vorgelassen -- 
  schwarz Kleide -- Schönheit viele erhöhen -- sitzen Sofa -- hört Erzählung stillschweigend -- scheinen lächeln -- beantwortet Frage -- bewegen -- Wort verliebt Fürst sprechen -- 
  Weib -- schreiben -- anhaltend flehen -- Stückchen Papier -- stark Manne Schwor halten treu erfüllen -- 
  Fürst erhalten -- eilt fest Vorsatze fort -- Erfüllung Kraft befördern -- 
  Eile -- heftigsen Rache -- echt Gerechtigkeitslieb ähnlich -- nämlich besonderer Kommission niedergesetzen -- ernst Auftrag erhalten -- Unglücklichen Strenge untersuchen -- befinden -- Todesurteil Konfiskation Vermögen sogleich aussprechen -- 
  Mitglied Kommission feind Neider Grafe allgemein -- Vorsatz -- bloß Zufall vereinen -- Fürst ausdrücklich erklären -- Wahrheit untersuchen -- Formalie binden sollen -- _ begreifen -- Kommission binnen Fürst nebst geschloßen Akte Todesurteil Befehl Vermögenskonfiskation vorlegen -- 
  unglücklich Graf Untersuchung freiwillig Geständnis erleichtern -- appellieren Gnade Fürsten -- verweigern -- Todesurteil Befehl sogleich unterschreiben -- 
  Indes Fürst geliebter eilt -- Nachricht günstig Blick ernten -- eilen Kommissair Haus unglücklichen Präsidentin -- 
  Hoffnung -- Teure retten -- Ohnmacht wecken -- Begierde -- Leben frisen -- angstvoll aufrecht erhalten -- 
  lassen unversucht -- edl Zweck erreichen -- fleht Fürst Audienz -- verweigern streng -- suchen Gemächer dringen -- aufmerksam Wache vereitelt Bemühung -- Freundin -- gütigen Fürstin eilen -- versagt Wache Zutritt -- täglich Gelegenheit laueren -- Fürstin gewöhnlich Spaziergäng sprechen -- traurig Nachricht -- Fürst Gemahlin streng begegnen -- Spaziergang untersagen -- 
  größtem verlangen Antwort Brief entgegen -- alt Kammerfrau -- Träne erweicht -- Fürstin heimlich übergeben -- versprechen -- Kommissäre Zimmer treten -- Unglücklichen Schonung machen -- Fürst vorher unterzeichnen -- 
  Kraft wichen -- sinken leblos Erde -- Angst nahend Verzweiflung reißen Knie empor -- strecken Arm fürchterlich Höhe -- fleht zitternd Lippe -- stammelnd Wort Gott Allmacht Barmherzigkeit Rettung herab -- 
  scheinen -- fühlen -- -- anfangs Eigentum erkennen -- Siegel belegen -- folgen willig -- kund -- Haus -- fürstlich Befehl konfiszieren -- verlassen müssen -- 
  alt -- treust Diener -- leiten elend Wohnung -- führen Kind Arm -- blicken starrem Auge Himmel empor -- 
  Menge Volks folgen Leidende tränend Auge -- gerührt Herz -- 
  wähnen treu Diener -- Vernunft Raub Jammer -- lang Stunde Starrsucht erwachen -- dringend bitten -- alt Kammerfrau Fürstin eilen -- anzufragen -- 
  Hoffnung Erde grünen -- 
  Greis eilen fort -- kehren atemlos Brief -- Kammerfrau erhalten -- 
  einzig Hoffnung -- Herz hing -- Erde erwarten -- greifen Sehnsuchtsvoll hastig -- lesen folgendes -- 
  -- -- teuer Freundin Gefährden Jammer -- fühlen Unglück vollkommen -- deutlich überzeugen -- fähig -- anderer Träne still -- Meinig Ihrig vermischen -- 
  -- Fleh Ohr drang -- Herz schrecklich preßen -- wagen -- Fürst dringend bitten -- Gnade ergehen lassen -- arm Waise Vater -- jammernd Gattin geliebt Gemahl erhalten -- bitten -- flehen vergebens -- 
  Freundin -- 
  schrecklich -- -- 
  lieb Gatte verlieren -- fesseln Herz -- füllen Rache -- 
  -- Übersatte Bitte Weibe hören -- Allgeliebt -- stark reizend Schwester Ermordeten unaufhörlich blutig Rache heischt -- 
  tragen hart Schicksal Geduld Standhaftigkeit -- Sterblicher rühmen -- Träne sehen -- Zukunft empfindsam Auge hart pressen -- Gegenwart Allwissende strömen -- leiden kennen -- entscheiden -- 
  Lohn gebühren -- 
  gleich Rat erteilen -- schrecklich Unglück Standhaftigkeit fähig -- 
  blicken vergebens Rettung umher -- sehen Weg -- leiten -- 
  fallen Stolze hart -- fahren -- gelten Leben Mensch -- Stolz weichen -- 
  Wort Schwester Getötete -- bitte ähnlich lauten -- Fürst Gnade bewegen -- 
  Weib -- Herz -- 
  Flehen Gattin -- Wimmern unschuldig Kind widerstehen -- 
  Versuch -- harren Rache gereizt Schwester Schritt -- schuldig -- -- unglücklich Gatte geliebt Bruder rauben -- Strafe -- Tod verdienen -- 
  Lassen Fall Wirkung Rat bekannt Kanal erfahren -- -- allzugroß Unglück Kraft mindern -- Trost Genüsse -- ferner Hilfe suchen -- Hilfe -- -- 
  Anfang Brief raubt Herz Leidende Trost -- füllen Neuem -- hoffen -- Fleh Herz Rachbegierigen erweichen -- Fürbitte bewegen -- 
  Ergriff Kind Hand -- eilt Wohnung Gräfin -- 
  müßen flehen -- müßt euren Vater bitten -- sprechen -- Betrat -- 
  Bedienter -- Träne rühren -- führen Vorgemach -- melden -- 
  -- Frau Mörder -- Urheberin Träne sehen -- erscholl halb offen Türe Ohr Leidenden -- 
  Erbarme Unglücklichst Geschlecht -- rufen verzweiflungsvoll Tone -- Drang Gemach Gräfin -- 
  Wort ordnen -- Herz erweichen -- hemmt Größe Leiden Organe Sprache -- stürzen wimmernd Fuß Gräfin nieder -- umklammert Knie -- sprechen -- vermögen -- 
  arm Kind knieen -- heben Hand Höhe -- weinen laut -- 
  Weg -- Schlange -- 
  Weg -- 
  Natterbrut -- schrie Gräfin -- entreißen Hand Bittende -- entschlüpft Kabinett -- fest verriegelen -- 
  bedienter schleppn Jammernde Vorgemach -- überließen Verzweiflung Raube -- 
  Hernach wanken Heim -- schreiben zitternd Zeile Fürstin -- -- gelingen -- auf versuchen -- 
  unglücklich Gatte sehen sprechen können -- Kommissär Fürst erscheinen -- samt Kind Wagen führen -- Rathause fahren -- Befehl anständig Zimmer öffnen -- kund -- Entscheidung gefangener -- 
  rachsüchtig Gräfin R -- Ursache Kummer -- Furie beobachtet Gegenwart Fürsten streng Stillschweigen -- -- Verliebte erhalten -- schreiben -- Erfolgs gewiß -- 
  letzter Brief -- enthalten Drohung -- augenblicklich abreisen -- Frau Mörder hinderen -- ferner plagen -- Ärmst sogleich arretieren -- Möglichkeit Versuch hindern -- 
  duldet schmachtet schrecklichen entgegen -- Gatte Rabenstein bluten -- 
  Urteil unwiderruflich -- Tag kund -- bereiten standhaft nah Tod -- 
  Miene -- scheinen heit ruhig -- trüben -- Träne rollen unaufhaltsam Wang herab -- schrecklich Nachricht bringen -- letzter Bitte erfüllen -- Gattin sehen sprechen können -- 
  -- Trennung -- sprechen Seufzend -- treten an Fenster -- Kraft Standhaftigkeit sammeln -- 
  zahlreich Bürger Residenzstadt lieben gerecht Präsident -- -- -- willig gehören -- anhaltend Sache Unterdrückt verteidigen -- Herz Anteil unglücklich Schicksal -- versammelt beschließen einstimmig -- Hof -- Fürst anzuflehen -- Leben schenken mögen -- 
  Auge weinen -- schwarz Mantel trauerndem Blick Burg ziehen -- Audienz fordern -- 
  Fürst treten willig -- hören Bitte geduldig -- versichern standhaft -- Gerechtigkeit Staat üben müssen -- derjenige begnadigen können -- Hand unschuldig Blut tauchen -- einstimmig Beweise vorsätzlich morden -- 
  blicken Gerührt umher -- seufzen tief -- Menge nieder kniet -- abermals Gnade -- 
  Gnade -- rufen -- fassen schnell -- winken Kniende Hand -- eilt Zimmer -- 
  nehmen Wink Beweis Erhörung -- mehrere meinen -- Unglücklichen Gott retten können -- Fürst Gnade hoffen -- 
  Meinung Folge bestätigen -- nämlich _ allgemein kund -- unglücklich Graf folgend unwiderruflich Rabenstein bluten müssen -- 
  -- hören -- weiht Tran -- blicken betend Gott empor -- Todeskampf standhaft mögen -- 
  Sommer -- früh Sonne -- 
  Aufgange versammelt Soldat -- verurteilter zahlreich Menge Turme -- sitzen -- Richtplaze begleiten -- 
  Tausend Tausend -- sehen bemitleiden -- Mühe Eingange abhalten -- 
  harrt -- erregt Ankunft schnell Abfahrt fürstlich deputierter -- verstört Gesicht Unglück verkündigen scheinen -- Aufmerksamkeit Volk -- 
  fragen -- forschen erfuhrendlich -- Verurteilt verfloßen Nacht samt Kerkermeister entflohen -- 
  bezweifeln anfangs unerwarten -- unmöglich scheinend Nachricht -- gewahren -- abermals Husaren Stadt Land durchspähten -- Kurier Kurier abreisn -- einzeln Depntirt jeder verdächtig Haus emsig durchsuchten -- beginnen glauben -- wünschen -- vereinigt Herz Gebet -- Unglückliche schnell sicher Grenze entfliehen mögen -- 
  Graf L -- Gefängnis verschwinden -- 
  Abends verlassen Priester -- ruhen wünschen -- 
  nachher entlassen Kerkermeister Wächter Versicherung -- schlafend Grafe wachen -- nötig Fall rufen -- 
  gehen Wachtstube -- ruhen -- 
  Priester erscheinen -- führen hinauf -- Türe Zimmer fest verschließen -- vermuten -- Ruhe -- weilt Priester Gange -- Kommissär erscheinen -- verurteilter Richtplaze begleiten -- 
  Befehl Türe klopfen -- Kerkermeister sanden -- nirgends finden -- Türe erbrochen -- 
  Anwesende erstaunt -- Zimmer verurteilter nirgends erblicken -- Verrat Flucht erweisen -- eilt Fort -- erster entdecken -- letzter verhindern -- 
  Engelsruf schwer Todeskampf -- sanft Flötenton brausend Sturme Ungewitter Drang Ohr leidend betend Gattin -- mitleidiger Gerichtsdiener Nachricht zuflüsteren -- verurteilter wahrscheinlich glücklich entfliehen -- 
  Überspannung Kraft -- Raub Wahnsinn nahe -- lindernd Trost schmachtend Herz erquicken -- 
  Stunde Todes schwerlich -- Verlust Verstand überleben -- hoffen -- Hoffnung einzig Labsaal Leidenden -- 
  erregen Begierde lang Duldung Herz Mensch -- Begierde herrschen -- Verzweiflung Wahnsinn weichen -- 
  Fürst entrüsten -- unerwartet Nachricht hören -- 
  nah Ziel -- entfernen -- scheinen liebend Herz unerträglich Pein -- 
  suchen finden Linderung Gedanke -- Verrat Flucht gewiß entdecken -- Hoffnung erfüllen -- husaren -- Kurier -- Späher kehren leer -- bringen gering Spur -- Entdeckung leiten -- bleiben scheinen erweisen -- fliehend glücklich entkommen -- Befreiung ungetreu Kerkermeister Anteil -- Verbannung Teil -- 
  Anfangs bestehen rachsüchtig Gräfin R -- hartnäckig Erfüllung Gelübde -- liebend Fürst deutlich beweisen -- allwissend -- strafen können -- verurteilt entflohen -- berechnen eigennützig Vorteil Versöhnung -- Nachteil Rache -- finden -- Erstere letzter viele überwiege -- 
  heischt Schwor Fürst -- entflohen Täter begnadigen -- -- entdecken -- Strenge strafen wollen -- Fürst leisten Schwor -- _ Hof Stadt -- Gräfin R -- erklären Geliebte Fürst -- 
  erstenmal Hof erscheinen -- Betragen Fürstin beobachten -- erstaunt -- auf freundlichste empfangen -- anhaltend sprechen -- 
  Großmütige gerne Handlung üben -- achtet schwer Pfad -- Ziel leiten -- 
  Fürst Minister sprechen -- führen Fürstin Gräfin an Fenster -- 
  wissen -- sprechen -- Fürst Ersatz leiden schuldig -- Verlust geliebt Bruder Residenz erdulden müssen -- 
  Herz bied -- Bitte abschlagen -- wagen -- befürchten müssen -- Erfüllung auf kränken -- 
  wagen -- fallen gegründet Einwurf weg -- Erhörung gewiß -- 
  _ -- bitte -- -- Gräfin -- euer Durchlaucht befehlen -- -- Fürstin -- 
  -- vermögen -- 
  Charakter Auge erhöhen -- Lohn Freundschaft ziehen -- Gräfin -- 
  O solch Gewinn unternehmen -- 
  Fürstin -- 
  -- sanft lächelnd -- sogleich versuchen -- 
  Versicherung Schmeichelei -- 
  Gattin Grafe L -- verzeih -- erinnern -- schmachten Kind unverdient Gefängnis -- 
  -- üben -- streng büßen -- Freiheit Vermögen rauben -- 
  Wort sicher beide geben -- 
  versichern -- Geschwor -- versöhnen -- unschuldig Frau samt Kind Bettelstabe umhe wanken müssen -- 
  _ vorstellen -- wütend Schmerz Schwures fähig -- _ glauben -- Herz sanft Weibe Wurzel fassen -- Frucht tragen -- 
  -- Hand fassend -- sanft drückend -- 
  -- Glauben Großmut betrügen -- 
  Gräfin -- 
  -- hocherrötend Wang -- 
  _ leugnen -- schrecklich Schwor leisten -- gestehen offenherzig -- euer Durchlaucht -- -- bewegen -- Art -- _ fordern -- bewegen -- brechen vernichten -- 
  -- eifrig Fürbitterin -- eins bedungen -- geloben -- -- Fürstin -- 
  fordern -- 
  Gräfin -- 
  euer Durchlaucht ähnlich Fall -- ähnlich Art Fürbitterin wählen -- fordern -- einst Gnade Mörder flehen -- 
  Zorn -- Verfolgung zuziehen -- fühlen _ deutlich -- Verleugnung fähig -- 
  lieben Bruder innig -- Grafe beleidigt -- Beleidigung verdienen Mord -- 
  -- weinend -- schrecklich denken -- rufen innerer Stimme laut anhaltend Rache Täter -- wünschen -- -- Fürstin -- 
  -- Wort fallend -- 
  versprechen auf heiligst -- Trauer Verlust gut Bruder ehren -- Mörder erinnern -- 
  wissen -- Strafe verdienen -- 
  entfloh Tod glücklich -- Verlust Weibe -- Kind -- Vermögen Strafe -- Empfindsamen hart dünken -- wählen -- tragen -- bitten -- 
  legen nochmals Bitte an Herz -- 
  Gräfin -- 
  Erfolg _ lehren -- eifrig bitten verstehen -- 
  Fürstin -- 
  -- Hand drückend -- 
  -- Fall Wiedervergeltung sicher rechnen -- 
  erscheinen gefangen Gräfin Abgesandter Fürst -- 
  Name kund -- Gesetz Land Vermögen vorsätzlich Duellant streng Konfiskation unterliegen -- diesmal Gnade ergehen sollen -- Fürst Kind Genuß Vermögen ferner gnädig verleihen wollen -- sogleich Residenzstadt verlassen -- Hoflager stets meiden -- neu Verbrechen hoch Gnade verlustig machen -- 
  Trauernde danken -- versprechen Befehl gnädigen Fürst streng erfüllen -- 
  Haus -- bewohnen -- fahren Abgesandte fort -- schön Garten -- Vorstadt besitzen -- nützen -- behalten Fürst beide Gesetz bevor -- 
  Gräfin -- 
  Wille Gesetz -- belohnen würdigst Diener -- trauernd Einsamkeit Ruhe Gedanke finden -- anderer Vergnügen genießen -- willig entbehren -- 
  Ehe Abgesandte scheiden -- berichten -- Verhaft Augenblick enden -- Abreise dauern müssen -- Fürst ausdrücklich überzeugt wollen -- Hof kommen -- Besuch Verlegenheit setzen -- 
  stehen frei -- Anstalten Abreise treffen -- Diener berufen -- Haus räumen nötig Gepäck herbei schaffen lassen -- 
  Gräfin -- sinken Knie -- danken Gott innig -- Herz Fürst Gnade lenken -- 
  dunkel Vorhang -- Aussicht decken -- öffnet -- blickt Zukunft -- Hintergrunde entflohen Gatte Fuß Fürst knien -- Leben danken -- offen Arm Gattin Kind eilen -- 
  _ Leidende verdenken -- -- wünschen -- hoffen -- freilich -- liebend Herz scheinen -- 
  sand hastig Eile treust Diener Dienerinne -- erzählt Glück -- treffen Anstalt nötigen Abreise -- 
  Ehe Sonne untergehen -- sitzen Reisewag atmen frei -- Stadt liegen -- schrecklich dulden gelitten -- 
  Abreise -- schreiben Fürstin -- danken innig -- Grund Urheberin Glückes achten -- 
  bitten -- unglücklich Gatten einst ähnlich Art annehmen -- Werk vollenden -- höchst Unglückliche glücklich -- 
  großmütig Fürstin antworten sogleich -- edle Werk Fürst -- -- innig Freude nehmen -- 
  -- schreiben -- unmöglich scheinen -- entflohen Gatte jemals Gnade hoffen können -- Linderung Schicksal deutlich Beweis -- Gott unmöglich -- einst arm Rückehr können -- 
  Trost -- bangen -- 
  Aussicht -- trauern -- 
  dringend bitt -- unvorsichtig Nachforschung aufenthalt Gatte Aufmerksamkeit Fürst erregen -- 
  denken -- beobachten -- Fürst Herz Vergebung neigen -- unvorsichtig Schritt Argwohn wecken -- Rache reizen -- Gatte -- Kind unglücklich können -- 
  Nützen Rat wahr Freundin -- einzig -- Abschied geben vermögen -- 
  Hoffnung biener -- Gegenstand Honig saugen -- süß Genusse menschlich Herz tragen -- 
  Kamm -- Brief unglücklich Gräfin Stoff Trost finden -- 
  Schicksal lindern -- denken -- einst seinig lindern -- 
  froh Gedanke Reise Beschäftigung -- Folge echt Labsal -- liebend Herz Gatten sehnt -- tröstend Nachricht hören wünschen -- 
  leben entlegenst Landgute Grafe häuslich Einsamkeit -- still Trauer -- weiht Erziehung Kind -- finden Beschäftigung Trost leiden -- 
  einkünft Gut Grafe ansehnlich -- Leidende empfangen Träne -- Gedanke -- sammle -- indes Geliebte darben -- Herz mächtig engen -- unfähig -- Vergnügen Genüsse -- Kind Glück Sparsamkeit mehren -- reichlich Wohltat Träne Armut trockenen -- 
  Gegend wohltätig Gottheit verehren -- reichlich -- helfen suchen -- empfinden Wonne -- glücklich -- voll Größe -- Bittende notleidend Gatt erblicken -- dürftig hülflos denken -- neu Trauer reizen -- 
  verfloss Art -- -- ehe erzählen -- zuvor Schicksal entflohen Grafe enthüllen -- Leser kund -- entfloh -- entfliehen -- - schwer ruht Gedanke -- Fürst Edel -- blind Rache Irre leiten -- handeln -- Herz menschenfreundlich Fürstin -- 
  kennen Biedersinn -- Edelmut -- überzeugen -- Reue rasch Folge -- wahrscheinlich einst spät Leben verbittern -- liebt Ungetreue innig Zärtlichkeit -- äußerst künftig Ruhe besorgt -- 
  Schritt -- sicheren -- vergebens versuchen -- 
  weisen Bittend Härte -- suchen Befriedigung Leidenschaft -- -- Gegenstand blutig Rache heischen -- Tod Unglücklichen -- 
  letzter Versuch -- rachbegierig Anblick verzweifelnden Gattin -- jammernd Kind versöhnen -- vergebens wagen -- letzterer Nachricht erhalten -- Grausamer Härte zurückweisen -- rang Mittel -- hindern -- 
  möglich -- schleunig Flucht -- rufen -- Tod retten -- Gatte künftig Reue schützen -- 
  Augenblick Gedanke einzig Beschäftigung -- 
  wissen -- Kerkermeister -- adlig Staatsgefangenen besonderer Turme verwahrt -- ehemals Heiduck Murter Fürst dienen -- Widerwille einträglich Dienst Kerkermeister Belohnung treu Dienst annehmen -- ferner -- Weib -- Kind -- nahen Freund -- an Vaterland fesseln -- 
  Grund baut Hoffnung Möglichkeit Ausführung -- 
  eilt Garten -- stundenlang verweilen -- 
  vertraut Kammerfrau einzig Begleiterin -- müssen Gartenhause verkleid -- Nebentür entschlüpfen -- Kerkermeister Auftrage groß Verschwiegenheit berufen leiten -- 
  erscheinen sogleich -- Fürstin äußerst schwer -- Entführung gefangener bereden -- _ Verletzung Pflicht -- Schwurs achten -- weniger Leben Meineid beflecken -- 
  Versicherung -- allzu zornig Fürst einst lohnen -- Fürstin möglich Fall Verantwortung nehmen wollen -- bereitwillig -- versuchen -- 
  versprechen überdies lebenslang Versorgung Staat benachbart Fürstin -- wohin sicher Gefahr senden wollen -- 
  Versprechen -- redlich alt Teilnahme bewegen -- Überzeugung -- übe -- Widerwille -- traurig Dienst Kerkermeister verrichten -- bestimmt Handlung -- 
  verabreden beschließen -- Kerkermeister sobald gefangener unterrichten -- Nachtszeit lästig Zeuge entfernen -- Seitentüre Turms -- bewachen -- Wohnung Kerkermeister führen -- Garten Fürstin entfliehen -- 
  Garten Fürstin Ensiedelei erbauen lassen -- Schlüssel tragen -- 
  Kerkermeister Auftrag übergeben -- Gemächer Einsiedelei öffnen -- Graf Hintergrunde angebracht Grott begeben sollen -- menschlich Auge sehen entdecken -- 
  Genährt pflegen Hand Fürstin -- verbergen leben -- Fürst Nachspähe enden -- unkennbar Verkleidung sicher Paß versehen -- Gefahr Land verlassen können -- 
  äußerst vorsichtig Plan Kerkermeister Klugheit ausführen -- 
  mitternachtstund nahen -- hüllt gefangener weit Mäntel -- führen glücklich Seitentüre Garten -- ebenfalls Schlüssel erhalten -- 
  bangen unruhig Herz erwarten indes Fürstin Ausgang Wagstück fürstlich Residenz -- wohin sogleich rückgekehren -- 
  sandte früh vertraut Spähe -- genoß Frucht edel Fülle -- sicher Nachricht bringen -- gelingen -- Entflohen größt Eifer suchen -- 
  Fürstin möglich Argwohn hindern -- Garten -- vertraut Kammerfrau -- tragen Verborgen -- Vorwande -- Fürstin Buch befindlich Bibliothek hol -- Speise Trank -- 
  stark schlagen allemal Herz Edle -- rückkehrend Kammerfrau erzählen -- gefangener Wohlergehen -- Graf rührendsen Ausdrücken Retterin Leben danken -- 
  Fürstin gewahren -- ahne -- -- gewöhnlich -- Garten -- besuchen Versteckt allemal -- sprechen tröstend -- erscheinen stets Wohltat Hand -- 
  bringen nötig Speis -- wäsch unentbehrlich Ding -- Leben Notdurft erforderen -- 
  arm Graf künftig Schicksal Hand großmütig Fürstin -- zagt Zukunft -- unglücklicher Schicksal verlaßen Weibe -- unerzogen Kind quälen Herz doppelt -- 
  empfehlen Vorsorge gnädigen Fürstin auf dringend -- verleitet unerwartet Schritt -- geliebter Gatten Fürsprecherin Unglücklichen -- 
  heiß Grafe -- Überzeugung -- Edel handeln -- lohnt Überwindung reichlich -- Schritt Herzen kosten -- 
  sehnlich Wunsch Grafe erfüllen -- bleiben übrig -- Wohltäterin lang lästig fallen -- Winkel Erde kummervollen vertrauern -- 
  Fürstin vorher Erfüllung Wunsche vorbereiten -- 
  benachbart Fürstin -- Vormünderin unmündig Sohn ländchen -- Vater besitzen -- regieren -- ehemals Jugendfreundin -- finden vertraut Korrespondenz -- 
  entdeckt geprüft Freundin sogleich Sache -- bitten Rat Beistand -- 
  regierend Fürstin schreiben -- genau Verbindung -- Hof miteinander stehen -- fähig -- Grafe -- Land entfliehen -- öffentlich Schutz verleihen -- wollen -- teuer Freundin fallen -- Wagen -- Unternehmen -- -- verborgener kommen -- möglich Entdeckung hindern -- -- einsam landleben scheu -- Gefahr schützen können -- 
  Beförderung Absicht senden Paß -- Fürstentum untertänig Schäfer ausstellen -- Auftrag -- nächstgelegen Staat merkwürdigst Schäfereien besuchen -- Vorteil Verbesserung inländisch Schafzucht -- 
  -- schreiben Freundin -- Sorge -- Flüchtling Eigenschaft Passes gemäß kleiden -- Gesichtszug unkennbar -- geradezu Land senden -- 
  neu Brief unterrichten -- abreisen -- eintreffen -- 
  nehmen Weg neu errichtet fürstlich Schäferei - m -- Gebirge F-- -- 
  benachbart Jagdschloß wohnen -- Gelegenheit finden -- Grafe sprechen -- 
  Ehe geschehen -- Flüchtling Aufenthalt bestimmt Schäferei -- melden Vorsteher -- 
  gemeßen Auftrag erhalten -- Dienst aufnehmen -- Absicht -- erzählen -- keineswegs entsprechen -- alt demütig -- _ wag -- verborgen Kenntnis bezweifeln -- 
  -- reif Überlegung -- einzig Art -- Grafe sicher Aufenthalt Land gewähren -- schlechterdings gefallen lassen -- Schaf hüen -- einsam Gegend wachsamen Auge Beamter entziehen -- ernst Befehl erhalten -- Entflohen umh späh -- 
  Befehl -- dringender ersuchen dein Fürst ergehen lassen -- widerrufen -- Nichterinnerung schwächen -- 
  arm Graf Lose zufrieden -- fürstlich Freundin fragen -- Verleugnung besitzen -- nötig Einrichtung hindurch fügen -- 
  neu Stand -- sprechen -- innerer Lage angemessen -- ungehindert -- Herde folge -- Gedanke überlassen -- einsam Gegenden -- führen -- Labsal -- Andenken Weibe -- Kind weihen -- Verlust betrauern -- 
  schmerzen äußerst -- Retter Leben Ruhe entrissen -- hoch Alter wüsst Gegende umh irren -- Kost Genüssen -- Kraft angemessen -- 
  Fürstin suchen Gegenstand beruhigen -- versichern -- dauerhaft Versorgung redlich Kerkermeister Pflicht -- Möglichkeit leisten -- 
  -- sprechen -- Gefahr entronn -- Belieben wandern -- entfernt Gegend ruhig Summe Genüssen -- Abschied übergeben -- 
  hinreich -- zeitlebens ernähren -- übrig bleiben -- treu Wärter belohnen -- 
  selten Kerkermeister danken innig -- versichern ernstlich -- Grafe trennen -- Glück Unglück -- Kummer Freude teilen -- -- -- treu Dienstleistung hart Schicksal erleichtern wollen -- 
  -- Grotte durchleben -- gut alte angenehm verfloss -- deutlich überzeugen -- Graf Mensch -- 
  Ueberzengung Ursache -- trennen -- Überredungskraft Entschluss bewegen -- 
  Mensch denken -- Gott lenken -- 
  nötig Abreise anordnen -- Zufluchtsort verlassen -- Schutz Allmächtig übergeben -- arm Kerkermeister krank -- heftig Augenentzündung endet Leben -- groß Gefahr -- möglich Entdeckung Hilfe leisten -- 
  sterben Christ -- ruhig lassen -- Gewißheit hinüber -- Barmherzig Meineid verzeihen -- Absicht edlen lohnen -- 
  Grafe drücken Verlust Freund -- Bewußtsein -- Schuld Tod -- äußerst stark -- mißmutig hoch Grad traurig -- 
  vergebens mühen Fürstin -- tröst -- fassen Gedanke -- halten fest -- Gott verlassen -- empfindlich straf -- vergeben wollen -- 
  verdenk Grafe murren -- 
  glich reißend Strom Kämpfende -- letzter schwach Ast -- Rettung -- Verlängerung Leben hoffen -- brechen -- Aussicht schwehen -- 
  Körper entdecken -- Grotte begraben -- 
  vertraut Kammerfrau entwenden Gärtner Hacke Schaufel -- Graf brauchen voll Nacht -- treu Freund Grabstätte hart Boden Grotte auszuhauen -- 
  traurig Beschäftigung -- fortdauernd Anblick tote -- mehren Empfindung Herzens -- wünschen sehnlichst vollenden -- ausgerungen -- 
  Abend ruhen -- fürstlich Wohltäterin Träne wärmst Dank Abschied nehmen -- ferneren Schutz Weib Kind empfehlen -- Summe Versicherung erhalten -- Brief Weib bestellen wollen -- treten folgend Nacht Wanderung -- 
  entkommen Seitentüre glücklich Garten -- glücklich Stadt -- Tor -- Mauer umgeben -- Nebenweg ungehindert Vorstadt -- freie gelangen -- 
  Sonne Aufging -- liegen Residenz meilenweit Rücken -- 
  tragen Kleidung Schäfer -- Haar verschniten -- Hand Gesicht unmerklich gelb färben -- 
  letzterer ungewöhnlich stark Bart verstellt Physiognomie vollkommen -- achten -- wandert gewählt Seitenweg ungehinderen Grenze -- erreichen -- 
  glücklich -- Paß befragen -- langter bestimmt fürstlich Schäferei -- 
  liegen mitten hoch Forst -- unbewohnt -- wild Gegend -- 
  hie Holz entblößt Berg -- grasreich Täler ökonomisch Fürstin bewegen -- erster Sommerweid -- letzter Heu tausend Schaf benutzen -- herrlich gedeihen -- Nutzen bringen -- Wild -- Vorfahren Gegend hegn -- 
  Vorsteher Schäferei -- alt -- bied redlich Mann -- empfangen Grafe bäurisch -- traulich Freundlichkeit -- 
  längst erwarten -- Knechte Dienst entlassen -- Erwartet Platz sogleich anweisen -- 
  nämlich übergab vierhundern Stück schön Schaf -- leiten -- führen pflegen -- 
  Empfehlung Fürstin erregt alt Gedanke -- Fremde selten Kenntnis Schafzucht besitzen müssen -- schwätzen beständig Vorteil Hindernis Letzter -- Erster prüfen -- 
  Glück Grafe -- stets Ökonomie leidenschaftlich lieben -- Landgüter einig Woche Erholung Geschäft suchen -- vornehmst Zweig praktisch üben -- Regel gut Schafzucht unbekannt -- freilich Folge leisten -- alte hoffen -- verderben -- still eingezogen Lebenswandel Liebling -- 
  Fürstin besuchen Hernach Schäferei -- Gelegenheit -- Grafe tröstend sprechen -- 
  danken innig Schutz -- danken innig -- kund -- Weib -- Kind gesund leben -- traurig sinken hoffend Auge Erde -- erzählen -- wohltätig Fürstin Brief -- Gattin hinterlassen -- abgeschicken -- abschicken können -- gewiß erfahren -- heimlich Späher Fürst Gräfin genau beobachten -- Korrespondenz ingeheim untersuch -- gering Spur Entdeckung leiten können -- 
  arm Verbannt fühlt Nachricht leiden verlaßenen Gattin -- flehen auf -- Leben -- Gesundheit Nachricht geben sollen -- traurig -- tief leidend Herde -- einzig Trost -- Zeile geliebt Gattin lesen -- rauben -- 
  Ruhig Glücklich Einsamkeit Entfernung menschlich Gesellschaft traurig mißmutig -- Leidenden Unglücklichen -- 
  Freund erquicken schmachtend Herz Trost -- unerwartet Gelegenheit zerstreuen Kummer -- ungehindert Größe Leiden messen -- auf überzeug -- unendlich -- dauernd -- 
  ergings Grafe -- stets traurig -- stets melancholisch -- erregt Mitleid gutherzig Meister -- Knecht auszeichnen -- Tisch speisen lassen -- wunderen -- leidend Ehre hochschätzen -- vielmehr möglich Art vermeiden suchen -- 
  übrig Bewohner Graf gleich Rätsel -- gefällig -- freundlich Art ziehen -- Hang Einsamkeit -- tief nachdenken -- stoßen stark -- 
  -- gewinnen Jugend sorgfältig gepflegt Gewohnheit Rang schwer Verstellung -- suchen -- leiten -- hart Last erträglich -- reinlich übrig Schäfer kleiden -- 
  weniger Mädchen -- Einöde wohnen -- Geschäft besuchen -- blickt Lüstern -- nennen schön Galant Schäfer -- -- Gegenwart ausgesprochen Name Eindruck -- nannt Folge traurigen Schäfer -- blicken mitleidig -- gesenkt Auge Herde schlich -- 
  durchschmachteen -- finster Melancholie Herzen fest Sitz nehmen -- wahr Begierde Tod entgegen -- wünschen sehnlichst -- nahen -- namlos leiden enden mögen -- 
  besuchend Fürstin verstehen geben -- tief erniedrigend Verstellung nötig -- entfernter Land -- unterstützen Wohltäterin -- angenehm leben können -- Einsamkeit Schmerze unentbehrlich -- flehen -- lang dulden mögen -- versichern dreist -- Entfernung -- Nachricht Gattin erhalten -- Wahnsinn reizen -- 
  Fürstin ehren Grund -- versprechen -- öfter Nachricht Gattin erfreuen -- vermocht Wort halten -- jährlich Gegend -- Boten ohnehin gespannt Aufmerksamkeit dortig Bewohner reizen -- 
  fragen stark leidend duldend Gräfin Ewig -- 
  leiden enden -- Jammer hienied Lohn hoffen können -- 
  ungewöhnlich Geräusch Hofe Schlosses Tiefsinn wecken -- an Fenster ziehen -- 
  blicken hinab -- Reisewage Türe stehen -- Trauer gehüllt Dame heraussteigen -- 
  eilt Hinab sinken arm Fürstin -- besuchen -- 
  Trauer verkündigt Gräfin Voraus Ursache Möglichkeit selten Besuch -- ahndet Fürst Tod -- äußerst schnell unvermutet erfolgen -- 
  gewöhnlich Parforce-Jagd äußerst erhitzen -- unvermutet Gewitterreg durchnässter Kleid -- 
  Ehe Residenz erreichen -- sinken Schlage treffen Tod Pferd -- 
  liebenden -- Tod innig bejammernd Fürstin Regentin Landes -- einzig Sohn elft Alter erreichen -- 
  huldigen sogleich -- Arzt vergebens versuchen -- Tode wecken -- 
  Gräfin R-- -- erklären Geliebte Fürst -- Land Leute regieren -- erschrak äußerst -- Tod Fürst Huldigung Gemahlin Augenblick vernehmen -- 
  fürchtet Rache letzteren -- sanden sogleich folgend Brief -- 
  Durchlauchtigste Fürstin -- 
  Wiedervergeltung rechnen -- sprechen einst -- Fürbitte Gräfin L-- versprechen -- 
  Wiedervergeltung -- 
  hoffen -- großmütig handeln -- erlauben -- Land verlassen -- Monarch einzig Beschützer -- 
  tief gebeugt Fürstin vermögen sogleich antworten -- lassen Gräfin sagen -- Antwort sicher erfolgen -- 
  bang Sehnsucht zitternd Antwort entgegen -- staunen -- heiß Träne füllt Auge -- -- folgend Las -- 
  lieb Gräfin -- 
  äußerst billig -- Wiedervergeltung -- dankbarer Herz ehren -- Sache fordern -- strengste Gerechtigkeit verweigern -- 
  stehen vollkommen frei -- ferner Land wohnen -- verlassen -- 
  erster Fall Hochachtung fortdauern -- letzter ungeteilt nehmen -- 
  hoffen sicher -- Abschied scheiden -- -- groß bitt Stand setzen -- Bewußtsein entlassen -- Schuldnerin bleiben -- 
  -- -- finden Etikett -- meister verloren -- erlauben -- ungehindert weinen -- 
  Hofleute staunen -- nachh Gräfin R-- Fürstin melden lassen -- staunen -- sogleich vorgelassen -- kurz Unterredung -- Fürstin Hand Hand Kabinette treten -- Gegenwart Frenndin nennen -- echt Zärtlichkeit umarmen -- glücklichste Reise -- Zukunft ruhigsten wünschen -- 
  außerordentlich Leutseligkeit Fürstin Verstellung -- echt Lohn -- Gräfin zollen -- 
  Kabinett treten -- dankt Wärme -- Herz rühren -- bitten nochmals -- Land verlassen dürfen -- 
  Fürstin gewähren auf -- fordern ausdrücklich -- groß Gefälligkeit erbitten mögen -- 
  -- sprechen Gräfin -- Gnade nutzen -- 
  -- Knie sinkend -- -- eingebildet Größe sinken -- fühlen deutlich -- Tod Bruder hart rächt -- arm Grafe L-- hart verfolgen -- euer Durchlaucht Regentin -- euer Durchlaucht strafen -- vergeben vergessen -- 
  bitte erlauben -- Gewährung zusichern -- bitte -- euer Durchlaucht Grafe unbedingt vergeben -- vergessen -- erlauben -- übrig ruhig arme geliebt Weibe durchleben -- 
  _ edl Herz überzeugen -- Verzeihung bitte erfolgen -- achtet Pflicht -- erinnern -- auf bitten -- Gnade edel Handlung künftig Regentin mögen -- -- -- -- _ -- rufen gerührt Fürstin -- Versicherung nehmen -- bitte Wille ewig hochschätzen lieben -- 
  Trauer Tod Fürst erlauben -- Gebot sogar Fürstin Entfernung Residenz -- 
  fürstlich Beamter bisherig Dienst bestätigen -- heischen Schmerz Linderung -- hoffen Wohltun finden -- reisen Gräfin L-- -- Gesellschaft strengen Iukognito benachbart Fürstentum reisen -- Grafe überraschen -- namlos Freude Umarmung -- Wiedervereinigung Genüssen -- 
  wohltätig Vorsatz Gräfin entdecken -- -- -- O fähig Simptom Freude -- Seligkeit schildern -- gleichen vollkommen überirdisch -- dolmetsch Gott schildern -- kein sterblich Mund aussprechen vermögen -- 
  Überglückliche Kind ähnlich -- taumelte wonnevoll umhe -- heben Gegenstand Höhe -- legen schnell -- träumen wachend -- sprechen Glück -- erhitzt Einbildungskraft Traum scheinen -- 
  O unendlich langsam fließen Stunde vorüber -- Erfüllung heißen wunsche trennen -- 
  Schlaf erquicken Auge Hoffenden -- starren sehnsuchtsvoll Zukunft -- geliebt Gatte offen arme stehen -- 
  Fürstin beschließen -- Landgute Gräfin ruhen -- Sehnsucht -- werfen Freundin leicht Reisewag -- eilt unnennbaren Freude entgegen -- 
  schnell reisen -- Fürstin gewöhnlich Begleitung eutsagen -- Kammerfrau sitzen Kind Gräfin Wagen -- Bedient begleiten -- 
  rasch vorwärts -- Harrende langsam -- Schafherde -- nah fern Berg umher klettern -- stärksen Eindruck Herz -- strecken Arm -- glauben -- Hirt Gatte erblicken -- 
  liegen wüsste -- öde Berggegend Blick -- 
  sehen hoch Buche Eiche Schäferei Ferne glänzen -- stehen Wagen Haus Vorsteher -- 
  alt Mütze Hand hoch -- fremd Gast entgegen -- stannt -- Gräfin hastig fragen -- 
  Gatte -- Graf L-- gehen -- 
  -- 
  sehen sprechen können -- 
  schütteln bedächtig Kopf -- fremd beweisen -- Graf wohnen -- ruhig Fürstin Irrtum bemerken -- fremd Schäferknecht fragen -- fürstlich Schaf hüte -- 
  -- rufen alt -- freilich -- -- Graf -- 
  Fürstin -- 
  lang streiten -- 
  gefällig -- sagen -- treffen -- aufklären -- 
  alte sogleich bereit willig -- Berg führen -- Schaf weiden -- 
  voraus -- Wagen folgen -- 
  Fuß Berg müssen aussteigen -- eng -- Schaf getreten Pfad aufwärts schlängeln -- 
  Gräfin ergriff Hand Kind -- ziehen hastig -- 
  einzeln Schaf -- Gipfel umh klettern -- beschäftigter Auge -- ziehen Aufmerksamkeit magnetisch -- denken -- sprechen -- 
  Nah Gefühl Wonne -- entzückend Wiedersehen toben stürmend Ader -- Nerv Fiber -- hemmen Atem -- müssen ruhen -- blicken Nassem -- sehnsuchtsvoll Blick Höhe -- 
  Fürstin folgen stillschweigend -- hochgeregt Empfindung beschäftigen Herz Einbildungskraft stark -- 
  einigemal vermögend -- Gräfin allzuhastig Eile warnen -- Entzückt unfähig Warnung fassen -- allzugroß -- wonnevoll Ziel reißen Allmachtsstärke empor -- wecken Lebenskraft -- spannt Sehne -- -- schnell erreichen -- 
  Gipfel erstiegen -- alt Eich -- Stamm wütend Sturm bogen -- brechen -- stehen unfern -- 
  Schatten ruhen verbannt Graf -- liegen ausstrecken Boden -- unterstützen nachdenkend Haupt -- Auge starren fern Gegend -- 
  alt Traum wecken -- Sehnsucht liebend Gattin überflügelt Schritt -- 
  Karl -- 
  Schrie wonnetrunken -- nahen -- 
  Vater -- rufen Knabe -- folgen -- 
  denkend schauderen empor -- 
  Karl -- wiederholt Gattin -- 
  Vater -- lallt Kind atemlos -- Wettläufer -- Kraft verschwenden -- sinken Gräfin Ziel Wunsch kraftlos nieder -- Kind umfaßt Knie staunend -- 
  Fürstin vermochen sprechen -- Träne Freude -- innig Teilnahme hemmen Sprache -- 
  alte greifen hastig Müzze -- blicken entblößtem Haupt Himmel -- 
  dauern Szene stumm Empfindung -- Sturme namlosen Gefühl -- enden -- _ -- O diesmal freudenvoll Gefühl Leser Dichtung täuschen -- - _ traurig -- schrecklich Gewißheit -- schnell Überraschung -- jäh Sprung entferntest Hoffnung überzeugend Gewißheit arm Grafe Verstand rauben -- verwirren -- 
  streng Richter Schonung Todesurteil verkündigen -- letztenmal Sonne Auge entschwinden -- -- retten sicher Tod -- verbannen geliebt Weibe -- liebend Kind -- fortwandern müssen -- bleiben Mut standhaft unerschütteren -- unerbittlich Schicksaal spotten -- Truggestalt täuschen scheinen -- schwehen Mut Standhaftigkeit -- klagen laut streng Härte Barmherzig -- Tantalus strafen wollen -- bewegen -- dasjenig Wahrheit halten -- erhitzt Einbildungskraft Täuschung -- Traum achten -- 
  Traum -- 
  schrecklich Blendwerk -- rufen Unterlaß -- 
  Liebkosungen Gattin -- schmeichelnd Bitte Kind -- ermahnend Stimme Fürstin vermögend -- gefaßt Idee vernichten -- entflohen -- Wink Fürstin Bedienten ergreifen -- Gewalt Schäferei führen -- 
  Anfangs hoffen -- Gewohnheit Irrwahn tilgen -- Gewißheit überzeugen -- -- Arznei -- Überzeugung fähig -- stockend Rad Einbildungskraft wenden -- 
  stehen -- Bild Traumes Trug -- 
  ähnlich -- schrecklicher Bild gesellen -- 
  glauben Folge -- Weib -- Kind -- wohltätig Fürstin sterben sein -- Geist erscheinen -- 
  Gedanke vermehrt Wunsch Tod Herzen -- wünschen sehnlich geliebter vereinigen -- sorgfältig Aufmerksamkeit treu Dien hindern -- Tod finden -- sehnlich suchen -- 
  denk Leid gut Gattin -- Beschreibung fähig -- 
  lieben Heiß -- zärtlich innig -- 
  schmachtend Herz ziehen stets Gatten -- Ausrufe schrecken -- 
  hold Geist -- 
  kommst quälen -- 
  Verjag Wächter -- sollst sehen -- schnell Folge -- 
  Zahl leiden Mensch ungeheuer -- zählen -- Sand Meere -- jeder gefühlvoll Herz beistimmen -- Leiden Gräfin unzählbar Zahl groß stark -- 
  Gewißheit ewig Lohn überzeugend fühlen -- verdienen leiden -- Aussicht -- Hoffnung Lohns verzweifelnd sterben -- 
  müssen Herz Leser groß Trauer füllen -- fortfahr -- umständlich erzählen -- fassen -- 
  Anblick Gräfin Kind wahnsinnigen Grafe Qual Pein verursachen -- müssen Wagen fahren lassen -- 
  hoffen Besserung -- versuchen stets Überzeugung -- vergebens -- 
  Unglückliche lassen willig Schlos führen -- Anblick -- Willkommen treu Diener Bauer Eindruck -- scheinen kennen -- Gattin -- Kind nahn -- beben stets erschrocken empor -- rufen -- Seht -- sehen Geist -- 
  winken -- folgen -- 
  Sehnsuchtsvoll liebend Gattin Folge Arzt -- Nähe Ferne holen lassen -- entgegen -- Kunst fruchtlos Patient verschwendet -- einstimmig erklärt -- Hilfe -- Wunde Herzen fressend Krebs -- unheilbar Abzehrung nagt Körper -- langsam durchschmachteten endet Tod namlos leiden -- 
  begraben -- führen unglücklich Wahnsinnigen Rate Arzt Sarge -- 
  hoffen wahrscheinlich -- Anblick erschüttern sollen -- Endzweck erreichen -- scheinen Tod kennen -- blicken traurig Sarge -- einzig anwesende -- verklärter Tran weihen -- 
  Kind schwarz Trauerkleid nahn -- fliehen unaufhaltsam fort -- Versank gewöhnlich Schwermut -- 
  siebzig alt -- verlassen Zimmer äußerst selten -- kennen letzter Leiden Kind -- 
  finden tot Bette -- Schlagfluß Leben -- leiden enden -- 
  ruhen Seite Gattin -- -- Zufall -- Wahnsinn Freude trüben -- Lohn Leiden Fülle Genüsse -- 
  Hans K-- -- Bauer M-- -- 
  finster Aberglaube --sche Land decken -- Aufklärung Zinn Anhöhe schwankend umherwandelt -- leben Dorfen jung -- reich Bauer -- 
  leben ruhig zufrieden -- Gott Weib bescheren -- innig liebt -- gesund Kind gebar -- Haushaltung emsig klug führen -- 
  -- Nachbar _ -- jeder Einnahme reicheren Ertrag Feld vermehrt -- Ausgabe klug Wirtschaft Frau verminderen -- 
  -- unglücklich Siebzigst unser beinahe vollendet Jahrhundert allgemein Mißwach allgemein Klage Landwirt -- geben wohlgepflegt Feld mittelmässig Ernte -- Gesinde eigen Brot speisen -- überdies mäßig Überfluß verkaufen -- 
  Hungerjahr herrlich grünend Äcker reich Ernte versprechen -- liegen erspart Vorrat Boden -- 
  Widerstand hartnäckig hoch steigend Anbot Aufkäufer -- Dorf durchzogen -- Vorrat aufzukaufen -- Stadt führen -- Not zahlen -- heißhungrig Gewinnsucht fordern -- 
  Weib beschließen -- all Getreide Grenze Dorf arm Insasse Taglöhner niedrig Preis verkaufen -- erfüllen Gelübde -- Eheleute hoffen -- Werk Allesbelohnende einst reichlich vergelten -- 
  Ernte naht -- tausend hungrig reife bang Sehnsucht erwarten -- Hans Vorrat Art verkaufen -- Scheffel Weizen liegen leer Boden -- klug Hausfrau nebst nötig Bedürfnis zurücklegen -- Ernte kraftlos Lohnarbeiter nahrhafter Mehlspeise stärken -- 
  Hans Absicht Weizen Mühle führen -- bekannt Bäcker einsprachn -- 
  laufen -- sprechen -- Scheffel Weizen umh -- Metze auftreiben -- 
  Kloster L-- -- Semmel versehen -- fordern Ungestüm Erfüllung Kontrakts -- Kloster Vermögen danken -- sehen Gewinn -- Erfüllung Wort -- gerne Preis gefallen lassen -- Scheffel erkaufen -- 
  Hans -- helfen -- 
  Hans -- 
  Scheffel -- 
  Bäcker -- 
  indes -- Weizen H-- erwarten -- 
  Frau -- 
  Weizen verkaufen -- Schnitter bestimmen -- 
  Bäcker -- 
  weiß schwarz Klös essen -- gelten _ -- -- 
  Verkaufen Weizen -- zahlen Taler Scheffel -- 
  Frau -- 
  -- 
  arm Taglöhner ißt gerne -- 
  Arbeit fordern -- nahrhaft Speise stärken -- 
  Bäcker -- 
  zahlen Scheffel Taler -- 
  Kauft Schnittern Fleisch -- stärken kräftig -- 
  Frau -- 
  gewohnen -- schaden -- nützen -- 
  Bäcker -- 
  lassen erbitten -- geben Dreissig Taler -- 
  Denkt -- Gottgeweiht Mensch gehören -- eu Gebet gedenken -- 
  Preis -- Bäcker bieten -- außerordentlich -- Vermutung gewiß -- Woche Mal teuer zahlen -- 
  Hans letzter Antrage Bäcker Weib fragend -- nickt kopfe -- Hans Handel -- 
  Becker Weizen -- zahlen sechzig Taler -- dankt Verkäufer -- Verlegenheit retten -- 
  Kloster beweisen -- aufofere -- Kundschaft erhalten -- ermaugelt -- Vorsteher Kauf erzählen -- mehrere Bekräftigung Verkäufer nennen -- 
  Hans Weib leben jeher gottesfürchtig -- erfülln -- ächten wahr Religion unterrichten -- selten Strenge außerordentlich Zeremoniell -- 
  gehen Sonn Feiertag nah Kloster -- -- hoch Amt -- -- gesungen Messe -- Predigt hören -- 
  Glühende Röt verbreitet Angesichte -- bleich -- angstvoll Totenblässe folgen -- folgend Sonntage Prediger Wucher eifern -- jetzig Teuerung Hungersnot Herzen reich füllen -- Sünde verleit -- barmherzigst langmütig Gott schrecklich strafen müssen -- 
  reich Bauer -- rufen -- vorig Woche erfrecht -- höchst nötig Bedürfnis unser arm Klösterlein gottloseste Art benützen -- 
  Diener Gott -- Fürbitter Mensch Scheffel Weizen Dreissig Taler verkaufen -- 
  Vorstellung -- hungern -- schmachen -- bewegen lassen -- einzig Pfennig annehmen -- 
  gottlos Wucherer verdienen -- Name öffentlich nennen -- Bann Kirche belegen -- Zöllner Versammlung gläubige verjagen -- Gott nachahmen -- barmherzig -- -- vergeben vergessen -- Pflicht -- warnen -- versöhn -- bereu -- einst Höllenpfuhl werfen -- heulen Zähnklappe erwarten -- Erlösung hoffen -- 
  Hannsen Nachbar Freund Verdacht Wucher Herz hegen -- sein vielmehr Gegenteil überzeugen -- -- Prediger hart rügen -- sogleich Gesicht lesen -- Betrag vermuten -- 
  wanken trostlos Kirche -- Weib folgen -- 
  Haus weinen beten -- beschließen folgend Schlaflose Nacht schrecklich Sünd beichten -- Weizen erhaltenen sechzig Taler Versöhnung Herr opfern -- 
  beicht Kloster angehören -- Sühnopfer annehmen -- Vergebung zusichern -- Folge Opfer beweisen -- Vorsatz -- gut -- wahrer Ernst -- 
  ängstigen Furcht Angst gewiss Ärmsten -- folgend Sonntage eigennützig Prediger beweisen -- Freude Himmel Sünder -- Buße tun -- groß -- neunzig Gerecht -- Buße bedürfen -- Reu -- Sühnopfer wucherischen Bauer öffentlich erzählen -- aufnehmen Bund Gnade -- Gemeinschaft selig machend Kirche -- wich Furcht Angst -- glauben arm Hans zuversichtlich -- Gott vergeben vergessen -- 
  Überzeugung wohlgemuten Arbeit -- Hausfrau unverbrüchlich Regel -- Erstlinge Früchte Viehs Kloster Herr opfern -- 
  folgend Winter bekommen Hannsen Kind Blatter -- Knabe sterben -- übrig entging Tod Mühe -- 
  Pferd brechen nachh Fuß -- fett Mastochsen finden Tod Stalle -- 
  Tod geliebt Kind kränkt Herz Vater -- Verlust Vieh glücklich Wirt äußerst traurig -- 
  tragen Weibe häufiger Opfer Kloster -- beten emsig anhaltend Kirche -- hoffen Gott Zorn versöhnen -- folgend Sommer stark Wolkenbruch grasreich Wiese überschwemmen -- Stein Sand bedecken -- glauben fest ernstlich -- Fürbitte beleidigt Kloster wirken können -- stark kräftiger suchen -- Gott Zorn streng Buße versöhnen müssen -- Haus Hof erhalten wollen -- 
  Beichtvater -- einfältig -- dumm Mönch -- Rat heischen -- bestärkt falsch Glaube -- erteilen heilsam Rat -- entfernt -- berühmter Kloster wallfahrten -- Gewalt -- groß Verbrechen versöhnen -- ruchlosest Sünder wissen waschen -- streng Gerechtigkeit Gott Flecken entdecken können -- 
  -- fügen für gute Orden sorgend Mönch -- Taler kosten -- entgehen stärkerer Verlust groß Gefahr -- 
  Hans -- Rettung -- kostbar -- wünschen suchen -- geloben sogleich Wallfahrt -- 
  Ehe Folge -- zuvor erzählen -- Hilfsmittel Kloster Ruf erwerben -- Mönch handelt -- Büßende schrecklich Irrwahne bestärken -- wiederholt Gebet Opfer -- darbrachen -- Mord Totschlag versöhnen -- scheußlichst Verbrechen ausgearteter Menschheit Meer Vergessenheit senken können -- 
  Erzählung äußerst besserten -- unbefangen Geschichtsschreiber nachzuahmen -- erwiesen -- historisch richtig Faktum darstellen -- Schminke besudeln -- Schminke dulden -- 
  Tat Aberglauben -- verheerend Wirkung -- 
  Gott -- Gewißheit sagen -- _ -- 
  Gott -- müssen gesenkt Blick gestehen -- _ -- 
  angenehmen -- laut Gotte Größe Allmacht verkündigend Täler T -- Land -- liegen -- schön Kloster -- 
  lehnen hoch stolz Mauer Berg -- Gipfel ewig Schnee -- ewig Eis decken -- blicken müde Pilger einladend durch eng Tal entgegen -- Bewunderung Wanderer erregen -- Lage deutlichsen Beweis -- Mensch groß Werk -- klein Kleinigkeit -- 
  weitläufig Gebäude -- hoch -- glänzend Türme schwinden unmerkbar Punkt -- Allmachtsgrösse Schöpfer vergleichen -- ungeheur Berg messen -- stark Hand hierher setzen -- 
  dumpf -- durchdringend Ton Glocke -- Kloster Türme zieren -- fliegen horchend Ohr unhörbar vorüber -- Donner Fels rollen -- Eisklumpe wild Tal hinabstürz -- Erde beben -- Schall Klüft umherbrüllen -- 
  fünfhunderen baut Büssend einsam Zelle -- sterben Rufe Heiligkeit -- 
  spät Jahrhundert wandernd Mönch Gelegenheit -- Klösterlein stifen -- sterbend Edl Land reichlich begabn -- 
  Ehe Hälfte Jahrhundert verfließen -- wandelt Vergrabung hölzern Türmlein hoch Turm -- Quaderstein Tal hinabglänzt -- nieder Zelle Mönch erweitern hoch -- luftig Gemächer -- Raum -- Dutzend Zecher lustig Trinker fassen -- 
  Sage durch Land -- Kloster Sünde reinigen -- schwer Last Herz Gewissen wegbeten können -- Stifter Klosters -- Erzgauner -- verrucht Bösewicht -- Vergebung erfleht -- Kraft erhalten -- Wunder wirken -- kranke heil Teufel austreiben -- 
  Sage -- Rand Leben schaudernd Sünder Vergabung reizen -- gewiß Ursache -- mehrend -- üppig lebend Mönch Auge unwissend Laie heilige erheben -- jeder Andenken ruchlosest Missetat tilgen -- jeder Verbrechen versöhnen können -- 
  herrschen blind Glaube Land -- nährt Mönch reichlich -- Kloster erbauen -- nämlich Vorzug rühmn -- suchen reuend Ferne -- Nähe finden -- Einnahme berühmt Kloster verringeren -- 
  teilen brüderlich -- sogenannter Spekulationshandel -- Mönch Jude -- 
  Betrog Wacker -- Unterschied -- Erster treuherzig Käufer künftig verkaufen -- Letzterer -- gewinnen -- Reelles liefern -- 
  ehren Kloster Mönch -- Mechanismus einträglich Handel vollkommen verstehen -- letzter Lebensstunde -- gerne irdisch Tand jenseitig Gewißheit kaufen -- geistlich Wucherer beweisen -- 
  Mäkler sicher Ehrenstelle rechnen -- geschickte Abt erwählen -- 
  Mangel geistlich Wechselnegoz Kloster T -- täglich Speis Tafel setzen -- -- Becher Wein leeren -- sterben alt -- untätig Abt -- geschicktesten Mäkler behauptet Platz -- 
  untersuchen Forscherblick Verfall klösterlich Einkünfte -- blicken durch Tal hinab -- tief Deutschland hinein überzeugen deutlich -- fett Boden Aberglauben Kloster Pilz empor wachsen -- Wechselbanke errichten -- päpstlich Kammer äußerst billig Prozent privilegieren -- Firma Anweisung unerschöpflich Gnadenfond ewig Jenseits ausstellen -- 
  Sann -- Nebenbuhler Rang abgewinn -- idealisch Gewinn Käufer versinnlichen -- anschauend darstellen -- Kauflustig Nähe Ferne herbeilocken können -- 
  sieh -- Wunsch gelingen vollkommen -- Projekt übertreffen kühn Erwartung Mönch -- 
  baut -- Endzweck erreichen -- Kirche Kloster neu Hochaltar -- Tabernakel -- lassen -- viereckig Öffnung wölben -- -- Simple Laterna Magika stellen -- Bild Gefallen -- Pöbel sehen -- innerer Altar verwechseln -- 
  Bild -- offen Höllenrachen Attribut la Kochem vorstellen -- anderer -- Heiland Mensch -- blutend Kreuze verschied -- -- Seligkeit Himmel irdisch Idee reizend abbildet -- wesentlichst Vorstellung -- Laterna magika auszieren -- 
  katholisch Kirche dasjenig Altar nennen -- Mitte Hintergrundes Kirche stehen -- Tabernakel geweiht Hostie -- Hochwürdigste -- aufbewahren -- 
  Folge Sünder Beichtstuhl erscheinen -- Beichtvater unterrichten -- 
  Reue -- sprechen Beichtenden -- echt rein -- Gewalt geben -- sünd Strafe entbinden -- 
  vorher Gelegenheit gönnen -- jetzig Zustande überzeugen -- 
  Gehen hoch Altar -- steig Stufe Höhe -- blicken Allerheiligste -- bring Nachricht -- 
  sahsen -- -- -- Zitternd bebend kehrt Sünder -- fest setzen -- erstenmal offen Höllenrachen sehen -- feuersprüde Teufel arm Seele einführen -- 
  -- -- verlieren -- verdammen -- entgegnet Beichtvater zagend Büßer -- stracks Hölle wandern -- echt Buße tun -- eifrig Fürbitter wählen -- -- -- Notleidender Hülfsbedürfige haschen gerne Letzter -- heischen stets dringend -- hienied gerne vergebens bemühen -- allemal Vermögensstand Bußfertig sorgfältig prüfen -- Opfer festsetzen -- Kloster darbringen -- eifrig Fürbitter -- 
  Büssende -- erlegen -- -- -- Geduld verweisen -- hindurch fleißig Herberge Klosters zehren -- emsig Kirche beten -- Genoß süß Hoffnung -- Gebet -- Messe -- Mönch sprechen lesen -- Versöhnung kräftiglich wirken -- 
  Prüfungszeit vollenden -- erscheinen Sünder Beichtstuhl -- sogleich Blick Heilige verweisen -- 
  gemeiniglich sterbend Heiland Kreuze -- 
  Frohlockend rufen alsdann Mönch rückgekehrt Erzähler -- Glücklicher Sterblicher -- Heiland Vermittler -- kostbaren Blut Sünde abwaschen -- streng -- väterlich Richter versöhnen -- 
  Halt -- Gebet -- opferen -- reinigen deinen Missetat hinnen ziehen -- 
  Sünder befolgen Auftrag pünktlich -- kehrt bestimmt -- letztenmal heilig -- gemeiniglich offen Himmel -- weiß Taube empor fliegen -- Engel offen arme erwarten -- 
  weiß Taube -- sprechen Beichtvater -- sünd Verbrechen gereinigt Seele -- Schnur stracks gen Himmel fahren -- stirbst -- Folge sündigen -- 
  Gehen Frieden -- Sünde vergeben versöhnen -- 
  sicher künftig Bewohner Himmel -- 
  setz Lage arm Sünder -- denken fest Glaube -- fühlen Freude Wonne -- 
  Gewissensbiß nagen Herzen -- Last ängstigen qualten -- Auge überzeugen -- reinigen Sünde -- Himmel offen arme erwarten -- 
  _ -- Dankbarkeit Verkündiger Wunder -- Mönch T -- täglich üben -- -- Gewissen ängstigen -- vollkommen Versöhnung verweisen -- 
  Ehe verflossen -- sprechen halb Deutschland Wundertätigen Klosters -- ehe endigen -- wallfahrtet -- schwer Sünde beladen -- -- reinigen versöhnen Rückkehr -- 
  Überfluß Genuß Delikatessen herrschen Kloster -- Abt klug -- Brotsamen -- Tisch schwelgend Mönch herabfielen -- nah entfernt Kloster Orden brüderlich verteilen -- Dankbarkeit Lobredner unerschöpflich Gnadenquell -- Kloster T -- Trost Erquickung bußfertig Sünder entsprungen -- stets reichlich Hervorströme -- 
  elend Kunst Trugstück Abts teich Bethsaida vergleichen -- Vorzug letzter einräumen -- Tagelang harren müssen -- geheilen gesund heim -- 
  Erfindung Abts herrlich Frucht bringen -- Folge stark vermehrt verfeinern -- 
  stellen Laterna magika Bild -- -- spähend reich arm -- Versöhnung verzögerten beförderten -- 
  -- offen Höllenrachen zurückbeben -- Hinzutrat -- Qual Fegfeuer -- Opfer erretten -- finden betend heilige -- erhaben arm Himmel flehen -- 
  Opfer bringen Himmel nah -- 
  Ordnung Menge Beichtenden erhalten -- Folge wundertätig Kast versperren -- Sünder -- Blick darein vergönnen -- erhalten Hand Beichtvater Schlüssel -- 
  Aufmerksam Beobachter wahrnehmen -- geheimer Glockenzug Direktor Maschine unterrichten -- 
  Bild Kommende darstellen -- 
  gewiß -- Täuschung Jahrhundert erhalten -- -- Hindernis -- Entdeckung befürchten -- fortwirken -- -- -- 
  denkend reisend erstaunt voll -- Kinderspiel beherzigen -- -- schrecklich Wirkung überdenken -- 
  Pracht Kirche -- Schatzkammer -- Wert golden silbern Opfer übersteigen Erwartung -- 
  Pilger Nation versammeln -- finden häufig Beichtstühle sprache kundig Mönch -- ungescheuen Spiel finstersn Aberglauben forttreiben -- 
  unglaublich -- unglaublich -- -- 
  Kloster wallfahrtet arm -- geängstigen Hans -- 
  Vergebung sünd erlangen -- groß Strafe Haus Hof abwenden -- sattelen best Pferd -- trabn anhaltend fort -- 
  _ um Herz -- Ferne Zinn Kloster erblicken -- zagend hoffend -- fürchtend zweifelnd wankt Hochaltar -- Beichtvater Schlüssel reichen -- 
  öffneen zitternd Türe -- blicken hinein -- offen Höllenrachen -- feuersprühenden Teufel -- Seele Barmherzigkeit Feuerpfuhl versenken -- 
  schrecklich -- unerwarten Anblick raubt Unglücklichen Stelle Verstand -- fest Überzeugung hierher reisen -- Vergebung schwer Sünd erlangen können -- voll Trost -- Hoffnung erwarten -- 
  schrecklich Anblick rauben beide -- 
  ewig verdammen -- schallt Ohr drang Nerv -- 
  ewig verdammen -- lallt Mund -- eilt Kirche -- Beichtvater fragen -- Gegend verschwinden -- 
  lang Woche -- kehrt harrend Gattin heim -- 
  arm Pferd -- matt wanken -- Fuß hinken -- äußerst mager -- erkennen wahrscheinlich nah Heimat -- arm Wahnsinnig ziehen -- tragen Stalle -- gut Pflege kennen -- 
  finden Abend Knecht -- Herr -- müssen mühen -- -- wild -- starr Blick Unglücklichen äußerst verstellten -- 
  Geschrei -- Hauswirt heimkehren -- erregen anfangs Freude Haus -- eilen offen arme entgegen -- schaudert -- fürchterlich Blick angrenzen -- Zurief -- 
  verdammen -- verdammen -- 
  Gewalt Stube schleppen -- müssen Lager wachen -- entfliehen -- 
  ra fürchterlich -- trauernd Gattin hindern -- Kette fesseln -- Leben Kind zagen -- einigemal erwürg -- hungrig Teufel füttern -- Einbildung -- stets offen Kralle stehen -- 
  Bild Hölle stehen fest Seele -- Weib Kind wegbeen -- Arzt Quale lindern -- dauernd Anblick verursachen -- 
  verdammen -- 
  einzig Wort -- stets schrecklich -- fürchterlich aussprechen -- nahen -- pflegen -- 
  vergebeus versuchen Mönch -- Wunde heilen -- schlagen -- 
  an Unglücklichen nahen -- Rast schrecklich -- klammeren fest Lager -- wahrscheinlich Mönch Teufel -- wähnen -- Hölle schleppen wollen -- 
  Folge Gelegenheit -- arm Wahnsinnig Besessenen -- Priester retten erlösen können -- sträflich Wucher schwer versüudigen -- 
  finden Aberglaub schrecklich Wirkung Nahrung -- errichten Thron Rücken Elenden -- vorher Boden treten -- 
  Anverwandt Unglücklichen erfahren eigentlich Ursache Wahnsinn -- wähnt -- Verbrechen Verstand verwirren -- ehe Wallfahrt vollenden -- Gnadenort erreichen -- 
  Mönch bestärkten Meinung -- nehmen Scheu häufig Opfer -- arm Gattin darbrachen -- leiden Mann milderen -- 
  sterben fünfzehn -- duldet hienied schrecklich Pein -- sterben heftig Anfalle Raserei -- gut Welt hinüber -- Mönchstrug hellsehend Auge blenden -- gerecht -- barmherzigst Richter finden -- habsüchtig Priester groß Tyrann schildern -- 
  O Wirkung Aberglauben täuschend Trug schrecklich -- verheerend -- Philosoph glauben -- Menschenfreund wähnen -- 
  Biographie Unglücklichen liefern -- Hand hart Beichtvater -- fanatisch Prediger Verstand verlieren -- Werk Größe anwachsen -- weit Arm sanft Duldung umfassen -- 
  verehr Religion innigst Ehrfurcht -- verehr würdig Diener -- hass Hirt -- Herde Fantomen Gespenster schrecken -- hindern -- Weide Genüssen -- Gott Genusse erschaffen -- 
  Zinne Wahrheit empor klimmen -- hinab blicken Tal -- Werkstätte Aberglauben -- Tat erstaunen -- 
  bauen schwankend Brücke fürchterlichsn Abgrund -- stellen warnend Zeichen Gräbchen -- sechsjährig Knabe Gefahr überschreiten -- 
  lassen Diener schroffen Fels umherklettern -- spotten Klug -- breit -- gebahnt Heerstraße wandeln -- 
  entreißen weinend Witwe schirmend Schild -- decken Mörder Gatten -- 
  reichen froh Buhldirn Hand -- stoßen tugendhaft Jungfrau Pfade hinab -- leiten -- 
  werfen Feuer friedlich Hütte Weisen -- bauen Dummheit vergoldet Paläst -- 
  stiehlen hungrig arm Brot -- mästen Hund reiche -- 
  handeln Fetzen Lump -- lassen Diamant bezahlen -- 
  messen ewig Seligkeit Elle -- verkaufen Länge Jahrtausend Pfennig -- 
  beweisen unumstößlich Grund -- Geizhals -- Trunkenbold -- Wollüstling Mörder Reich Gott eingehen können -- Freibrief -- Seitenwege hineinschleichen können -- 
  verfluchen Judas Ischariot -- Meister Dreissig Silberlinge verraten -- bieten folgend Augenblick Unwürdigst Mensch Verdienst göttlich Heiland Kauf -- 
  wuchern Himmel Hölle -- schachern Jude Fegfeuer -- 
  steinern Brautbett -- Hugo Klette -- 
  -- Fortsetzung -- -- Hugo Edeldrud eilen -- -- vorig entdecken -- Aufschluß erhalten -- finden Tod -- - trauernd Klette sinken schluchzend Arm -- sprechen -- rannen häufig Träne Wang herab -- 
  Stande -- Traured beruhigen -- 
  Hugo müssen -- damalig Sitt -- entfernen -- -- Edeldrud beerdiget -- Klette kehren -- 
  dünken weniger Ewigkeit -- 
  verflossen -- Klette -- 
  Hugo -- sprechen -- Fluch Mutter ruhen -- lieben -- -- -- -- verbirgen Busen -- Grund Verbot Eldruden bleiben Geheimnis -- 
  erinnern Klette Schmuckkästchen -- wovon Mutter -- worin Papier verwahren liegen -- Zeddel -- Befestiget -- Befehl -- 
  eher Monden Kleta's Heirat eröffnen -- vernichtet Hoffnung -- 
  denken Mönch -- Eindruck -- Edeldrud -- -- 
  kund Antwort -- hitzig Fieber danieder liegen -- Leben zweifle -- 
  Auskunft erwarten -- 
  Hugo -- Glück Liebe nahe glauben -- entfernen -- 
  Kaiser Ludwig -- Regierungsgeschäft München rufen -- lassen Zubereitungen treffen -- aufbrechen -- 
  Hugo nötigen -- folgen -- Klette unbeschützen lassen -- scheinen unmöglich -- 
  versuchen -- Klette Verbindung bereden -- 
  zufrieden -- Priester schrecklich Fluch Mutter lösen -- 
  finden dienstfertig Priester -- aufhieben -- Klette eilt geliebter München -- Verlauf Monat Hand Priester verbinden -- 
  Indes Hugo Klette Genuß Liebe glücklich fühlen -- kehren Regensburg -- 
  monden erholen Mönch -- Anblick Edeldruds betreffen -- Krankheit -- 
  erkundigen sogleich Edeldrud Klette -- berichten Tod ersteren -- -- Klette Hugo München reisen -- wahrscheinlich vermählen -- 
  Edeldrud Tochter erlauben -- Lebensgeschicke eröffnen -- einzig Kind grenzenlos Elend stürzen -- 
  verhindern -- eilt alt Mönch -- Otto Fahrwangen -- München -- Klette Hugo mütterlich Burg Böhmen abgereistn -- wohin schnell Eile folgen -- 
  finden Ankunft Garten -- 
  fürchterlich Blick schrecken -- argwöhnt Sturm -- drohen -- 
  Mönch -- 
  verheiraten -- 
  Hugo -- 
  Monden -- 
  Mönch -- 
  Unglückliche -- ahnden -- -- Klette Schwester -- -- Hugo -- Bruder -- 
  Wort Greis Ohnmacht nahe -- Hugo Rasenbank leiten -- Mönch -- 
  -- Klette zeigend -- Stehe -- sprechen -- 
  Nachricht Ohr schrecklich -- sinken -- stehen -- vermögen -- 
  Klette sinken -- eilt Hugo Hilfe herbei -- nötig -- Schreckenswort unbekannte all Glück -- froh Aussicht vernichteten -- 
  schlepen Ohnmächtige Gemache -- eilt Garten -- schrecklich Nachricht prüfen -- möglich Gegengründe bestreiten -- 
  voll Gewißheit Unglück -- 
  ehemalig Pflegvater -- Edle Immental -- Sohn erziehen -- alt siech -- entdecken -- Kind -- Sohn Unglücklichen Otto Fahrwang -- einst Freund lieben -- -- lall -- Nachtzeit überbrachen -- einzig Pfand höchst unglücklichen -- namlos Liebe anvertrauen -- 
  wissen -- sprechen Greis Hugo -- Vater hienieden wallen -- -- Gott Arm führen -- sicher gewiß Erkennst -- verwahr Stück zerbrochen Ringe möglichst Sorgfalt -- 
  -- Hälfte zeigen -- Vater -- ehren -- höchst unglücklich -- höchst unschuldig -- 
  Sage -- tun -- Freundespflicht erfüllen -- 
  Name auslöschen Name Edlen Land -- dringend Bitte Kaiser erhalten -- Meinig führen -- 
  Gott -- Fest Erbteil hinterlassen -- -- ehe Bitte Kaiser wagen -- verdient Krieger belehnen -- Schwert hinterlassen -- -- führst -- ähnlich Belohnung erwerben -- 
  Hugo erinnern Wort -- 
  tragen Hälfte golden Ring stets Brust -- stolz unglücklich Vater -- regierend Kaiser längst verzeihen neigen -- wünschen sehnlich -- sehen umarmen -- wähnen -- Erfüllung Wunsche höchst unglücklich -- 
  nahen -- Ring Hand -- zitternd Mönch -- 
  Ha -- verstehen -- sprechen -- prüfen -- 
  Vater -- 
  nimm -- Hälfte reichen -- sieh -- einer ausmachen -- 
  Hugo fügen Stück zitternd -- sinken überzeugend Mönch Fuß nieder -- 
  Todesbecher reichsen -- Grausamkeit hindern -- Vater grüßen Ehre -- 
  Mönch sinken gerührt Brust hinab -- fühlen -- ehe Hugo wagt wiedergefunden Vater fragen -- 
  geliebt Weib Schwester -- 
  Trennung grenzenlos elend müssen -- 
  Mönch -- 
  Gott -- trösten -- 
  Gott -- unglücklich Heirat erfahren -- 
  unwissende sündigen -- sicher Verzeihung -- -- -- reden -- -- Sündenschal belasten -- ohnehin tief sinken -- 
  vertrauen unendlich Barmherzigkeit Ewigen lassen hoffen -- Reu heben -- 
  überzeugen -- Lebensgeschicht erzählen -- 
  Veracht -- Vater gestehen -- einst ruchlos Bösewicht -- 
  dienen -- alt -- Kaiser Albrecht Hofe -- Rudolph Palm vertrautest Freund -- verbünden Herzog Johann Leben Kaiser -- führen Gesellschaft Bubenstück -- 
  -- mutmaßen zweideutig Rede -- Freund -- Verrat unglücklich -- 
  bleiben -- Täter fliehen -- 
  Albrechts Kind Rachschwert ergreifen -- -- Täter ehemals Gemeinschaft pflog -- Gericht führen -- allzu streng richten -- treiben Angst Furcht Flucht -- 
  verdächtig -- überall suchen verfolgen -- 
  fliehen Böhmen Grenze -- irren Wälder umh -- Räuberhorde Bekanntschaft -- Höhle Forst ungestört wohnen -- Bund aufnehmen versprechen -- 
  nirgends Sicherheit -- nirgends Hoffnung -- ergriff einzig -- Leben frisen -- Hunger sterben -- 
  bekennen -- Gesellschaft rauben -- Tapferkeit ansehen Hochachtung erwerben -- 
  mächtig Bund Entdeckung -- möglich Verrat sicheren -- grausam Gesetz errichten -- 
  grausamsen -- jeder Glied berechtigen -- Töchter Land Dirne rauben -- Weib heimzuführen -- müssen vorher schwören -- hindern wollen -- Unglücklichen Zunge abschneiden -- möglich Flucht Entdeckung verraten können -- 
  schaudert -- unglücklich Geschöpf Höhle umherwandeln -- staunen -- überzeugen -- sprachlosen Dirn Gatt innig lieben -- Kind sorgfältig -- treu Mutter pflegen -- 
  sterben Anführer Horde -- dreihundern Glied stark -- 
  erkannt Tapferst -- wählen Hauptmann -- müssen schwören -- Bund aufrecht erhalten -- jeder Gesetz Strenge schützen -- 
  einst untergebene glücklich Raube unser Forst kehren -- begegnen schön Edeldrud -- wahrscheinlich iu nah Kapelle beten -- Schleier wallen frei umher -- deckt Angesicht -- nahn -- 
  Engelgesicht -- reizend Gestalt weckt Liebe -- Herz fliegen entgegen -- folgen unwillkürlich -- väterlich Fest ziehen -- 
  wälzen schlaflos Lager umh -- Gestalt -- innig Liebe wallen heiß Blut -- durchdrang Nerv -- kraftlos -- glich Tränmende -- Kind -- emporstreben zurücksinken -- 
  Räuber achteten krank -- gönnt Ruhe -- nützen -- verbergen täglich nah Kapelle -- hold Dirne sehen -- 
  -- Liebe mehren -- heischen stürmisch Trost Rettung -- wallen verzweiflungsvoll umh -- untergeleg -- Räuber Zustand ahnden -- Aussicht öffnen -- vorher denken wagen -- 
  Riet einstimmig -- Dirne entführen -- Weib sollen -- 
  ergriff Rat ungestüm Freude -- schaudert -- überlegen -- hülflos unglücklich -- grausam Gesetz üben -- Zunge abschneiden -- andächtig beten -- 
  lassen sterben -- sprechen Räuber -- lieben -- Gegenstand innigst Liebe verunstalten sehen -- 
  Räuber scheinen Leid fühlen -- sehen nebenbei -- untätig verschmachten -- treten Lager -- versprachen -- Gesetze Vollstreckung fordern -- echt Neigung Hauptmanne Ausnahme -- künftig Weibe Zunge berühren -- 
  Gelübde froh tätig -- ziehen hernach Tapferst Gefährt Spähe -- laueren Kapelle -- rauben Inniggeliebt glücklich abend Tag -- 
  tragen ohnmächtig Höhle -- erwacht -- kämpfen Verzweiflung -- haßt verachtet Urheber Unglück -- fluchen -- flehend Liebe heischen -- 
  Gegenwart mehrt Wut -- ruchlosen Räuber wecken Spott Hohn -- lacht tapfer Hauptmann -- schwach Weib zwingen können -- 
  verachte -- verabscheu deinen Vater -- gestehen -- heftigst Leidenschaft siegen -- Gewalt rauben -- bitte gewähren -- 
  Glücklicher Erfolg krönt schändlich Unternehmen -- kühn -- rasend Dirne duldender -- schmachtend Weib -- scheinen Unglück tief fühlen -- rächt Schimpfwort -- Träne -- 
  gebar Sohn -- 
  warst -- 
  O heben dankend frohlockend Höhe -- erstenmal arme erblicken -- scheinen Liebe fühlen -- lohnen erstenmal freiwillig Kuß -- 
  Halb alt warst -- Nachricht -- böhmischen König Johann Braut Elisabeth Weib Prag führen -- kostbar Schatz folgen -- Vater Wenzel ererben -- Fest bewahren -- Tagereis unser Höhle entfernt liegen -- 
  Gefährden ausgekundschaften -- zweihundern Lanzenknecht geleiten -- achtet Raub -- 
  stellen vergebens -- kriegerisch König Raub -- gelingen -- strengste Spähe stark Rache ahnden -- verblendeter behaupten -- Schatz hinreichen -- verbündeter Lebenszeit glücklich -- 
  weilen -- sprechen -- unser Höhle -- teilen -- vernichten unser Bund -- zerstreuen weit Welt -- Frucht Tapferkeit ruhig Gefahr Genüsse -- vierfach -- Winkel Erde finden -- geliebt Weib ruhig Genüsse -- 
  Versprechen reizen -- erfahren -- neuerwählen Kaiser Heinrich Luxemburg allzu streng Rache Albrechtische Familie tadle -- hindern suchen -- 
  hoffen erborgt Name Welt innig geliebt Weib leben -- ziehen Räuber -- Glück fördern -- 
  Kampf -- Raub glücklich -- sicher Lanzenknecht Tale überfallen -- meistens töten -- 
  Menge Saumrosse seitwärts leiten -- ziehen bairisch jung Herzog -- Sohn jetzig Kaiser Ludewig sechshunderen Reiter Straße herauf -- Prag Hochzeitsfest Königs feiern helfen -- 
  entflohen Lanzenknecht Raube benachrichtigen -- Hilfe bitten -- 
  stürmt Übermacht -- müssen fliehen -- Beute Sieger überlassen -- 
  Räuber bleiben verwunden Schlachtfelde liegen -- wahrscheinlich Bekenntnis unser Aufenthalt erzwingen -- -- zweihunderen Eingang Forst erreichen -- anziehen -- 
  gedacht Edeldrud Kinde -- senden sogleich Dreissig Reiter -- auf eilig Weiber -- Kind -- Höhle verborgen Schatz retten möchten -- 
  bescheiden -- wohlbekannt Forst -- versprechen Sieger kämpfen -- retten -- Sicherheit -- 
  Herzog nähern -- Widerstand vermuten -- Reiter wichen anfangs -- -- beschützen Bäumen -- tapfer wehrten -- 
  faßt Mut -- kämpfen Vorteil -- müssen weichen -- leiten abseits -- erneuern Kampf -- Abgesandt Rettung gönnen -- 
  Sicherheit glauben -- Zahl Kämpfer minderen -- sammeln schnell -- entschwinden Auge Siegers -- 
  jagen rastlos bestimmt Forst -- harrt Fels gerettet Weiber -- Kind Schatz -- 
  melden Späher Felsenspitze -- Gerettet Tal heraufzögen -- eilen entgegen -- suchen Edeldrud -- finden -- 
  angstvoll fragen -- überreichen Weib Sohn -- -- geliebt Hugo -- 
  schließen dankend arme -- forschen auf Edeldrud -- 
  Räuber treten -- 
  Hauptmann -- sprechen -- rufen Gegenwärtige Zeuge -- anwenden -- Geliebte retten -- achten weder Ernst Bitte -- weich Höhle -- widersetzen Gewalt -- 
  dringend -- Horchende hören fern Huftritte -- 
  wirsts ahnden rächen -- Sicherheit denken -- Widerstrebende zurückließ -- -- einstimmig Rat -- Zunge abschneten -- -- Verräterin können -- 
  _ wagen -- Zustand schildern -- unnennbar Schmerz -- 
  durchbohrt Brust ruchlosen Täter -- ra -- zwingen -- bind -- Mordtat verhüten -- 
  fühlen denken -- matt kraftlos -- bitten flehte -- erlauben mögen -- verlaßen Höhle kundschaft -- arm Edeldrud retten -- Rettung -- 
  Räuber lieben ehrten -- fühlen Mitleid Zustande -- begleiteten Höhle -- 
  Jammer -- Größe Unendliche reichen -- finden dennoch Stoff Vermehrung -- 
  Sieger unst verborgen Höhle finden -- zorn Iugrimme Holz Reisser dicht anfüllen -- Feuer darein werfen -- 
  glimmt Kohl -- schrecklich Hitze verwehrt Eingang -- 
  Konute vermuten -- schwer verwundet -- gepflegt Edeldrud -- hülflos Lager schmachten -- Raub Flamme -- 
  rast -- Gefährde hindern -- glühend Höhle stürzen -- enden -- 
  Gram -- rastlos Herzen nagen -- unfähig -- Räuber Hauptmann bleiben -- Höhle wählen -- nisteten -- ehe -- Fels -- 
  einst Raub auszog -- Kraft fühlen -- Arm -- verlassen Höhle fest Vorsatze -- Rückzukehr -- all Lebelang streng Ausübung Verbrechen bereuen -- 
  gelangen glücklich Fest ehemalig Freund Immental -- entdecken -- aufnehmen -- 
  versprechen -- Vater -- fordern heischen -- 
  Pilgerkleide wanderen Avignon -- beichtet Sünde -- erhalten Verzeihung -- Kloster aufnehmen -- Eifer erforderlich Wissenschaft widmen -- Folge Priester weihen -- 
  Ordensgeneral senden Jahresfrist Auftrag Deutschland -- erfüllen gerne -- vaterlande sehnt -- vorzüglich wissen wünschen -- ergehen -- 
  sprechen Immentals Fest -- erfahren -- tot -- geliebt Pflegsohn Kaiser Hofe leben -- Liebling -- 
  eilend fliehen Regensburg -- -- Auge -- Gesicht -- fühlen erstenmal rein Freude -- 
  kennen -- leben einsam Kloster -- -- sehen -- sättigt Überzeugung -- edl -- Sohn seisen -- 
  nahen -- zuflüstern -- Vater dulde leiden -- zögert Vorsatz -- Freude nah Turnier verbittern -- 
  Kampfe -- zugegen -- schön -- unbekannt Jungfrau -- Preis reichen -- Wange küßen -- 
  ahnden -- Jungfrau Weib -- Schwester können -- 
  nachh Sehnsucht -- umarmen -- groß -- besuchen -- la Absicht früh Messe -- 
  enden -- Volk segnen -- erblickt Fuß Altar Mutter -- unvergeßlich Edeldrud -- 
  starren fürchterlich empor -- staunend hinab -- Fuß zitteren -- Sinn wichen -- sinken ohnmächtig Boden -- liegen Lager Zelle -- denken empfinden -- 
  Bild schweben -- Fieberhitze glüht Ader -- rauben Verstand -- 
  monden kämpfen Tod -- erholen langsam -- 
  Freund -- Anliegen entdecken -- harrt Ungeduld -- Kraft Ausgang gestatteten -- 
  erfahren sogleich -- Kaiser gen München ziehen seist -- Tochter edlen -- stumm Böhmin heiraten Würdest -- 
  zittert bebt -- forscht Wohnung -- erfahren -- Tochter München reisen -- Mutter sterben -- -- wahrscheinlich -- erkennen -- 
  vergessen Pflicht Gelübde Orden -- eilt München -- hören -- Unglück vollenden -- Bruder Schwester heiraten -- 
  Schilderung edel Paar -- Zunge beschäftigen -- Beschreibung rein -- echt Liebe quälen Herz reizt Mitleid -- 
  zögeren -- Glück stören -- achten Ungerecht grausam -- schuldlosest Mensch grenzenlos unglücklich -- Gewissen Mitleid laut widersprechen -- Rat Trost gelehrtest würdigst Priester suchen -- Sonnenklar beweisen -- absichtlich Blutschander förder -- schrecklich Folge Verbrechen teilhaftig machen -- müssen Mitleid weichen -- 
  stehen nah Grab -- _ schuldlos -- -- besteigen -- 
  Anklägerin Harret -- zittre Verantwortung -- Anklage vergrößern -- Gott danken -- Kraft verliehn -- hierher folgen -- Verbrechen enden -- 
  folgen väterlich Rate -- weihen Himmel -- versöhnen Gott eu Gebet -- 
  Hugo -- 
  -- trostlos jammernd -- Gott Vater -- stehen -- stehen Klette -- 
  Allmächtiger -- gabst namlos Glück -- vergällst größer Unglück -- 
  Laß -- Glück -- dauern -- -- fassend -- dämmern Licht graus Finsternis -- leuchten Ferne Hoffnungsschimmer -- 
  gedachtest Geschichte Kleta Geburt -- 
  Tochter Schwester -- 
  Mönch -- 
  Klette Tochter -- -- Hugo -- 
  -- frohlockend -- Heil -- 
  Mönch -- 
  Tochter Mutter -- folglich Schwester -- 
  Hugo -- 
  Weh -- 
  Weh -- 
  Mönch -- 
  wahrscheinlich rettet Unglückliche Höhle -- glücklich heilen -- 
  wahrscheinlich heiratet Folge edl Gatte -- Tochter gebar -- 
  achten tot -- kenn Geschichte Leben -- 
  allgemein Sage verkündigen -- Klette Tochter -- -- -- Hugo -- 
  Ha -- 
  O -- Allmächtiger -- -- Vater Arm sinkend -- -- teuer Vater -- letzter Nachricht lassen hoffen -- 
  Ah -- wohltätig Hoffnung Ader durchströmen -- kalt Nerv erwärmen -- Wiederempfindung reizen -- 
  Vater -- 
  Vater -- hoffen -- 
  Vater -- Grund -- -- -- -- wahrscheinlich gewiß -- Klette Tochter Mutter -- angenommen -- Pflegkind -- 
  Höre urteilen -- 
  -- hastig schnell -- 
  Klette erlauben -- Hochzeit bestimmen -- wonnetrunken Wappenherold Priester eilt -- Gebot -- Wappe stellen -- ersucht -- verbinden sollen -- fordern erster edl Vater Stammbaum -- letzterer Zeugnis Geburt -- eilen -- gestehen offen Unschuld -- Vater Name kennen -- Zeugnis Geburt besitzen -- 
  verbergen Kummer -- irren trauernd nachdenkend Burggarte umher -- Kaiser begegnen -- Ursache Kummer forschen -- erzählen -- lächelen Sanft -- sprechen -- 
  ruhig -- kenn Vater -- Edlerer -- -- stehen Throne -- kenn Ort Geburt -- Herold Priester sprechen -- Hindernis erregen -- 
  danken -- stehen schön -- unbekannt Wappen Seite -- Priester forschen Zeugnis Geburt -- 
  -- -- Komme -- eilen -- Hoffnung trösten -- eilend Kaiser nachziehen -- Aufklärung erhalten -- 
  Mönch -- 
  Geben Gott -- Hoffnung Gewißheit -- 
  O kräftig tröst stärken -- Glück zerstören -- dein arme enden -- deinen Segen Grab nehmen -- 
  -- 
  Gott geben Erfüllung -- hoffen -- 
  eilen unglücklich Klette -- erwachen Gefühle Jammer Elend -- liegen weinend Hand ringend Lager -- 
  -- rufen Hugo entgegen -- Mutter Fluch Erfüllung -- drücken Pfühl Lager Stein -- 
  Priester log -- schrecklich Fluch lösen -- ruhen schwer -- 
  Hugo -- unbekannt -- verstehen Sinn Wort -- forschen -- Tröste erquicken -- 
  erzählt Vater Geschichte Kürze -- fügen Mutmassung hinzu -- Herz Hoffnung möglich Rettung wecken -- 
  Klette widersprechen Hoffnung laut -- 
  -- sprechen -- Vater kennen -- wissen gewiß -- Edeldrud gebar -- folglich Mutter -- 
  erinneren -- unbekannt Vater schön Fest leben -- -- bedürfen _ Erinnerung -- Gewißheit entscheiden -- 
  reich Schmuckkästchen -- -- -- hastig -- Reiche _ -- Fluch laden -- vorher wissen -- 
  Gatte erkennen -- 
  Hugo -- 
  gestern enden Mond -- -- -- Klette -- 
  gib -- -- unglücke überzeugen -- 
  Ah Ursache Weigerung -- 
  Ahnung -- 
  Erkenntnis Zug Vater Gesichte Sohnes -- 
  O _ Helle -- spät -- -- O Allmächtiger spät -- 
  bleiben schrecklich Verzweiflung -- 
  Hugo indes Schmuckkästchen überbrachen -- Klette öffnet zitternd Hand -- versiegelt Schreiben heraus -- 
  fähig öffnen -- 
  Weiche -- sprechen -- Siegel abriß -- weich -- schrecklich Mutterfluch -- verdienen -- redlich Mondlang harren -- -- -- lesen -- vermögen -- reichen zitternd Hand Mönch -- 
  -- sprechen -- Geschichte -- Blatt enthalten -- lassen laut -- unser Unglück gewiß -- falsch Hoffnung nagen -- 
  Mönch weigern -- hoffend Hugo bitten dringend -- Vater vermögen wiedergefundenen Sohne Bitte lang weigern -- gelobt Gewährung -- 
  Gerechter Gott -- rufen -- ehr dein Wille -- verdienen Strafe -- Angesichte Sohnes schrecklichste Anklage laut verkündigen -- 
  standhaft ertragen -- murren -- gerecht Zorn Flucht -- 
  ermüdend -- wiederholen -- Mönch vorher ausführlich erzählt -- erwähn -- Erzählung schonend gedacht -- namlos Schmerz kräftig Wort schildern -- gestehen -- grenzenlos Liebe Urheber Unglück einsah -- Mitleid sogar Beginn Gegenliebe fühlen -- 
  Mönch sinken dankend Knie -- Bekenntnis lesen -- O sterbe zufrieden vergnügen -- rufen -- Verzeihung hoffen -- -- zitteren auf -- schrecklich Szene -- Räuber Zunge raubten -- glauben -- Urheber grausamen anklagen -- Folge überzeugen -- 
  -- Ritter -- schreiben -- Gefährt ausgezogen -- sitzen Sohne Lager -- fühlt Freude Mutter -- gedacht lebhaft Schmerz Meinig -- wahrscheinlich Kind entbehren -- 
  Dumpf Geräusch jammernd wehklagen schreckt Gedanke empor -- Räuber treten eilfertig Gemach -- ergriff Sohn -- reißen Lager -- gebot schnell Folge -- 
  kennen äußerste Bosheit roh Leute -- wähnen -- Ritter empöret -- ermorden -- Fortschleppe -- widerstrebte -- klammeren an Lager -- schri Hilfe -- 
  Räuber springen herbei -- Eilt -- Schri -- verlieren -- 
  Ruf vermehrt Argwohn -- widerstand Kraft -- wichen -- mehrere springen herbei -- Martert -- quälen schrecklich -- schneiden groß Zunge -- 
  liegen blutend ohnmächtig Boden -- 
  erwachen -- stehen fremd -- jung Ritter -- blicken huldvoll mitleidig herab -- knien nieder -- wischen strömend Blut Angesichte -- 
  frei tragen -- Reiter schlept Holz Äste Höhle -- stecken letzterer Brand -- 
  heben flehend Hand Ritter empor -- tröstet liebreichst Wort -- Stimme Mitleids drang lieblich Ohr -- danken Gebärde -- _ Wort vermögen -- 
  vergebens forschen -- 
  -- 
  hierher kommen -- 
  Antwort -- 
  Gebot vierzig Leute -- möglichst Sorgfalt Bayern Arzt -- nennen -- Geleit -- 
  bitten herzlich -- innig -- teuer Leben schonen -- Vorschrift fügen -- ferner Schutz versichern bleiben -- 
  geloben -- danken -- Auge glänzt Träne -- Schied rühren -- versprechen -- besuchen -- 
  reisig begegnen Ehrfurcht -- Schmerzen Wunde mehren -- Ross Tritt ertragen -- legen breit Decke -- tragen abwechselnd rastlos fort -- 
  Ohnmacht Bewußtsein wechseln Seele -- erstern scheinen Sieg erringen -- dauern -- 
  erwachen -- stehen Bild Ritter -- mitleidig -- huldvoll Min erwecken Wunsch Leben -- Leben danken -- Hilfe elend verschmachten -- 
  Verlust Sohnes ängstigen Herz -- Vater gedacht Schauder -- Urheber all Unglück -- 
  Mittage bringen glücklich Wohnung Arzt -- 
  staunen -- Name jung Herzog äußerer Sorgfalt empfehlen -- _ deutlich -- Rettung verzweifelen -- dürsten schrecklich -- Labetrunk genießen -- geschwollen Wunde drohen ersticken -- 
  Linderung schaffen -- sagen -- liegen betäubenden Fieber -- Bewußtsein rauben -- besseren -- ehe Monden verfließen -- Gefahr entrissen -- ehe enden -- fühlt Verlust Zunge -- Schmerz -- 
  Arzt Tochter treu Wärterin -- pflegen Sorgfalt -- innig Zuneigung verraten -- 
  hört Vergnügen -- Reiter Gemache Arzt erscheinen -- genau Zustande -- Besserung forschen -- 
  bringen Kleid Leinenzeug Menge -- treten Lager -- Aussage -- Augenschein Besserung überzeugen -- forschen -- 
  schreiben lesen können -- bedauert Name Herr -- verneinen müssen -- 
  Lager verlassen -- Gemache umher wandelen -- Versicherung Wärterin gemäß -- Rose blühen -- hören Getümmel Haus Arzt -- 
  blicken hinab -- Retter Roß steigen -- eilt Gemache -- bleiben voll Verwunderung weniger Schönheit Türe stehen -- 
  euer herrlich Bild -- sprechen -- stehen Auge -- _ schlafend wachend -- eur Gegenwart überzeugen deutlich -- Einbildungskraft armselig Ding -- Dämmerung zeigen -- hell Licht herrschen -- 
  Verwirrung -- sprechen -- antworten -- 
  Freude glücklich Rettung -- blühend Gesundheit echt rein -- Hilfe lebhaft warm -- 
  lieben -- Ritter Otto -- schrecklich rauben -- Mitleid dulden -- überwältigen gefährlich -- süß Leidenschaft Herz -- 
  -- hören -- geliebt Retter -- vergessen Vater -- Mutter Sohn -- nachher gestehen -- Lohne edlen Mitleid fordern -- gestehen -- lieb Unglücklichste Sterblichen -- 
  erzählen -- Kaiser Ludwig unecht -- zärtlich geliebt anerkannt Sohn -- -- Forst finden -- böhmischen König Johann gesandt -- Vermählung Glück wünschen -- Zug Schatz Braut retten -- Räuber Hand -- 
  tapferen -- segnen -- finden -- Liebe König erwerben -- müssen wider Wille lang Hof weilen -- Landshut -- Vater Bericht erstatten -- Fest ziehen -- nah Tirol Grenze liegen -- Vater Erbteil schenken -- 
  flehen -- ziehen -- schön Gegend Paradies wandeln -- versprechen _ -- frohlocken -- 
  forschen emsig Geschichte -- -- Vater Stand Name -- Mühe -- anwenden -- begreiflich -- Vater edl Ritter -- Räuber List rauben -- 
  fordern -- ziehen -- willig -- 
  Ehe Fest erreichen -- -- innig Liebe gestehen -- angelangen -- treten ehrwürdigen Mönch Gemach -- heischt Erklärung -- 
  Gegenwart Priester Hand reichen -- Weib wollen -- 
  gedingen erstenmal Verbindung Räuberhauptmanne -- freilich Priester segnen -- entdecken wünschen -- 
  kämpfen anhaltend -- Scham Gefühl widersprechen Bekenntnis -- ohnehin leisten -- lieben stark heftig -- Widerstand lang -- reichen Burgkapell Hand -- 
  lieben Gatte zärtlich -- stets innig -- verlassen -- äußerste Notwendigkeit zwingen -- Hofe Vater erscheinen -- 
  vermehrt Zärtlichkeit groß Sehnsucht kehrt Arm -- Genoß arme schön Glück rein Liebe -- 
  weinen -- zärtlich Wort stumm Blick erwidern -- wünschen sehnlich deutlich Zeichen ausdrücken -- wund -- weder edel Schreibekunst -- Wort dienen -- gedacht -- wahrscheinlich verstehen -- erinnern Hilfsmittel -- behaupten -- stumm beredt Blick Herz fest stark fessle -- 
  halb Ehe gestehen -- Vater Kenntnis -- hoffen -- einst billig -- erlauben -- Triumph Hof führen -- 
  verflossen -- gebar Tochter -- 
  -- warst -- geliebt Klette -- -- 
  -- -- -- Mönch halten inne -- starren Hugo Klette -- vereinen laut aufschrien -- voll Verzweiflung Hand rangen -- 
  schwinden letzter Hoffnung -- jammeren Hugo -- _ weissagen -- wimmert Klette -- verhülln Gesicht -- 
  Mönch rang Trost Unglücklichen -- finden -- 
  heischt Klette Erfolg Geschichte -- wischen Träne Auge -- lesen -- -- unfähig -- Wonne dein Vater schildern -- Jagd rückkehrn -- Wärterinne Arm legen -- 
  segnen kräftig -- gelobt Gott -- Vater -- leben -- Glück Tod befördern befestigen -- 
  Gott schenken Folge Kind -- warst einzig Pfand Liebe -- Vater lieben Augapfel -- zärtlich -- Kuß -- erhalten -- doppelt -- 
  --- glücklichst Leben -- -- verflossen still -- genußreich Ruhe -- 
  zehnmal ziehen Absicht Vater Hofe -- Heirat entdecken -- verschweigen -- möglich -- böse Ausgang fürchten -- Freude -- Leben denken -- 
  Vater Zug Italien beschließen -- nehmen -- zwingen äußerste Not Entdeckung -- 
  Anfangs zürnte gnädig Vater heftig -- erzählt -- ehemalig Schicksal auf Lebhafteste schildern -- Schönheit -- Geistesgabe allzu reichlich lobpreiste -- Glück rührendst Wort erzählen -- neigen Herz Verzeihung -- vergeben voreilig Schritt -- versprechen Heerzug Sohn Fest einzukehren -- Glück überzeugen -- entlassen Zug Italien -- 
  -- sprechen liebreich -- einst innig lieben -- warst Frucht Liebe -- erinneren -- gewaltsam Trennung beinahe Leben kosten -- hart -- Vater -- trennen geliebt Gattin -- sehen -- segnen -- 
  reichlich Schweiß hastigsten Eile trieft Wang -- Botschaft bringen -- Genoß golden Frucht -- träumt heiterst -- glücklich Zukunft -- 
  fest Vorsatz _ -- vollendet Versöhnung Gatte bewegen -- Böhmen reisen -- 
  kennen Gegend -- Vater Fest liegen -- hoffen finden -- Segen teuer Eltern Glück vergrößern -- 
  einsamen Stunde Jammer -- Wonne Wiedersehens denken -- bitte wagen -- Vater Gatten Heirat -- Zug Böhmen fruchtbar -- 
  harrt Ankunft Kaiser entgegen -- langen Eilbot Fest -- bringen froh Nachricht -- Nacht folgend Tag -- -- sicher anlangen -- 
  Gatt ehe prächtig Kleid -- herrlichst Kleinodie beschenken -- fordern -- schön zieren -- gewand folgend Putze -- harrt Abend hoffend ahnend Ankunft Kaiser -- 
  -- Klette -- warst schön putzen -- glichst Engel Unschuld -- 
  erinnerst -- Vater schön Willkommen lehren -- _ emsig vormacht -- vornehmen Gast entgegeneilen -- Arm ausstrecken -- Knie umfassen Solltest -- 
  finster Nacht Gegend decken -- Schwand Hoffnung -- wecken Wächter Ruf auf -- melden nachher -- reisig Tal herauf zögen -- 
  Vater lassen Fackel anzünden -- Tor öffnen -- 
  eilt arm Treppe hinab -- vergessen Eile -- arm Wärterin Schlummertest -- 
  hinab kommen -- füllen Reiter Vorhof -- zitteren bebt -- Schwertklang Jammergeschrei Diener hören -- 
  Gatte drang vorwärts -- Schwert Haupt glänzen -- -- sinken ohnmächtig Boden -- 
  erwachen -- stehen Fest hell Flamme -- verwunden Knecht Diener winseln unfern -- 
  Reiter umgaben -- bedeckt Mantel -- heben Roß -- 
  jammeren schrecklich -- barmherzig -- Klette -- auf Roß reichen -- klammertesen Hand Nack -- halten Gewalt aufrecht -- sinken lassen -- 
  Zug beginnen eilend schnell -- müssen Mitte traben -- 
  Auge suchen Finsternis geliebt Gatten -- finden -- 
  glauben -- Rache verstellten versöhnt Vater -- wähnen -- arme gerissen -- ewig einzukerkern -- 
  Leid -- mehren Riesengröß -- anbrach -- voll Gewißheit -- Gesellschaft Räuber befinden -- Höhle Forst wohnen -- 
  grüßen höhnisch -- blicken Mitleidig -- 
  ahndet schrecklich Ding -- wähnen -- Hauptmann -- heftig Liebe kennen -- Aufenthalt entdecken -- Gatte entreißen -- Buhlerin wollen -- 
  fähig -- schaudervoll entsetzen Gedanke schildern -- erregen Vorsatz Selbstmorde -- gewiß schnell ausführen -- Anblick abhalten -- 
  ungewiß -- 
  vernichten -- Hand ruchloser Räuber zurücklassen -- 
  mittag rastet dunkel Forst -- 
  Räuber lagert Boden -- ruhen sanft -- Ältest setzen wachend -- boen Trank Speise -- führen -- 
  gedachen -- verschmähen -- alte barmherzig -- Mutterstelle vertreten -- dein Hunger stillen -- 
  Auge überzeugen -- ehemalig Geliebter Mitte ziehen -- gerne fragen -- schrecklich Schicksal gewiß -- Verlust Zunge hinderen -- 
  Älteste wahrscheinlich Sehnsucht Aufklärung Gesicht lesen -- blicken Mitleidsvoll -- 
  arm Frau -- sprechen -- Rache vorbereiten -- treffen unschuldig -- - glücklich -- Zeichen begreiflich -- Erzählung Begebenheit hören wünsch -- wärmst Danke lohnen -- 
  achtet Bitte -- erzählt -- unglücklich Raube -- Schatze königlich Braut üben -- Hauptmann -- einst lieben raubt -- verlassen -- 
  geschehen -- -- gerecht Schmerz grausam -- Gesellschaft wider Wille Befehl üben -- 
  Galt Tod -- suchen Höhle -- finden -- verlassen -- Einöde eueren Tod betrauern -- 
  wählen -- bereiten Forst Wohnung -- Böhmen Rache reizen -- Entdeckung unser Aufenthalt zwingen möchten -- fest beschließen -- Land Raub üben -- benachbart Land umherstreifen -- unser Raub Unterhalt suchen -- 
  klug Vorsicht schützen herrlich -- überall suchen Aufenthalt mächtig Räuber ausforschen -- Böhmen -- Raub klagen -- Räuber Nähe wähnen -- 
  monden vernahmen -- Edle reich Kostbarkeit beladen Italien ziehen -- Krönung Kaiser feiern helfen -- 
  eilen geteilt Haufen Bayern -- verlegt verschieden Straße -- Italien führen -- suchen Beute -- 
  Haus Forst -- nahe eurer Fest liegen -- lauern -- erfuhr Bauer -- Kaiser Sohn -- einst schrecklich züchtigt -- Haus -- arme Stumm schwelge -- einst Böhmen bringen -- 
  Begierde Rache Haus regen -- meister gelobt -- ehemalig Unbild rächen -- geliebt Stumm entführen -- sogleich erkannten -- 
  erfahren -- 
  eur Fest bemannen bewachen -- ziehen verschieden Spähe -- bringen tröstend Nachricht -- gewiß erfahren -- reisige -- meistens unbewaffnet mägde Diener wohnen -- 
  Sturm Fest beschließen -- Kundschaft -- Kaiser stark Zug nahe -- 
  antasten -- Wille -- reichen Kraft -- Straße -- tief Forst ziehen -- Unser Nachricht bringen -- Kaiser Nacht Burg erwarten -- gewiß anlang -- nah Städtchen Gegenwart weniger Gefolg Nachtherberge nehmen -- Reiter reisig Straße gen Tirol vorwärts gesandt -- 
  glücklich Umstande -- fahren fort -- schnell List Rache fördern -- 
  Kaiser Sohn erwarten Vater -- erfahren Diener -- Straße spähen -- forschen -- benutzt Gelegenheit -- versichert -- Anzug begreifen -- 
  -- Bruder -- -- lassen -- _ dunkel -- Fest ziehen -- sicher glauben -- Kaiser nahe -- Tor öffnen -- 
  voll Gelegenheit -- Rache Sicher üben -- überzeugen -- ungeahnden beleidige -- 
  Wagstück -- Reiz -- 
  -- Gefährte deutend -- behagen -- müssen Strom folgen -- 
  List gelingen -- Rache vollenden -- 
  Gatt Buhle -- einst Unser ermorden -- Höhle zerstören -- müssen Überzeugung sterben -- Rache üben -- 
  Tod beschließen kostbar Anzug -- Schönheit -- blendet Auge meisten -- Sinne -- 
  neu Hauptmann Geliebte -- bestimmen -- verlangen Kind -- reichen -- trösten -- 
  schick Schicksal -- warst ehe wohnen -- 
  Hauptmann jung schön -- erzählen -- ehemals lieben -- ehren -- bewog vorzüglich Entschluss -- 
  Weise -- Wohlergehen -- 
  -- -- begreifen _ -- Mut Entschlossenheit sammelt -- schrecklich Nachricht Standhaftigkeit anhören -- 
  Gewißheit -- innig geliebt Gatte ermorden -- drohen Herz zerreißen -- verraten Gesicht schmerzhaft Empfindung -- 
  lächelen Verzweiflung -- Räuber Namens Empfindung Freude -- machen Übrig kund -- erwachten -- 
  Flucht Tod einzig Gedanke -- Seele denken fassen -- 
  beide Gefallen ausüben -- müssen Freiheit Genüssen -- Genüsse -- wenden -- Räuber überzeugen -- gerne Mitte zögen -- willig bestimmt Schicksal fügen -- 
  List gelingen -- bewachen sorgfältig -- achteen verwahren -- rings lagerten ruhig schlafen -- 
  Zug stets einöder Wald -- langsam -- Roß schwer Beute beladen -- 
  entfliehen -- wagen Flucht -- Hungertod ahnden -- deinetwillen fürchten -- 
  weit Reise lagert Tal Forst -- staunt -- Träne wehmütig Freude verbergen -- Felsen Kapelle erblicken -- beten -- 
  Herz schlagen ängstlich hoffend -- Auge Wartturm väterlich Fest gewahren -- 
  verstelln -- suchen Lager -- ruhen -- Räuber tranken -- 
  hören deutlich -- wundert -- Gegend erkennen -- frohlocken Ingeheim -- treuherzig versicherten -- willig arme Hauptmann ruhen -- gerne Höhle wohnen -- 
  gewiß Hoffnung -- Höhle einzutreffen -- Weiber umarmen -- ungewöhnlich heit -- tranken ruhen fest -- Flucht wagen glücklich vollenden -- 
  folgen Lehre mancherlei Auftrag -- Mutter an Herz Tochter legen -- 
  -- sprechen -- Otto Fahrwangen hienied wallen -- einst finden -- verkündig voll Verzeihung -- 
  einst grenzenlos unglücklich -- verdanken _ -- unbeschreiblich glücklich arm Gatte leben -- hadern -- Anklägerin Gott -- 
  Rückerinnerung unglücklichen -- unschuldig Sohn -- gebar -- qualten mütterlich Herz -- 
  erforschen -- 
  -- leben -- 
  Pflicht -- Nachforsche fortsetzen -- reichlich unterstützen -- Mutter teilen -- arm -- Bruder lieben -- reich wohlhabend findest -- 
  Kaiser nahen -- entdecken -- Leidend -- ermordet Liebling einst glücklich -- zittert -- Schritt wagen -- Notwendigkeit -- Zweifel wider edel Geburt erregen -- 
  Vollbringen Vorhaben -- Mutter sterben -- ehe _ vollbracht -- nahe künftig Gatte Throne -- beweisen -- rechtmässig Enkelin seisen -- _ dein Kind wahrscheinlich Wohltat lohnen -- -- 
  sitzen Unglücklichen stumm trauernd -- Mönch Vorlesung enden -- 
  hoffen Stoff Überlegung Fülle -- 
  Hugo suchen emsig Rettung schrecklich Abgrunde -- stürzen finden -- 
  Klette voll Licht Ursache -- Mutter Hugos Anblick erschrak -- Anwerbung zurückbeben -- Erhörung wünsche schrecklichsen Fluche verbieten -- 
  Rückerinnerung vorig leiden -- allzu heftig Gemütsbewegung verhindern wahrscheinlich schnell Entdeckung -- 
  Kraft sammeln -- bescheiden wiedergefunden Sohn -- neu Schrecken Leben enden -- 
  Klette bereute innig -- Mutter Fluch achten -- 
  Erfüllung schrecklich Gebot -- rufen laut -- äußerst unglücklich -- namlos elend -- 
  Mönch -- Herz väterlich Gefühl füllen -- wünschen helfen retten -- 
  gewiß voraus -- Trennung wiedergefunden Sohn rauben töten -- suchen Leben wahrscheinlichen -- möglich Trost frisn -- 
  Komm -- Schmerzenssohn -- sprechen -- kommen -- Folge -- Füße heiligsen Vater Avignon führen -- vergeben -- eur ferner Ehe -- Umstand erwägen -- bestätigen billigen -- 
  Gewalt -- lösen binden -- hören -- deinen Jammer sehen -- Verbrechen lösen -- eurer Ehe ruhen -- vorsätzlich übten -- gerne vernichten wollten -- _ eurer stehen -- 
  Hugo ergriff Vorschlag heftig Begierde -- hoffen glücklich Erfolg -- trösten Klette voraus -- Verzweiflung Herz Unglücklichen vergiften -- Trost wirken -- widerraten Reise -- Trennung unvermeidlich -- verzweifelt glücklich Erfolg -- 
  Hugo Vater reisefertig Lager treten -- glänzt Tran Auge -- starren angstvoll -- Seele finden Wort -- Schmerz ausdrücken -- Herz preßen -- 
  gelobt Gatten Bruder Mine -- Hand legen -- Gott Barmherzigkeit verzweifeln -- Rückkehr Geduld abwarten wollen -- 
  verlassen halb Mond Gemach -- sprechen äußerst -- beten anhaltend -- 
  finden händeringend weinend -- 
  Mutter Fluch drücken schwer -- antworten -- treu Wärterin Ursache Träne forschen -- 
  einst äußern heftig verlangen -- Kapelle beten -- Mutter rauben -- 
  Vogt -- streng Obhut bieten -- begleiten Riesig -- beten -- ruhig heit dannen -- 
  folgend Nacht entstehen schrecklich Gewittersturm -- heftig Erdbeben begleiten -- droht Fest einzustürzen -- Wasserflut -- Strömen Himmel herab wälzen -- lebend Geschöpf ersäufen -- 
  Mutvollst beben -- meister Klette -- Blitz werfen Lager -- 
  Gott Gericht schrecklich -- rufen -- Wirkung mütterlich Fluch verheerend -- Mühe vergebens -- wegbeen -- 
  verlangt Kapelle -- erfüllen Gebot -- leiten Umweg -- Erdbeben Wasserströme gewöhnlich Pfad vernichten -- 
  Zug anlangen -- -- Erdbeben Kapelle beweisen -- stehen Felsenspitze -- Schatten senkrecht Höhe herab tief Tal werfen -- Seite gemächlich bestiegen -- Felsen breit Rücken langsam erheben -- 
  Erdbeben Grundfeste Kapelle erschüttern -- wütend Sturm Tal hinab schleudern -- 
  Felsenspitze -- wahrscheinlich einst durchgehauen -- teilen gleich Teil -- bildet Höhlung -- gereizt Einbildungskraft absichtlich gemacht Lager halten -- 
  Klette starren Öffnung -- springen rasch hinzu -- legen darein -- 
  Mutter Fluch -- schreien wild Gelächter -- erfüllen -- 
  Brautbette Stein verwandeln -- Schwefelflammen empor lodern -- 
  Betet -- beten -- glücklich -- 
  Wort Trostes finden Eingang Herzen -- Vorstellung vermögen -- Ort verlassen -- 
  müssen Gewalt brauchen -- reizt echt Raserei Wahnsinn -- enden -- versprechen -- Brautbett führen -- 
  sprechen -- Idee Gedanke beschäftigen einzig -- müssen leiten -- tödlich Raserei Herzen erregen -- 
  vergessen Hugos -- gedachen -- scheinen Begebenheite Leben vergessen -- 
  Monden kehren Hugo Vater -- 
  Freude Wonne glänzt Gesicht -- Papst Fleh erhören -- ferneren Ehe Stiefschwester gestatten -- Kirche bauen -- Kind Herr widme -- 
  Freude Wonne wandeln Leid Jammer -- überzeugen -- Klette kennen -- Raub Wahnsinn -- 
  hoffen vergebens Gegenwart -- Versicherung Glück heilen -- scheinen Trostgründe hören -- bewegen -- Hand Willkommen reichen -- 
  eilen -- ehe zuvor -- Brautbett -- dünken glücklich -- Stunde ruhen -- 
  Hugo Begleiter -- einst folgen -- Trauernd -- arm Wahnsinnig -- voll Vergnügen steinern Brautbett springen -- voll Angst Ausbruch Schwefelflamme erwarten -- 
  nahen tröstend -- scheinen diesmal Wort hören -- blicken lächelnd -- 
  Ausbruch Freude rufen -- 
  Hugo -- 
  Bräutigam -- 
  O kommen -- lagere hierher -- 
  Brautbett bereit -- -- -- Wort aussprechen -- Erwartet Platz -- drängen Körper allzu vorwärts -- stürzt Öffnung Felsen tief Tal hinab -- 
  Körper liegen zerschmettern Boden -- schrecklich grausam enden -- 
  Hugo Nachfolger -- getreue abhalten -- folgen nachher Vater Kloster -- weiht Herr -- sterben freudig -- Lohn namlos Jammer erhalten -- 
  Wahrscheinlich sprechen vorher Kaiser -- entdecken -- Räuber -- einst Sohn mordeten -- Böhmen Forst nisteten -- durchzog nachh Gesellschaft Königs Johann Gegend -- finden Räuber -- lassen Feuer Höhle werfen -- verbrannt -- leben -- 
  sehen Höhle -- Wand schwarz färben -- hie ausgebrannt -- 
  Klette Stätte -- enden -- begraben -- gotisch Leichenstein bezeichnen Grab -- Spur vorhanden -- 
  Nahe entspringen Brunnen -- allgemein Fluchbrünnlein nennen -- Wasser trinken -- Aufsatz verursachen -- stark Schwefel schmecken -- 
  _ dämmern -- _ -- Versicherung alt Mütterche -- sicher wandeln -- häufig Irrwische Wanderer irre führen -- 