jung Jäger sitzen innerst Gebirge nachdenkend Vogelherde -- Rauschen Gewässer Wald Einsamkeit tönen -- 
  bedacht Schicksal -- jung -- Vater Mutter -- wohlbekannt Heimat -- Befreundet Dorf verlassen -- fremd Umgebung suchen -- Kreis wiederkehrend Gewöhnlichkeit entfernen -- blicken Art Verwunderung -- Tale -- Beschäftigung wiederfinden -- 
  Wolke ziehen Himmel verlieren Berg -- Vögel singen Gebüschen Widerschall antworten -- 
  steigen langsam Berg hinunt -- setzen Rand Bach nieder -- vorragend Gestein schäumend murmeln -- 
  hören wechselnd Melodie Wasser -- scheinen -- Wog unverständlich Wort tausend Ding sagen -- wichtig -- müssen Innig betrüben -- Rede verstehen -- 
  umh dünken -- froh glücklich -- fassen Mut singen lauter Stimme Jägergesang -- 
  -- froh lustig Stein Jüngling Jagd -- Beute erscheinen grünlebendig Hain -- Sucht Nacht -- 
  treu Hund bellen schön Einsamkeit -- Wald Hörner gellen -- Herz mutig schwellen -- 
  O schön Jägerzeit -- 
  Heimat Klüfte -- Baum grüßen -- Rauschen streng Herbsteslüfte Find Hirsch Reh -- Schlüft jauchzend durchziehn -- 
  Laß Landmann müh Schiffer Meer -- sehen Morgen Frühen Auroras Auge glühen -- Hängen Tau Grase schwer -- Jagd -- Wild -- Wald kennen Diana lachen -- einst schön Bild entbrennen -- Liebste nennen -- 
  O beglückter Jägersmann -- -- 
  gesang Sonne tief sinken breit Schatten fallen eng Tal -- 
  kühlend Dämmerung schlich Boden weg -- Wipfel Baum -- rund Bergspitze Schein Abends vergolden -- 
  Christian Gemüt trübselig -- Vogelherde zurückkehren -- dennoch bleiben -- Dünkt einsam sehnt Mensch -- 
  wünschen alt Buch -- Vater sehen -- niemals lesen -- sooft Vater antrieben -- fallen Szene Kindheit -- Spiel Jugend Dorfes -- Bekanntschaft Kind -- Schule -- drückend -- sehnt Umgebung -- freiwillig verlassen -- Glück unbekannt Gegende -- Berg -- fremd Mensch -- Beschäftigung finden -- 
  Finsterer -- Bach lauter rauschen -- Geflügel Nacht irr Wanderung umschweifend Flug beginnen -- sitzen mißvergnügt versinken -- wein -- Unentschlosse -- vornehmen sollen -- 
  Gedankenlos ziehen hervorragend Wurzel Erde -- plötzlich hören erschreckend dumpf winseln Boden -- unterirdisch klagend Tönen fortzog -- Ferne wehmütig verschollten -- 
  Ton durchdrang innerst Herz -- ergreifen -- unvermuten Wunde berühren -- sterbend Leichnam Natur Schmerz verscheiden wollen -- 
  springen entfliehen -- ehemals seltsam Alrunenwurzel gehören -- Ausreißen herzdurchschneidend Klagetöne geben -- Mensch Gewinsel wahnsinnig müssen -- 
  Fortgehe -- stehen fremd Mann -- freundlich ansehen fragen -- wohin wollen -- 
  Christian Gesellschaft wünschen -- erschrak neu freundlich Gegenwart -- 
  -- wohin eilig -- -- fragt Fremde -- 
  jung Jäger suchen sammeln erzählen -- plötzlich Einsamkeit schrecklich vorkommen -- retten -- Abend dunkel -- grün Schatten Wald traurig -- Bach sprechen laut Klage -- Wolke Himmel ziehen Sehnsucht jenseits Berg hinüber -- 
  -- jung -- -- Fremd -- -- streng Einsamkeit ertragen -- begleiten -- finden Haus Dorf Umkreis Meile -- unterwegs sprechen erzählen -- verlieren trüb Gedanke -- Stunde Mond Berg hervor -- Licht Eure Seele Licht -- -- 
  gehen fort -- Fremde dünkt Jünglinge alt Bekannt -- 
  -- Gebürge kommen -- -- fragen -- -- -- Eurer Sprache -- einheimisch -- -- 
  -- -- -- -- Jüngling -- -- lassen sagen -- Rede -- Erzählung wert -- fremd Gewalt Kreis Eltern verwandte hinweggenommen -- Geist mächtig -- Vogel -- Netz gefangen vergeblich sträuben -- verstricken Seele seltsam Vorstellung wünschen -- 
  wohnt Ebene -- umh Berg -- Anhöhe erblicken -- Baum schmückt grün Plan -- Wiese -- fruchtbar Kornfelder Garten ziehen -- Auge reichen -- Fluß glänzt mächtig Geist Wies Feld vorbei -- 
  Vater Gärtner Schloß -- ebenfalls Beschäftigung erziehen -- liebt Pflanze Blume tagelang unermüden Wartung Pflege abgeben -- 
  -- behaupten -- können fast sprechen -- lern Wachstum Gedeihen -- verschieden Gestalt Farbe Blatt -- 
  Gartenarbeit zuwider -- -- Vater zureden -- Drohung zwingen versuchen -- 
  Fischer -- Versuch -- Leben Wasser stehen -- Handelsmann Stadt geben -- väterlich Haus -- 
  hören Vater Gebirge erzählen -- Jugend bereiset -- unterirdisch Bergwerk Arbeiter -- Jäger Beschäftigung -- plötzlich erwacht bestimmte Trieb -- Gefühl -- bestimmt Lebensweise finden -- 
  Nacht Sann stellen hoch Berg -- Klüfte Tannenwäld -- Einbildung erschuf ungeheuer Fels -- hört Gedanke Getöse Jagd -- Hörner -- Geschrei hund Wilde -- Traum angefüllt weder Rast Ruhe -- 
  Ebene -- Schloß -- beschränkt Garten Vater geordnet Blumenbeet -- eng Wohnung -- weit Himmel -- ringsum traurig ausdehnt -- Höhe -- erhaben Berg umarmen -- Betrübter verhaßt -- 
  scheinen -- Mensch bejammernswürdigst Unwissenheit leben -- denken empfinden -- -- Gefühl Elend einzig Mal Seele aufgingen -- 
  treiben -- Entschluß fassen -- Haus Eltern verlassen -- 
  Buch Nachricht nächster Gebirg finden -- Abbildung Gegenden -- richten Weg -- 
  Frühlinge fühlen froh -- 
  eilt -- Ebene verlassen -- abend Ferne dunkel Umriß Gebirges liegen -- 
  Herberge schlafen -- ungeduldig -- Gegend betreten -- Heimat ansehen -- frühest munt Reise -- 
  Nachmittag befinden vielgeliebt Berg -- Trunkener -- stehen Weile -- schaun rückwärts -- berauscht fremd wohlbekannt Gegenstand -- 
  verlieren Ebene Gesichte -- Waldströme rauschen entgegen -- Buche Eiche braust bewegt Laube steil Abhänge herunter -- Weg führen schwindlig Abgründe vorüber -- blau Berg stehen ehrwürdig Hintergrunde -- 
  Welt aufgeschlossen -- müde -- 
  -- Gebürg durchstreifen -- alt Förster -- inständig Bitte -- Kunst Jägerei unterrichten -- 
  Monat Dienst -- 
  Gegend -- Aufenthalt -- Königreiche Besitz -- lernt Klippe -- Schluft Gebürg kennen -- Beschäftigung -- früh Walde ziehen -- Baum Forst fällten -- Auge Büchse üben -- treu Gefährt -- Hund Geschicklichkeiten abrichten -- überaus glücklich -- 
  sitz Vogelherde -- einsam Gebürge -- Abend traurig Sinn -- niemals Leben -- verlieren -- unglückselig -- trüb Stimmung erholen -- -- 
  fremd Mann aufmerksam zugehören -- dunkel Gang Wald wandern -- 
  treten freie -- Licht Mond -- Horn Bergspitze stehen -- begrüßen freundlich -- unkenntlich Form gesondert Masse -- bleich Schimmer rätselhaft vereinigen -- liegen gespalten Gebürge -- Hintergrunde steil Berg -- uralt verwittert Ruine schauerlich weiß Licht zeigen -- 
  -- Weg trennen -- -- Fremde -- -- geh Tiefe hinunt -- alt Schacht Wohnung -- Erz Nachbar -- Berggewässer erzählen Wunderdinge Nacht -- folgen -- 
  sehen Runenberg schroffen Mauerwerk -- schön anlockend alt Gestein herblicken -- 
  niemals dorten -- -- 
  -- niemals -- -- jung Christian -- -- hört alt Förster wundersam Ding Berg erzählen -- töricht vergessen -- erinneren -- Abend grauenhaft zumute -- 
  Höhe besteigen -- Licht schönsen -- Gras dorten grün -- Welt umh seltsam -- treffen -- mancher Wunder alt fände -- -- 
  -- fast fehlen -- -- -- -- suchen verstehen -- Herz innerlich hingezogen -- finden uralt Freund Herrlichkeit -- -- eifrigsen wünschen -- -- 
  -- Wort steigen Fremde schnell hinunt -- Gefährten Lebewohl sagen -- Dickicht Gebüsches verschwinden -- nachher verhallt Tritt Fuß -- 
  jung Jäger verwundern -- verdoppeln Schritt Runenberge -- winken dorthin -- Stern scheinen dorthin leucht -- Mond weisen hell Straße Trümmer -- licht Wolke ziehen hinauf -- Tiefe redet Gewässer rauschend Wald sprechen Mut -- 
  Schritt beflügeln -- Herz klopfen -- fühlen Freudigkeit Inneren -- Angst emporwuchs -- -- 
  Gegende -- -- Fels steil -- Grün verlieren -- kahl Wand rufen zürnend Stimme -- einsam klagend Wind jagen -- 
  eilt Stillstand fort -- spät Mitternacht schmal Fußsteig -- hart abgrunde Hinlief -- 
  achtet Tiefe -- gähnt verschlingen drohen -- spornen irr Vorstellung unverständlich Wunsch -- 
  ziehen gefährlich Weg hoch Mauer -- Wolke verlieren scheinen -- steig Schritt schmal -- Jüngling müssen vorragend Stein festhalten -- hinunterzustürz -- 
  -- Pfad endigt Fenster -- müssen stillstehen wissen -- umkehren -- bleiben sollen -- 
  plötzlich Licht -- alt Gemäuer bewegen scheinen -- 
  Schein -- entdeckt -- alt geräumig Saal blicken -- wunderlich verzieren mancherlei Gestein Kristall vielfältig Schimmer funkelen -- geheimnisvoll wandelnd Licht durcheinanderbewegn -- weiblich Gestalt tragen -- sinnend Gemache nieder -- 
  scheinen Sterbliche anzugehören -- -- mächtig Glied -- streng Gesicht -- dünken entzückt Jüngling -- niemals Schönheit sehen ahnen -- 
  zittert wünschen heimlich -- Fenster treten wahrnehmen -- 
  stehen still -- setzen Licht kristallen Tisch nieder -- schaut Höhe singen durchdringlich Stimme -- 
  -- alte weilen -- erscheinen -- 
  Kristall weinen -- demanten Säule Fließen Tränenquell -- Ton klingen drein -- klar hell Schön durchsichtig Welle Bilden Schein -- Seele ziehetn -- Herz Erglühet -- 
  Geist golden Halle -- Hebt tief Dunklen Häupt -- funkeln -- 
  Herz Geist -- durstig Sehn -- leuchtend schön Träne Allgewaltig Meister -- -- 
  endigen -- fing entkleid -- Gewänder kostbaren Wandschrank legen -- 
  golden Schleier Haupt -- lang schwarz Haar fließen geringelt Fülle Hüfte hinab -- lösen Gewand Busen -- Jüngling vergessen Welt Anschauen überirdisch Schönheit -- 
  wagen atmen -- hüllen lösen -- nackt Schritt saale nieder -- schwer schwebend Locke bilden dunkel wogend Meer -- Marmor glänzend Form rein Leib abwechselnd hervorstrahlten -- 
  geraum nähert golden Schranke -- Tafel heraus -- eingelegt Stein -- Rubinen -- Diamanten Juwele glänzen -- betrachten prüfend -- 
  Tafel scheinen wunderlich unverständlich Figur unterschiedlich Farbe Linie bilden -- zuweilen -- Schimmer entgegenspiegeln -- Jüngling schmerzhaft blenden -- besänftigen grün blau spielend Schein Auge -- 
  stehen -- Gegenstand Blick verschlingend -- tief versinken -- 
  Inneren Abgrund Gestalt Wohllaut -- Sehnsucht Wollust auftun -- Schar beflügelt Tön wehmütig freudig Melodie ziehen Gemüt -- Grund bewegen -- Welt Schmerz Hoffnung aufgehen -- mächtig Wunderfelse vertrauen trotzend Zuversicht -- Wasserströme -- voll Wehmut fließend -- 
  kennen -- erschrak -- schön Fenster öffnen -- magisch steinern Tafel reichen weniger Wort sprechen -- 
  -- Nimm Angedenken -- -- 
  fassen Tafel fühlt Figur -- unsichtbar sogleich Innere überging -- Licht mächtig Schönheit seltsam Saal verschwinden -- 
  dunkel Nacht Wolkenvorhänge fallen Innere hinein -- suchen vorig Gefühl -- Begeisterung unbegreiflich Liebe -- beschaut kostbar Tafel -- untersinkend Mond schwach bläulich spiegeln -- 
  halten Tafel fest Hand gepreßen -- graut erschöpfen -- schwindelnd halb schlafend steil Höhe hinunterstürzen -- 
  -- Sonne scheinen betäubter Schläfer Gesicht -- erwachend anmutig Hügel wiederfinden -- 
  umh -- erblicken kennbar äußerer Horizont Trümmer Runenberg -- 
  suchen Tafel -- finden nirgends -- 
  erstaunt verwirrt sammeln Erinnerung anknüpfen -- Gedächtni wüst Nebel anfüllen -- formlos Gestalt wild unkenntlich durcheinanderbewegten -- 
  vorig Leben liegen tief Ferne -- seltsamst Gewöhnlich ineinander vermischen -- unmöglich -- 
  lang Streite glauben -- Traum plötzlich Wahnsinn Nacht befallen -- begreifen -- fremd entlegen Gegend verirren -- 
  fast Schlaftrunk steigen Hügel hinab -- geraten gebahnt Weg -- Gebirge hinunt flach Land führen -- 
  fremd -- glauben anfangs -- Heimat gelangen -- verschieden Gegend -- vermuten -- jenseits südlich Grenze Gebirges befinden müssen -- Frühling Norden betreten -- 
  Mittag stehen Dorfe -- Hütte friedlich Rauch Höhe steigen -- Kind spielen grün Platz festtäglich putzen -- Kirche erscholl Orgelklang Singen Gemeine -- 
  Ergriff unbeschreiblich süß Wehmut -- rühren herzlich -- weinen müssen -- 
  eng Garten -- Hütte rauchend Schornstein -- abgeteilt Kornfelder erinnert Bedürftigkeit arm Menschengeschlecht -- Abhängigkeit freundlich Erdbod -- Milde vertrauen -- erfüllen Gesang Ton Orgel Herz gefühlt Frömmigkeit -- 
  Empfindung Wünsche Nacht erscheinen ruchlos frevelhaft -- kindlich -- bedürftig demütig Mensch Brüder schließen -- gottlos Gefühl Vorsätz entfernen -- 
  reizend anlockend dünkt Ebene Fluß -- mannigfaltig Krümmung Wiese Garten schmiegen -- Furcht gedacht Aufenthalt einsam Gebirg wüst Stein -- sehnt -- friedlich Dorfe wohnen -- treten Empfindung menschenerfüllt Kirche -- 
  Gesang beendigen Priester Predigt beginnen -- Wohltat Gott Ernte -- Güte speisen sättiget leben -- wunderbar Getreide Erhaltung Menschengeschlechtes sorgen -- Liebe Gott unaufhörlich Brot mitteilen andächtig Christ unvergänglich Abendmahl rühren feiern können -- 
  Gemein erbauen -- Jäger Blick ruht fromm Redner -- bemerken dicht Kanzel jung Mädchen -- Andacht Aufmerksamkeit hingegeben scheinen -- 
  Schlank blond -- blau Auge glänzen durchdringendst Sanftheit -- Antlitz durchsichtig zartest Farbe blühend -- 
  fremd Jüngling Herz niemals empfinden -- voll Liebe beruhigen -- stillst erquickendst Gefühl hingegeben -- 
  beugen weinend -- Priester Segen sprechen -- fühlen heilig Wort unsichtbaren Gewalt durchdrungen -- Schattenbild Nacht tief Entfernung Gespenst hinabgerücken -- 
  verlassen Kirche -- verweilen Linde -- danken Gott inbrünstig Gebet -- Verdienst Netz bös Geist befreien -- 
  Dorf feiern Erntefest Mensch fröhlich stimmen -- geputzt Kind freut Tänze Kuchen -- jung Bursch richten Platz Dorfe -- jung Baum umgeben -- herbstlich Festlichkeit -- Musikante sitzen probiert Instrument -- 
  Christian Feld hinaus -- Gemüt sammeln Betrachtung nachzuhängen -- Dorf -- Fröhlichkeit Begehung Fest vereiniget -- 
  blond Elisabeth Eltern zugegen -- Fremde mischt froh Haufe -- 
  Elisabeth tanzen -- unterd Vater Gespräch angesponnen -- Pachter reichsen Leute Dorfe -- 
  scheinen Jugend Gespräch fremd Gast fallen -- kurz einig -- Christian Gärtner einziehen sollen -- 
  Unternehmen -- hoffen -- Kenntnis Beschäftigung zustatt -- Heimat verachten -- 
  beginnen neu Leben -- 
  ziehen Pachter Familie rechnen -- stand verändert Tracht -- 
  -- dienstfertig freundlich -- stehen Arbeit fleißig -- Haus -- vorzüglich Tochter -- gewogen -- 
  Sooft Sonntage Kirche -- halten schön Blumenstrauß Bereitschaft -- errötend Freundlichkeit danken -- vermissen -- -- erzählt Abend märchen lustig Geschichte -- 
  notwendig -- alte -- bemerken -- scheinen -- Christian fleißigst schön Bursche Dorfe -- Augenblick Zug Liebe Freundschaft fühlen -- 
  halb Elisabeth Gattin -- 
  Frühling -- Schwalben Vögel Gesanges kommen Land -- Garten stehen schön Schmuck -- Hochzeit Fröhlichkeit feiern -- Braut Bräutigam scheinen trunken Glück -- 
  Abend spät -- Kammer gehen -- jung Gatt geliebter -- 
  -- -- Bild -- einst Traum entzücken niemals vergessen -- glücklich Nähe selig dein arme -- -- 
  vergnügen Familie -- Tochter vermehren -- Leonora nennen -- 
  Christian zuweilen ernst -- Kind betrachten -- jugendlich Heiterkeit -- 
  gedacht vorig Lebensweise -- fühlen einheimisch befriedigen -- 
  Monat fallen Eltern Gedanke -- Vater ruhig Glück -- Stand Gärtner Landmann freuen -- ängstigen -- Vater Mutter lang vergessen -- Kind erinnern -- Freude Kind Eltern -- beschließen -- Reise Heimat besuchen -- 
  Unger verlassen Gattin -- wünscht Glück -- schön Jahreszeit Fuß Weg -- 
  fühlen weniger Stunde -- Scheiden peinig -- erstenmal empfand Leben Schmerz Trennung -- fremd Gegenstand erscheinen fast wild -- -- feindselig Einsamkeit verlieren -- 
  Gedanke -- Jugend vorüber -- Heimat finden -- angehör -- Herz Wurzel schlagen -- fast verloren Leichtsinn vorigen beklagen -- äußerst trühselig zumute -- Nacht Dorfe Wirtshause einkehren müssen -- 
  begreifen -- freundlich Gattin erworben Eltern entfernt -- verdrießlich murrend Weg -- Reise fortsetzen -- 
  Angst -- Gebirg nähern -- fern Ruine sichtbar treten kenntlich hervor -- Bergspitze heben abrinden blau Nebel -- 
  Schritt zaghaft -- bleiben stehen verwundert Furcht -- Schauer -- Schritt gedrängt nahe kommen -- 
  -- kenn Wahnsinn -- -- rufen -- -- gefährlich Locken -- männlich widerstehn -- 
  Elisabeth schnöd Traum -- wissen -- denken -- warten liebevoll Stunde Abwesenheit zählen -- 
  Sehen Wald schwarz Haar -- 
  schauen Bach blitzend Auge -- 
  schreiten Glied Berg -- -- 
  -- Wort auszuruh Baum niederwerfen -- Schatten alt Mann sitzen -- groß Aufmerksamkeit Blume betrachten -- Sonne halten -- Hand beschatten -- Blatt zählen -- bemühen -- Gedächtnisse genau einprägen -- 
  nah -- erscheinen Gestalt -- bleiben Zweifel übrig -- alt Blume Vater -- 
  stürzt Ausdruck heftigsen Freude Arm -- vergnügen -- überraschen -- plötzlich wiederzusehen -- 
  -- Kommst entgegen -- Sohn -- -- alt -- -- wissen -- finden -- glauben -- heutig Freude widerfahren -- -- 
  -- -- woher wußten -- Vater -- antreffen würden -- -- 
  -- -- Blume -- -- sprechen alt Gärtner -- -- leben -- wünschen -- sehen -- niemals -- selten -- Gebirge wachsen -- 
  suchen -- Mutter sterben Haus Einsamkeit drückend trübselig -- 
  wissen -- wohin Weg richten -- wanderen Gebirge -- traurig Reise vorkommen -- suchen beih Blume -- nirgends entdecken -- finden unvermuten -- schön Ebene ausstrecken -- wissen -- finden müssen -- Sieh -- lieb Blume weissagen -- -- 
  umarmt -- Christian beweinte Mutter -- alte fassen Hand -- -- Laß -- Schatten Gebirge Auge verlieren -- weh um Herz steil wild Gestalt -- gräßlich Geklüft -- schluchzend Wasserbäche -- Laß -- fromm -- eben Land besuchen -- -- 
  wandern -- Christian froh -- 
  erzählt Vater Glücke -- Kind Heimat -- Gespräch trunken -- fühlt Rede -- Zufriedenheit ermangle -- 
  kommen Erzählung -- traurig fröhlichen -- Dorfe -- 
  früh Beendigung Reise vergnügen -- meister Elisabeth -- 
  alt Vater ziehen -- Vermögen Wirtschaft -- bilden zufriedenst einträchtigst Kreis Mensch -- 
  Acker gedieh -- Viehstand mehren -- Christian Haus weniger eins ansehnlichst Ort -- Vater mehrere Kind -- 
  Weise verflossen -- Fremder Reise Dorfe einkehren -- Christian Haus -- ansehnlichst Wohnung -- Aufenthalt -- 
  freundlich -- gesprächig Mann -- vieler Reise erzählen -- Kind spielt Geschenk -- kurz gewogen -- 
  gefallen Gegend -- aufhalten -- Woche -- Monat -- 
  wundert Verzögerung -- gewöhnen -- Familie zählen -- 
  Christian sitzen nachdenklich -- -- kenn reisend ehemals -- Gelegenheit erinnern -- sehen -- 
  Monat Fremde Abschied -- -- lieb Freund -- wunderbar Schicksal seltsam Erwartung treiben nächster Gebirg hinein -- zaubervoll Bild -- widersteh -- locken -- verlasse -- wissen -- zurückkommen -- Summe Geld -- euren Hand sicher Meinig -- bitte -- verwahren -- komm Jahresfrist -- behalten -- nehmen eur bewiesen Freundschaft -- -- 
  reisen Fremde -- Christian Geld Verwahrung -- 
  verschließen sorgfältig übertrieben Ängstlichkeit zuweilen -- zählen -- fehlen -- -- 
  -- Summe glücklich -- -- Vater -- -- Fremd zurückkommen -- Kind sorgen -- -- 
  -- Laß Gold -- -- alt -- -- liegen Glück -- gottlob mangeln -- entschlag Gedanke -- -- 
  stehen Christian Nacht -- Knecht Arbeit wecken sehen -- Vater besorgt -- übertrieben Fleiß Jugend Gesundheit schaden -- Nacht -- ermahn -- übertrieben Tätigkeit einschränken -- erstaun Lampe Tisch sitzend finden -- groß Emsigkeit Goldstücke zählen -- 
  -- Sohn -- -- alt Schmerz -- -- -- verfluchen Metall unser Unglück Dach bringen -- 
  Besinn -- -- böse Feind Blut Leben verzehren -- -- 
  -- -- -- -- Christian -- -- verstehen selber -- weder Nacht lassen Ruhe -- sehen -- anblicken -- rot Glanz tief Herz hineingehen -- 
  Horcht -- klingen -- gülden Blut -- 
  rufen -- Schlafe -- hören -- Musik tönen -- Wind blasen -- Leute Gas sprechen -- scheinen Sonne -- sehen gelb Auge -- zublinzeln -- heimlich Liebeswort Ohr sagen -- nächtlicherweise aufmachen -- Liebesdrang nugzutun -- fühlen innerlich jauchzen Frohlock -- Finger berühren -- Freude Röter herrlich -- schauen Glut Entzückung -- -- 
  -- Greis schaudernd weinend Sohn arme -- beten sprechen -- 
  -- Christel -- mußt Wort Gott wenden -- mußt fleißig andächtig Kirche -- verschmachten traurigsen Elende verzehren -- -- 
  Geld weggeschlossen -- Christian versprechen ändern -- alte beruhigen -- 
  vergehen -- Fremden Erfahrung bringen -- alt Bitte Sohn -- zurückgelassen Geld Länderei Weise anlegen -- 
  dorf Reichtum jung Pachter sprechen -- Christian scheinen außerordentlich zufrieden vergnügen -- Vater glücklich pries -- heit sehen -- Furcht Seele verschwinden -- 
  müssen erstaunen -- Abend Elisabeth beiseite Träne erzählen -- Mann verstehen -- sprech Irre -- vorzüglich nachts -- träume schwer -- gehen Schlafe Stube herum -- wissen -- erzählen wunderbar Ding -- schaudern müssen -- 
  schrecklichst Lustigkeit -- lachen wild frech -- Blick Irre fremd -- 
  Vater erschrak betrübt Gattin fahren fort -- 
  -- sprechen fremde -- behaupten -- -- fremd Mann eigentlich wunderschön Weib -- Feld hinausgehen Garten arbeiten -- -- hören unterirdisch fürchterlich Ächz -- Wurzel ausziehen -- fahren scheinen Pflanze Kräuter Gespenst entsetzen -- -- -- Allgütiger Gott -- -- rufen Vater -- -- fürchterlich Hunger fest hineingewachsen -- -- 
  verzaubert Herz menschlich -- kalt Metall -- Blume lieben -- lieb Gottesfurcht verlieren -- -- 
  folgend Vater Sohne spazieren -- -- Elisabeth gehören -- ermahnt Frömmigkeit -- Geist heilig Betrachtung widmen sollen -- 
  Christian -- -- -- Vater -- -- gelingen -- -- -- wahr Gestalt Inneren vergessen -- gleichsam fremd Leben Leichtigkeit führen -- plötzlich neu Mond regierend Gestirn -- selber -- Herz -- besiegen fremd -- 
  froh -- -- seltsam Nacht -- Hand geheimnisvoll Zeichen tief Gemüt hineingepragen -- schläft ruhen magisch Figur -- vergehen -- quellen Gift plötzlich hervor -- wecken Linie -- 
  denken fühlen -- umh verwandeln -- vielmehr Gestaltung verschlungen -- 
  Wahnsinnige Anblick Wasser entsetzen -- empfangen Gift giftig -- geschehen eckig Figur -- Linie -- Strahl -- innewohnend Gestalt entbind Geburt befördern -- Geist Körper fühlen Angst -- Gemüt Gefühl außen empfangen -- quälend ringend äußern Gefühl hinausarbeiten -- ruhig -- -- 
  -- unglücklich Gestirn -- -- sprechen alt -- -- hinwegzog -- warst still Leben gebären -- Sinn neigt Ruhe Pflanze -- führen Ungeduld hinweg -- Gesellschaft verwildert Stein -- Fels -- zerrissen Klippe schroff Gestalt Gemüt zerrütten -- verwüstend Hunger Metall pflanzen -- 
  Hättest Anblick gebirg hüten bewahren -- denken erziehen -- -- 
  Demut -- Ruhe -- kindlich Sinn trotz -- Wildheit Übermut verschütten -- -- 
  -- -- -- Sohn -- -- erinneren deutlich -- Pflanze Unglück Erde -- verstehen Seufzer Klage -- allenthalben Natur vernehmbar -- hören -- Pflanze -- Kräuter -- Blume Baum regen bewegen schmerzhaft Wunde -- Leichnam vormalig herrlich Steinwel -- bieten unser Auge schrecklichst Verwesung dar -- 
  verstehen -- -- Wurzel tiefgeholt Ächz sagen -- vergessen schmerze verraten -- 
  grün Gewächs erzürnen -- stehen Leben -- geliebt Figur Herzen auslöschen -- Frühling verzerrten Leichenmiene Seele gewinnen -- 
  unerlaubt tückisch -- -- alt Mann -- hintergangen -- Seele gänzlich Besitz nehmen -- 
  Frage Stein -- erstaun -- reden hörst -- -- 
  Vater -- antworten -- 
  gehen schweigend Haus -- alte müssen ebenfalls Lustigkeit Sohn entsetzen -- dünken fremdartig -- anderer Wesen -- Maschine -- unbeholfen ungeschickt herausspieler -- 
  -- Erntefest feiern -- Gemeine Kirche -- Elisabeth ziehen Kind -- Gottesdienste beizuwohnen -- Mann Anstalt -- begleiten -- Kirchentür kehren -- tiefsinnend Dorf hinaus -- 
  -- setzt Anhöhe -- rauchend Dach -- hören Gesang Orgelton Kirche -- geputzt Kind tanzn spielt grün Rasen -- 
  -- Leben Traume verlieren -- -- -- -- Verfloss -- hinunterstieg -- Kind hinein -- spielen -- ernsthaft Kirche -- treten Gebäude -- Elisabeth blühend kindlich Mädchen -- Jugend vorüber -- Sehnsucht Blick Auge aufsuchen -- mutwillig hoch ewig Glück lassen -- vergänglich zeitlicher gewinnen -- -- 
  sehnsuchtsvoll benachbart Walde -- vertieft dichtesn Schatten -- 
  schauerlich Stille umgeben -- Luft rührt Blätter -- 
  Mann fern zukommen -- fremde erkennen -- erschrak -- Gedanke -- Geld zurückfordern -- 
  Gestalt nah -- -- geirren -- Umriß -- wahrnehmen wähnen -- zerbrachen selber -- alt Weib äußerer Häßlichkeit -- schmutzig Lump kleiden -- zerrissen Tuch halten greis Haar -- hinkt Krücke -- 
  fürchterlich Stimme reden Christian -- fragt Name Stande -- antworten umständlich -- 
  -- -- -- 
  -- nennen Waldweib -- -- -- -- jeder Kind wissen erzählen -- niemals -- -- 
  letzter Wort wenden -- Christian glaubt Bäume golden Schleier -- hoch Gang -- mächtig Bau Glied wiederzuerkennen -- 
  nacheilen -- Auge finden -- 
  ziehen Glänzende Blick grün Gras nieder -- 
  heben magisch Tafel farbig Edelgestein -- seltsam Figur -- verlieren -- 
  Gestalt bunt Licht drücken plötzlichst Gewalt Sinn -- 
  fassen fest -- überzeugen -- Hand halten -- eilt Dorfe -- 
  Vater begegnen -- 
  -- Seht -- -- rufen -- -- -- wovon erzählen -- Traum sehen glauben -- gewiß wahrhaftig -- -- 
  alte betrachtet Tafel -- 
  -- Sohn -- schaudern Herzen -- Lineament Stein betrachten ahnend Sinn Wortfügung erraen -- Sieh -- kalt funkeln -- grausam Blick geben -- blutdürstig -- rot Auge Tiger -- 
  Wirf Schrift weg -- kalt grausam -- Herz versteinern -- 
  Sieh zart Blüte keimen -- erwach -- Kind Träum entgegen lieblich lachen -- 
  Farbe Spiel Zugekehrt golden Sonne -- heiß Kuß fühlen -- hoch Wonn -- 
  Küsse verschmachten -- vergehen Liebe Wehmut -- stehen -- lachen -- verwelken still Demut -- 
  hoch Freude -- Geliebte verzehren -- Tod verklären -- vergehen süß Leid -- 
  ergießen Düfte -- Geist -- Entzück berausch Lüfte balsamisch Erquick -- 
  lieb Menschenherz -- Regt golden Saitenspiel -- Seele sprechen -- 
  fühlen Schönste -- wonach zielen -- Wehmut -- Sehnsucht lieb Schmerz -- -- 
  -- Wunderbare -- unermeßlich Schatz -- -- antworten Sohn -- -- Tiefen Erde geben -- 
  ergründ -- heben reißen -- 
  Erde geliebt Braut drücken vermöchter -- Angst Liebe Kostbarst gönnen -- 
  Waldweib rufen -- gehen suchen -- 
  nebenan alt verfallen Schacht -- Jahrhundert Bergmannen ausgegraben -- finden -- -- 
  eilt Fort -- 
  vergeblich streben alt -- zurückhalten -- Blick entschwinden -- 
  Stunde -- vieler Anstrengung gelangt Vater alt Schacht -- Fußstapfen sand Eingange eingedrücken -- kehren weinend -- Überzeugung -- Sohn Wahnsinn hineingegangen -- alt gesammelt Wass Untiefen versunken -- 
  unaufhörlich betrüben Träne -- 
  Dorf trauert jung Pachter -- Elisabeth untröstlich -- Kind jammern laut -- 
  halb alt Vater sterben -- Elisabeth Eltern folgen -- müssen Wirtschaft verwalten -- 
  angehäuft Geschäft entfernt Kummer -- Erziehung Kind -- Bewirtschaftung lassen Sorge Gram übrig -- 
  entschließen Heirat -- Hand jung heiter Manne -- Jugend lieben -- 
  gewinnen Haus Gestalt -- 
  Vieh sterben -- Knecht Mägde untreu -- Scheuer Früchten Feuer verzehren -- Leute Stadt -- Summe stehen -- entwich Gelde -- 
  Wirt nötigen -- Äcker Wiese verkaufen -- Mißwach Teures bringen Verlegenheit -- 
  scheinen -- wunderbar erworben Geld schleunig Flucht suchen -- indessen mehren Kind -- Elisabeth sowohl Mann Verzweiflung unachtsam saumselig -- suchen zerstreuen -- trank häufig stark Wein -- verdrießlich jähzornig -- Elisabeth heißen Zähr elend beweinen -- 
  Glück weichen -- ziehen Freund Dorfe -- verlassen sehen -- Mühe Woche hinüberfristeen -- 
  Schaf Kuh übrigbleiben -- Elisabeth selber Kind hüten -- 
  sitzen einst Arbeit Anger -- Leonore Seite saugend Kind Brust -- fern herauf wunderbar Gestalt sehen -- 
  Mann zerrissen Rocke -- barfüßig -- Gesicht schwarzbraun Sonne verbrennen -- lang struppig Bart entstellen -- tragen Bedeckung Kopf -- grün Laube Kranz Haar geflocht -- wild Ansehn seltsam unbegreiflich -- 
  Rücken tragen festgeschnürten Sack schwer Ladung -- stützen jung Fichte -- 
  näh -- setzen Last nieder -- holen schwer Atem -- 
  bieten Frau gut -- Anblick entsetzen -- Mädchen schmiegt Mutter -- 
  geruhen -- -- 
  -- komm beschwerlich Wanderschaft rauhst Gebirge Erde -- kostbarst Schatz mitbringen -- Einbildung denken Herz wünschen -- 
  sehen -- erstaunt -- -- 
  öffnet hierauf Sack schütten -- voll Kiesel -- Stück Quarz -- nebst Stein liegen -- 
  -- -- -- fahren fort -- -- Juwele polieren schliffen -- fehlen Auge Blick -- äußerlich Feuer Glanze inwendig Herz begraben -- herausschlagen -- fürchten -- Verstellung nützen -- sehen -- wes Geist Kind -- -- 
  -- Wort hart Stein schlagen heftig -- rot Funke heraussprangen -- 
  -- Glanz sehen -- -- rufen -- -- Feuer Licht -- erhell Dunkel lachen -- freiwillig -- -- 
  -- packen hierauf sorgfältig Sack -- fest zusammenschnüren -- 
  -- kenn -- -- wehmütig -- -- Elisabeth -- -- 
  Frau erschrak -- 
  -- Name -- -- fragen ahnend Zittern -- 
  -- -- -- Gott -- -- unglückselige -- -- Christian -- einst Jäger -- kennen -- -- 
  wissen -- erschrecken tief Mitleide sagen -- 
  fallen Hals -- küßen -- 
  Elisabeth rufen -- -- O Gott -- Mann -- -- 
  -- ruhig -- -- -- -- sterben -- Walde warten schön -- Gewaltige -- -- golden Schleier schmücken -- 
  liebst Kind -- Leonore -- 
  Komm -- teuer -- lieb Herz -- gib Kuß -- einzig -- dein Mund Lippe fühlen -- verlassen -- -- 
  Leonore weinen -- schmiegt Mutter -- Schluchz Träne halb Wanderer lenken -- halb ziehen -- Arm -- drücken Brust -- -- 
  still fort -- Walde sehen entsetzlich Waldweibe sprechen -- 
  -- -- -- fragt Mann -- Mutter Tochter blaß Träne auflösen finden -- 
  Antwort geben -- 
  Unglückliche sehen -- 