Gegend Harz wohnt Ritter -- gewöhnlich blond Eckbert nennen -- 
  ohngefähr vierzig alt -- mittl Größe -- kurz hellblond Haar liegen schlicht dicht blass eingefallen Gesicht -- 
  leben ruhig niemals Fehd Nachbar verwickeln -- selten außerhalb Ringmauer Schlosses -- 
  Weib lieben Einsamkeit ebensosehr -- schiene Herz lieben -- klagen gewöhnlich -- Himmel Ehe Kind segnen wollen -- 
  selten Eckbert Gast besuchen -- geschehen -- ihretwegen fast gewöhnlich Gang Leben ändern -- Mäßigkeit wohnen -- Sparsamkeit scheinen anordnen -- 
  Eckbert alsdann heit aufräumen -- -- bemerken gewiß Verschlossenheit -- still zurückhaltend Melancholie -- 
  häufig Burg Philipp Walther -- Mann -- Eckbert anschließen -- ohngefähr Art denken finden -- meister zugetan -- 
  wohnen eigentlich Franken -- halten halb Nähe Eckbert Burg -- sammeln Kräuter Stein -- beschäftigen -- Ordnung bringen -- leben Vermögen abhängig -- 
  Eckbert begleiten einsam Spaziergänge -- entspann inniger Freundschaft -- 
  Stunde -- Mensch ängstigen -- Freund Geheimnis -- vieler Sorgfalt verbergen -- Seele fühlen unwiderstehlich Trieb -- mitteilen -- Freund Innerst aufzuschließen -- Freund -- 
  Augenblick geben zart Seele erkennen -- zuweilen geschehen -- Bekanntschaft zurückschrecken -- 
  Herbst -- Eckbert nebligen Abend Freund Weibe Bertha Feuer Kamin sitzen -- 
  Flamme werfen hell Schein Gemach spielen Decke -- Nacht schwarz Fenster herein -- Baum draußen schüttelen nasser Kälte -- 
  Walther klagen weit Rückweg -- -- Eckbert schlagen -- bleiben -- halb Nacht traulich Gespräch hinzubringen -- Gemache Haus schlafen -- 
  Walther Vorschlag -- Wein Abendmahlzeit hereingebrachen -- Feuer Holz vermehren -- Gespräch Freund heiter vertraulich -- 
  Abendessen abtragen -- Knecht entfernen -- Eckbert Hand Walther -- -- Freund -- sollten Frau Geschichte Jugend erzählen lassen -- seltsam -- -- 
  -- -- -- -- Walther -- setzen Kamin -- 
  Mitternacht -- Mond abwechselnd vorüberflatternd Wolke -- 
  -- müßt zudringlich halten -- -- fing Bertha -- -- Mann -- Edel denken -- Unrecht -- verhehlen -- 
  halten Erzählung Märchen -- sonderbar klingen -- 
  Dorfen gebären -- Vater arm Hirte -- 
  Haushaltung Eltern bestellen -- wissen -- Brot hernehmen -- 
  jammeren -- -- Vater Mutter Armut entzwein -- bitter Vorwurf -- 
  hören beständig -- einfältig dumm Kind -- unbedeutendste Geschäft ausrichten wissen -- äußerst ungeschickt unbeholfen -- lassen Hand fallen -- lernen weder näh spinnen -- Wirtschaft helfen -- Not Eltern verstehen -- 
  sitzen Winkel füllt Vorstellung -- helfen -- plötzlich reich -- Gold Silber überschüten erstaunen laben -- Geist heraufschweben -- unterirdisch Schatz entdecken -- Kiesel geben -- Edelsteine verwandeln -- -- wunderbar Phantasie beschäftigter -- aufstehen müssen -- helfen -- tragen -- zeigen Ungeschickter -- Kopf seltsam Vorstellung schwindelen -- 
  Vater ergrimmen -- unnützen Last Hauswesen -- behandeln ziemlich grausam -- selten -- freundlich Wort vernehmen -- 
  ungefähr alt -- ernstlich Anstalt -- -- lernen -- 
  Vater glauben -- Eigensinn Trägheit -- Müßiggang hinzubringen -- -- setzen Drohung unbeschreiblich -- fruchteen -- züchtigt grausamste Art -- -- Strafe wiederkehren -- unnütz Geschöpf -- 
  Nacht hindurch weinen herzlich -- fühlen außerordentlich verlassen -- Mitleid selber -- sterben wünschen -- 
  fürchten Anbruch Tage -- wissen -- anfangen -- wünschen möglich Geschicklichkeit begreifen -- einfältig -- übrig Kind Bekanntschaft -- 
  Verzweiflung nahe -- 
  graut -- stehen eröffnen -- fast wissen -- Tür Hütte -- 
  stehen frei Feld -- Walde -- hineinblicken -- 
  laufen Immerfort -- umzuseh -- fühlt Müdigkeit -- glauben -- Vater einholen -- -- Flucht reizen -- Grausamer behandeln -- 
  Walde heraustrat -- stehen Sonne ziemlich -- Dunkle liegen -- dicht Nebel bedecken -- 
  müssen Hügel klettern -- Fels gewunden Weg -- erraten -- benachbart Gebirg befinden müssen -- worüber anfing Einsamkeit fürchten -- 
  Ebene Berg sehen -- bloß Wort Gebirge -- reden hören -- kindisch Ohr fürchterlich Ton -- 
  Herz zurückzugehn -- Angst treiben vorwärts -- erschrocken -- Wind weg Baum fahren -- fern Holzschlag still hintönen -- 
  Köhler Bergleute begegneen fremd Aussprache hören -- entsetzen fast Ohnmacht sinken -- 
  mehrere Dorf bettelen -- Hunger Durst empfinden -- helfen ziemlich Antwort -- fragen -- 
  ohngefähr fortgewandert -- Fußsteig geraten -- Straße entfernen -- 
  Fels gewann -- seltsam Gestalt -- 
  Klippe -- aufeinandergepackt -- Ansehn -- Windstoß durcheinanderwerfen -- 
  wissen -- weitergehen -- 
  nachts Walde schlafen -- schönsen Jahrszeit -- abgelegen Schäferhütt -- treffen menschlich Wohnung -- vermuten -- Wildni stoßen -- Fels Furchtbarer -- müssen dicht schwindlig Abgründe vorbeigehen -- hören sogar Weg Fuß -- 
  trostlos -- weinen schreien -- Felsentäler hallt Stimme schrecklich Art -- 
  brechen Nacht herein -- suchen Moosstell -- Ruhn -- 
  schlafen -- Nacht hören seltsamst Ton -- halten wild Tier -- Wind -- Fels klagen -- fremd Vogel -- 
  beten -- Schlief spät -- 
  erwachen -- Gesicht scheinen -- 
  steil Fels -- klettern Hoffnung hinauf -- Ausgang Wildnis entdecken -- Wohnung Mensch gewahr -- 
  stehen -- -- Auge reichen -- -- -- nebligen Dufte überzogen -- grau trübe -- Baum -- Wiese -- Gebüsch Auge erspähn -- einzeln Sträucher ausnehmen -- einsam betrübt eng Felsenritz emporgeschossen -- 
  unbeschreiblich -- Sehnsucht empfinden -- Mensch ansichtig -- -- fürchten -- 
  fühlt peinigend Hunger -- setzen nieder Beschloß sterben -- 
  tragen Lust leben dennoch Sieg -- raffen Träne -- abgebrochen Seufzer hindurch -- bewußt -- müde erschöpfen -- wünschen leben -- fürchten Tod -- 
  Abend scheinen Gegend umh freundlich -- Gedanke -- Wunsch leben -- Lust Leben erwacht Ader -- 
  glauben Gesause mühl Ferne hören -- verdoppeln Schritt -- -- -- Grenze öd Fels erreichen -- Wälder Wiese fern angenehm Berg liegen -- 
  -- Hölle Paradies treten -- Einsamkeit Hilflosigkeit scheinen fürchterlich -- 
  Stadt gehofft Mühle stoßen Wasserfall -- Freude freilich viele mindert -- schöpft Hand Trunk Bache -- plötzlich -- hören Entfernung leis Hust -- 
  angenehm überraschen -- Augenblick -- näh Ecke Wald alt Frau gewahr -- auszuruhen scheinen -- 
  fast schwarz gekleiden schwarz Kappe bedeckt Kopf Gesicht -- Hand halten Krückenstock -- 
  nähern bat Hülfe -- lassen niedersetz Brot Wein -- 
  aß -- singen kreischend Ton geistlich Lied -- 
  enden -- -- folgen -- 
  Antrag erfreut -- wunderlich Stimme Wesen alten vorkommen -- 
  Mt Krückenstock ziemlich behend -- Schritt verzog Gesicht -- Anfange lachen müssen -- 
  wild Fels treten -- gehen angenehm Wiese -- ziemlich lang Wald -- 
  heraustrat -- Sonne -- Anblick Empfindung Abends vergessen -- 
  sanftest Rot Gold verschmelzen -- Baum stehen Wipfel Abendrot -- Feld liegen entzückend Schein -- Wald Blatt Baum stehen still -- rein Himmel aufgeschlossen Paradies -- Riesel Quelle Flüster Baum tönen heit Stille wehmütig Freude -- 
  jung Seele bekommen Ahnung Welt Begebenheite -- 
  vergessen Führerin -- Geist Auge schwärmen golden Wolke -- 
  steigen Hügel hinan -- Birke bepflanzen -- grün Tal voll Birk hinein -- unten mitten Baum liegen Hütte -- 
  munteres Belle entgegen -- springen behend Hund alte -- wedelen -- -- besehen Seite -- kehrt freundlich Gebärde alte -- 
  Hügel heruntergingen -- hört wunderbar Gesang -- Hütte scheinen -- Vogel -- singen -- 
  > Waldeinsamkeit -- erfreut -- ewig -- O freuen Waldeinsamkeit -- < 
  weniger Wort beständig wiederholen -- beschreiben -- fast -- Waldhorn schalmei Ferne Durcheinanderspiele -- 
  Neugier außerordentlich spannen -- Befehl alte warten -- treten Hütte -- 
  Dämmerung einbrechen -- ordentlich aufräumen -- Becher stehen Wandschranke -- fremdartig Gefäß Tisch -- glänzend Käfig hing Vogel Fenster -- -- Wort singen -- 
  alt keichen husten -- scheinen erholen -- streichelt Hund -- sprechen Vogel -- gewöhnlich Liede Antwort -- -- Zugeg -- 
  betrachten -- überlief Schauer -- 
  Gesicht ewig Bewegung -- alt kopfe schütteln -- wissen -- eigentlich Aussehn beschaffen -- 
  erholen -- zünden Licht -- decken Tisch tragen Abendessen -- 
  -- heißen geflochten Rohrstühl nehmen -- 
  sitzen dicht Licht stehen -- 
  faltet knöchern Hand beten laut -- Gesichtsverzerrung -- beinahe lachen bringen -- -- erbosen -- 
  Abendessen beten -- weisen niedrig eng Kammer Bett -- schlief Stube -- 
  bleiben Munter -- halb betäuben -- Nacht wacht einigemal -- hört alt hust Hund sprechen -- Vogel -- Traum scheinen -- einzeln Wort Liede singen -- 
  Birk -- Fenster rauschen -- Gesang entfernt Nachtigall wunderbar Gemisch -- -- erwachen -- fieler seltsamem Traum -- 
  wecken alte -- weisen nachh Arbeit -- 
  müssen spinnen -- begreifen -- Hund Vogel sorgen -- 
  lernen schnell Wirtschaft finden -- Gegenstand umher -- -- müssen -- denken -- alt Seltsames -- Wohnung abenteuerlich Mensch entfernen liegen -- Vogel Außerordentliches -- 
  Schönheit fallen -- Feder glänzt möglich Farbe -- schön Hellblau brennendste Rot wechseln Halse Leib -- singen -- Blähte stolz -- Feder prächtiger zeigen -- 
  alt Abend -- Hund entgegen -- nennen Kind Tochter -- 
  Herz -- Sinn -- Kindheit -- gewöhnen -- 
  abendstunden lehren lesen -- finden Kunst -- nachh Einsamkeit Quelle unendlich Vergnügen -- alt geschrieben Buch -- wunderbar Geschichte enthalten -- 
  Erinnerung damalig Lebensart seltsam -- menschlich Geschöpf besuchen -- Familienzirkel einheimisch -- Hund Vogel machen Eindruck -- längst gekannt Freund hervorbringen -- 
  seltsam Name Hunde besinnen -- Sooft nennen -- 
  alte leben -- ohngefähr zwölf alt -- vertraut -- Geheimnis entdecken -- 
  Vogel legen nämlich Ei -- Perle Edelstein befinden -- 
  bemerken -- heimlich Käfig wirtschafen -- genau bekümmern -- 
  tragen Geschäft -- Abwesenheit Ei nehmen fremdartig Gefäße verwahren -- 
  lassen Nahrung -- bleiben lang -- Woche -- Monat -- Rädchen schnurren -- Hund bellt -- wunderbar Vogel singen still Gegend umh -- kein Sturmwind -- kein Gewitter erinneren -- 
  Mensch verirren dorthin -- Wild Behausung nahe -- zufrieden arbeiten hinüber -- 
  -- Mensch glücklich -- ungestört Leben an fortfahren -- 
  weniger -- lesen -- bildet wunderlich Vorstellung Welt Mensch -- Gesellschaft hergenommen -- lustig Leute Rede -- vorstellen Spitz -- prächtig Dame sehen Vogel -- alt Frau wunderlich alt -- 
  Liebe lesen -- spielen Phantasie seltsam Geschichte selber -- 
  dachen schön Ritter Welt -- schmückt Vortrefflichkeit -- eigentlich wissen -- Bemühung aussehen -- Mitleid selber -- lieben -- rührend Rede Gedanke -- zuweilen laut -- gewinnen -- 
  -- lächeln -- freilich Jugend hinüber -- 
  -- -- alsdann Gebieterin Haus -- 
  Hund lieben -- Vogel antworten Liede Frage -- Rädchen drehen munt -- fühlt Grund Wunsch Veränderung -- 
  alte lang Wanderung zurückkommen -- lobt Aufmerksamkeit -- -- Haushaltung -- dazugehören -- ordentlich führen -- freut Wachstum gesund Aussehn -- -- Tochter -- 
  > brav -- Kind -- < einst schnurrend Tone -- > fortfährsen -- -- gedeihen -- Bahn abweichen -- Strafe folgen -- spät -- < -- -- achten -- Bewegung Wesen lebhaft -- Nacht fallen -- begreifen -- sagen -- 
  überlegt Wort genau -- Reichtümer lesen -- fallen -- Perle Edelsteine Kostbares können -- 
  Gedanke deutlich -- 
  Bahn -- 
  Sinn Wort fassen -- 
  vierzehn alt -- Unglück Mensch -- Verstand bekommen -- Unschuld Seele verlieren -- 
  begriff nämlich -- ankomm -- Abwesenheit alte Vogel Kleinodien nehmen -- Welt -- lesen -- aufsuchen -- 
  -- überaus schön Ritter antreffen -- Gedächtnisse liegen -- 
  Anfang Gedanke Gedanke -- Rade sitzen -- wider Wille -- verlieren -- herrlich schmücken -- Ritter Prinz -- 
  vergessen -- ordentlich betrüben -- aufschaut -- Wohnung antreffen -- 
  -- Geschäft -- bekümmeren alt Wesen -- 
  Wirtin fort -- -- diesmal lang gewöhnlich ausbleiben -- sollen ordentlich achtgeben lassen -- 
  gewiß Bangigkeit Abschied -- -- wiedersehen -- 
  wissen -- beängstigen -- fast -- Vorhaben stände -- deutlich bewußt -- 
  Hunde Vogel Emsigkeit pflegen -- liegen näh Herz -- -- 
  alte abwesend -- fest Vorsatze Aufstand -- Vogel Hütte verlassen -- sogenannter Welt aufsuchen -- 
  engen bedrängen Sinn -- wünschen dazubleiben -- Gedanke widerwärtig -- seltsam Kampf Seele -- Streit widerspenstig Geister -- 
  Augenblick ruhig Einsamkeit schön -- entzückt Vorstellung Welt -- wunderbar Mannigfaltigkeit -- 
  wissen -- selber -- Hund springen unaufhörlich -- Sonnenschein breitet munt Feld -- grün Birk funkelen -- 
  Empfindung -- Eilige -- greifen Hund -- binden Stube fest -- Käfig Vogel Arm -- 
  Hund krümmen Winselte ungewohnt Behandlung -- bittend Auge -- fürchten -- nehmen -- 
  einer Gefäßen -- Edelsteine anfüllen -- stecken -- übrigen lassen stehen -- 
  Vogel drehen Kopf wunderlich Weise -- Tür hinaustrat -- Hund strengen -- nachkommen -- müssen zurückbleiben -- 
  vermeiden Weg wild Fels entgegengesetzt Seite -- 
  Hund bellen winselt Immerfort -- rühren inniglich -- Vogel einigemal singen anfangen -- tragen -- müssen unbequem fallen -- 
  -- hören Belle schwach -- hören -- 
  weinen beinahe umgekehrt -- Sucht neue sehen -- treiben vorwärts -- 
  Berg Wald kommen -- Abend -- Dorfe einkehren müssen -- 
  blöd -- Schenke treten -- weisen Stube Bette -- schlief ziemlich ruhig -- alte träumen -- drohen -- 
  Reise ziemlich einförmig -- -- ängstigte Vorstellung alt Hund -- denken -- wahrscheinlich Hülfe verhungern müssen -- Walde glauben -- alte plötzlich entgegentreten -- 
  legen Träne Seufzer Weg -- sooft ruhen -- Käfig Boden stellen -- singen Vogel wunderlich Lied -- erinnern lebhaft schön verlassen Aufenthalt -- 
  menschlich Natur vergeßlich -- glauben -- vormalig Reise Kindheit trübselig jetzig -- wünscht Lage -- 
  Edelsteine verkaufen Wanderschaft Dorfe -- 
  Eintritt wundersam zumute -- erschrak wissen worüber -- erkennen -- Dorf -- gebären -- 
  überraschen -- 
  laufen Freude -- tausend seltsam Erinnerung -- Träne Wang -- 
  viele verändern -- Haus entstehen -- -- errichten -- verfallen -- treffen Brandstelle -- -- Gedrängter erwarten -- 
  unendlich freuen -- Eltern wiederzusehn -- finden Haus -- wohlbekannt Schwelle -- Griff Tür -- -- gestern anlehnen -- Herz klopfen ungestüm -- öffnen hastig -- fremd Gesicht sitzen Stube umher stiern -- 
  fragen Schäfer Martin -- -- Frau sterben -- 
  -- treten schnell -- laut weinend Dorfe hinaus -- 
  schön denken -- Reichtume überraschen -- seltsam Zufall -- Kindheit träumen -- umsonst -- freuen -- -- worauf meister Leben hoffen -- ewig verlieren -- 
  angenehm Stadt mieten Haus Garten -- Aufwärterin -- 
  wunderbar -- vermuten -- Welt -- vergessen alt ehemalig Aufenthalt -- leben zufrieden -- 
  Vogel singen -- erschrak -- Nacht plötzlich anfing -- verändert Liede -- 
  singen -- > Waldeinsamkeit liegst -- 
  O reuen einst -- -- 
  einzig Freude Waldeinsamkeit -- < 
  Nacht hindurch schlafen -- fallen neu Gedanke -- jemals fühlen -- Unrecht tun -- 
  Aufstand -- Anblick Vogel ordentlich zuwid -- -- Gegenwart ängstigen -- 
  hört Liede -- singen lauter Schallender -- wohnen -- 
  betrachten -- bang -- öffnet Käfig -- stecken Hand hinein fassen Hals -- herzhaft drückt Finger -- Bittend -- lassen -- sterben -- 
  -- begrub Garten -- 
  wandelt Furcht Aufwärterin -- denken -- glauben -- einst Beraube ermorden können -- -- 
  kannen jung Ritter -- überaus gefallen -- Hand -- hiermit -- Herr Walther -- Geschichte endigen -- -- 
  -- hätten sehen -- -- fallen Eckbert hastig -- Jugend -- Schönheit -- welcher unbeschreiblich Reiz einsam Erziehung geben -- 
  Wunder -- lieben Maß -- 
  Vermögen -- Liebe Wohlstand -- ziehen hierher -- Verbindung Augenblick reuen -- -- 
  -- Schwatze -- -- fing Bertha -- -- tief Nacht -- 
  schlafen legen -- -- 
  stehen Kammer -- 
  Walther wünschen Handkusse Nacht -- -- -- Edle Frau -- danken -- vorstellen -- seltsam Vogel -- Strohmian füttern -- -- 
  Walther legen schlafen -- Eckbert unruhig saal -- 
  -- -- Mensch Tor -- -- fing -- -- Veranlassung -- Frau Geschichte erzählen -- reuen Vertraulichkeit -- -- 
  mißbrauchen -- 
  mitteilen -- 
  -- Natur Mensch -- unselig Habsucht unser Edelgestein empfinden -- Plan anlegen verstellen -- -- 
  fallen -- Walther herzlich Abschied nehmen -- Vertraulichkeit -- 
  Seele Argwohn spannen -- treffen Kleinigkeit Bestätigung -- 
  werfen Eckbert unedles mißtrauen wacker Freund -- zurückkehren -- 
  schlagen Nacht Vorstellung herum -- Schlief -- 
  Bertha krank Frühstück erscheinen -- Walther scheinen kümmern -- verlassen Ritter ziemlich gleichgültig -- 
  Eckbert Betragen begreifen -- besucht Gattin -- liegen Fieberhitze -- Erzählung Nacht müssen Art gespannt -- 
  Abend besuchen Walther selten Burg Freund -- -- unbedeutend Wort weg -- 
  Eckbert Betrag äußerer Grad peinigen -- lassen Bertha Walther merken -- müssen innerlich Unruhe gewahr -- 
  Bertha Krankheit bedenklich -- Arzt ängstlich -- Röte Wang verschwinden -- Auge glühend -- 
  -- lassen Mann Bette rufen -- Mägde müssen entfernen -- 
  -- Mann -- -- fing -- -- entdecken -- fast Verstand bringen -- Gesundheit zerrütten -- unbedeutend Kleinigkeit scheinen -- 
  -- weißen -- -- sooft Kindheit sprechen -- trotz angewandt Mühe Name Hunde besinnen -- umgehen -- Abend Walther Abschiede plötzlich -- 
  > vorstellen -- Strohmian füttern -- < 
  Zufall -- 
  Name erraten -- wissen Vorsatz nennen -- 
  hängen Mensch Schicksal -- 
  zuweilen kämpfen -- Seltsamkeit einbilden -- gewiß -- gewiß -- 
  gewaltig entsetzen befiel -- fremd Mensch Erinnerung helfen -- 
  sagen -- Eckbert -- -- 
  Eckbert leidend Gattin tief Gefühl -- schweigen denken -- tröstend Wort verlassen -- 
  abgelegen Gemache unbeschreiblich Unruhe -- 
  Walther einzig Umgang -- Mensch einzig Welt -- drücken peinigen -- 
  scheinen -- froh -- einzig Wesen Weg rücken -- 
  Armbrust -- zerstreuen Jagd -- 
  rauh stürmisch Wintertag -- tief Schnee liegen Berg bog zweig Baum nieder -- 
  streifen umher -- Schweiß stehen Stirn -- treffen Wild -- vermehrt Unmut -- 
  plötzlich Ferne bewegen -- Walther -- Moos Baum sammeln -- wissen -- legen -- Walther -- drohen stumm Gebärde -- fliegen Bolzen -- Walther stürzen nieder -- 
  Eckbert fühlen beruhigen -- treiben Schauder Burg -- Weg -- hinein Wald verirren -- 
  ankommen -- Bertha sterben -- Tod Walther alte sprechen -- 
  Eckbert leben groß Einsamkeit -- schwermütig -- seltsam Geschichte Gattin beunruhigen -- irgendein unglücklich Vorfall -- ereignen -- befürchten -- zerfallen -- 
  Ermordung Freund stehen unaufhörlich Auge -- leben ewig innerer Vorwurf -- 
  zerstreuen -- begeben zuweilen nächster Stadt -- Gesellschaft Fest besuchen -- 
  wünschen irgendein Freund Leere Seele ausfüllen -- Walther zurückdachen -- erschrak Gedanke -- Freund finden -- überzeugen -- unglücklich jedwed Freund können -- 
  Bertha schön Ruhe leben -- Freundschaft Walther hindurch beglücken -- plötzlich dahingeraffen -- Leben Augenblick seltsam märch -- wirklich Lebenslauf erscheinen -- 
  jung Ritter -- Hugo -- schließen still betrübt Eckbert -- scheinen wahrhaft Zuneigung empfinden -- 
  Eckbert finden wunderbar Art überraschen -- Freundschaft Ritter schnell entgegen -- vermuten -- 
  häufig beisammen -- Fremde erzeigen Eckbert möglich Gefälligkeit -- riten fast -- Gesellschaft treffen -- -- scheinen unzertrennlich -- 
  Eckbert kurz Augenblick froh -- fühlen deutlich -- Hugo Irrtume lieben -- kennen -- wissen Geschichte -- fühlen Drang -- mitteilen -- versichern können -- wahrhaft Freund -- 
  halten Bedenklichkeit Furcht -- verabscheuen -- -- 
  Stunde Nichtswürdigkeit überzeugen -- glauben -- Mensch -- völlig Fremdling -- können Achtung würdigen -- 
  dennoch widerstehn -- einsamen Spazierritt entdeckt Freund Geschichte -- fragen -- Mörder lieben können -- 
  Hugo rühren -- suchen trösten -- Eckbert folgen leicht Herz Stadt -- 
  scheinen Verdammnis -- Stunde Vertrauen Argwohn schöpfen -- Saal treten -- Schein Licht Miene Freund gefielen -- 
  glauben hämisch lächeln bemerken -- fallen -- sprech -- anwesend reden -- scheinen -- 
  alt Ritter Gesellschaft -- Gegner Eckbert zeigen -- Reichtum Frau Weise erkundigen -- gesellt Hugo -- sprechen Zeitlang heimlich -- Eckbert hindeutet -- 
  Argwohn bestätigen -- glauben verraten -- schrecklich Wut bemeistern -- 
  Hinstarrt -- plötzlich Walther Gesicht -- Miene -- -- wohlbekannt Gestalt -- überzeugen -- Walther alte sprechen -- 
  entsetzen unbeschreiblich -- stürzen hinaus -- verlassen Nacht Stadt -- kehrt Irrwege Burg -- 
  unruhig Geist eilt Gemach Gemach -- Gedanke halten stehen -- verfiel entsetzlich Vorstellung entsetzlicheren -- Schlaf Auge -- 
  denken -- wahnsinnig -- selber Einbildung erschaffen -- erinnern Zug Walther -- Rätsel -- 
  beschließen Reise -- Vorstellung ordnen -- Gedanke Freundschaft -- Wunsch Umgang ewig aufgeben -- 
  ziehen fort -- bestimmt Weg vorzusetzen -- betrachtet Gegende -- liegen -- 
  stark Trab Pferd fortgeeilen -- plötzlich Gewind Fels verirren -- nirgend Ausweg entdecken lassen -- 
  treffen alt Bauer -- Pfad -- Wasserfall vorüber -- zeigen -- 
  Danksagung Münze geben -- Bauer schlagen -- 
  -- -- gelten -- -- Eckbert selber -- -- einbilden -- Walther -- -- -- -- Walther -- 
  -- Eckbert spornt Roß schnell laufen -- Wiese Wald -- erschöpfen zusammenstürzen -- 
  -- unbekümmert setzen Reise Fuß fort -- 
  steigen träumend Hügel hinan -- -- nah munter Belle vernehmen -- Birke säuselten -- hören wunderlich Tön Lied singen -- -- waldeinsamkeit freuen -- geschehen Leid -- wohnen Neid -- neu freuen Waldeinsamkeit -- -- 
  Bewußtsein -- Sinn Eckbert geschehen -- Rätsel herausfinden -- träume -- ehemals Weibe Bertha träumen -- Wunderbarste vermischen Gewöhnlichst -- Welt verzaubern -- kein Gedanke -- Erinnerung mächtig -- 
  krummgebückt alt schlich hustend Krücke Hügel heran -- 
  -- bringst Vogel -- 
  Perle -- 
  Hund -- -- schreien entgegen -- 
  -- sehen -- Unrecht bestrafen -- Freund Walther -- Hugo -- -- 
  -- Gott Himmel -- -- eckbert still -- -- entsetzlich Einsamkeit Leben hingebrachen -- 
  -- -- Bertha Schwester -- -- 
  Eckbert fallen Boden -- 
  -- verlassen tückisch -- 
  schön enden -- Probezeit vorüber -- 
  Tochter Ritter -- Hirt erziehen lassen -- Tochter dein Vater -- -- 
  -- schrecklich Gedanke ahnden -- -- rufen Eckbert -- 
  -- Jugend deinen Vater einst erzählen Hörtest -- Frau Tochter erziehen lassen -- Weibe -- -- 
  Eckbert liegen wahnsinnig verscheidend Boden -- Dumpf verworren hört alt sprechen -- Hund bellen -- Vogel Lied wiederholen -- 