Okuli -- -- -- 
  rufen Oberforstmeister Huwald Tür herein -- 
  rüstig -- 
  Brüderchen -- machen -- fest -- 
  Brief -- -- fahren Landrat Thalheim Armsessel -- ist_es gewiß -- 
  Brief -- 
  -- fallen laut lachen -- lassen -- alt Diplomat hältst Ordnung -- 
  Sohn Woche Feld schreiben -- Schnepfe notifizieren schriftlich Ankunft -- 
  weißen -- Okuli -- 
  Okuli -- -- -- 
  dein dummen Schnepf -- -- unterbrach Landrat verdrießlich -- 
  Dumm -- Schnepfen -- -- Schalt Oberforstmeister -- sollst abbitten -- Herr Bruder -- 
  machen fort -- kommen -- ziehen -- sollst Lust sehen -- 
  Schnepfen Jagd -- Landrat -- -- sieh Jammergesichter -- 
  Woche -- Nachricht fehlen -- 
  hören bedeutend Schlacht -- setzen Landrätin hinzu -- ruhig bleiben -- 
  Offizier -- entgegnet Oberforstmeister -- hinzusetzen -- Vater Mutter -- Braut Schwester schreiben -- 
  Brief -- Armee -- verloren können -- auffangen -- 
  -- schwach Tröstunge -- klagen Julie -- bleiben -- arm Blättchen Papier Wort schreiben -- 
  leben denken Eurer -- -- 
  -- Mann lieben -- -- -- 
  jung Braut -- -- 
  fallen Oberforstmeister -- -- Töchterchen -- 
  -- Fritz hoffentlich rechtfertigen -- vergeß -- Vater -- lieben -- 
  scherzen -- Landrat halb unwillig -- einzig Sohn Feld -- bleibst ruhig -- Umstand vereinigen -- traurig Ahnung erfüllen -- 
  Ahnung -- 
  -- wiederholen Oberforstmeister ernst -- Ahnung -- 
  Thalheim beziehen ausgeblieben Nachricht -- Oberforstmeister merken -- ungewöhnlich Unruhe Familie hervorbrachten -- 
  einigem herreden erzählt Landrat folgender -- weißt -- sprechen -- Fritz Abschiede Tochter Lieblinghund zurücklassen -- Bianca -- 
  niedlich Tierchen Nacht bleiben -- Julie Freude -- Stundenlang zuvor -- ehe Sohn -- Nähe merken -- unruhig -- kratzt Tür -- Herr entgegen -- 
  warten Pflegte auf's gute Tier gewöhnen -- Herr -- 
  Hund tiefsinnig -- eingezogen Schwanze herum -- nirgends Ruhe -- seufzt -- stöhnen fangen kläglich heulen -- -- Behältnis Hofe einsperren müssen -- 
  -- Jäger nachsehn -- Tier wütend zerbiss Tür arbeiten -- 
  müssen heftig Scharre verwunden -- Boden überall voll Blutfleck -- 
  Leute ausgeschicken -- Schaden -- Tochter finden Anzeichen -- glauben -- Herr Tier müssen Unglück begegnen -- Hund Geheul anzeigen -- 
  -- -- 
  fahren Oberforstmeister heftig -- treu Tier Herr sehnen -- 
  Ihr_es Mensch Vieh -- 
  stark Gefühl ergreifen -- begreifen -- rappeln -- 
  frei Bianca -- glauben Wort -- laß erschießen -- 
  -- -- Julie -- Nacht quälen ängstlichsn Traum -- 
  sehen Fritz Bruder -- niemals Uniform -- Jäger kleiden -- frisch geschossen Wild Hand -- 
  bedeuten Blut gefährlich Verwundung -- 
  Oberforstmeister Traumdeutung lachen -- Stimmung Familie ernst trübe -- Julien glänzend Auge drängen Scherz -- 
  lieb Kind -- freundlich ernst weinend Mädchen -- gewiß wenigster Ursache Bedeutsame Traum leugnen -- verlach -- 
  Traum -- Leben Richtung Gehalt geben -- 
  Gott wissen -- Traum währ -- 
  Traum Bedeutung -- gewöhnlich Traumbuch Ausleger Traum -- 
  sprech Ernst -- Kind -- 
  Braut -- geliebter entfernt -- voll Sehnsucht Bekümmernis -- 
  Ding -- dein Geist aufreg Phantasie gewöhnlich bewegen -- 
  erwarten -- Traum gewöhnlich Sprache ruhig Zeit sprechen -- Traumsprach glaubst -- 
  verletzeen gutgemeint Scherz dein Freund -- meinst -- Gefühl Traum gewöhnlich ironisch Späß Traumsprach verletzen -- 
  trösn gütig -- Julie -- -- Ernst Überzeugung -- Güte Trost -- 
  sagen -- fahren Oberforstmeister fort -- Schicksal -- berechtigen -- Traum Traumdeutung geheimnisvoll Einwirkung sogenannter Geisterwelt sprechen -- 
  währ unbekümmert abwesend -- währ Traum Schicksal beruhigen -- 
  bloß Traum -- -- wiederholen Julie -- 
  Wunderliches Mädchen -- entgegnet -- Beunruhigende Kraft dein Träum einräumen -- Beruhigung finden -- scheinen schicklich -- 
  sehen -- schießen Schnepf -- Haus reiten -- 
  Abendbrot vorsetzen -- erzähl Eurer Beruhigung Lebensgeschichte -- angenehm erfüllt Traum anfangen -- 
  Erbiet alt Freund -- Leben Schicksalen Wunderbare Seltsame verlauten -- höchst willkommen -- 
  möglichst bequem -- schicken Jäger Aufträg Teetisch vereinigt Erzähler Zuhörer freundlichen -- vertraulich Kreis -- 
  Vater -- beginnen Oberforstmeister -- besitzen Reichtümer -- Vermögen -- -- einzig Sohne -- sorgenfreier Leben sichern -- 
  hütet Verschwendung -- Sparsamkeit jugendlich Meinung einleuchten -- trocken -- 
  -- Unabhängigkeit -- jeder -- unabhängig bleiben -- Seinige zusammenhalten -- 
  alt Sprichwort -- 
  Neider -- Mitleid -- -- 
  bleiben hierüber Tod verschieden Meinung -- 
  halten öffentlich Urteil -- Vater Krösus -- Voraussetzung finden Freund Menge -- ihrig beistand -- Zahlung Vater Wünsch genügen -- ihrigen -- 
  Aufenthalt Universität -- überglücklich leben -- verlängern -- Nachricht Vater plötzlich ableben rufen Haus -- 
  Vater Genauigkeit herzlich lieben -- Tod schmerzen Innig tief -- Aussicht geworden Reichtum erfreuen -- 
  verschieben -- Papier durchzuseh Größe Verlassenschaft unterrichten -- 
  Mußt Werk -- unerwartet Ausgang -- 
  Durchsicht Papier enden -- finden -- Einbildungskraft reich Verlassenschaft Wirklichkeit hinreichen -- Gläubiger zufrieden stellen -- 
  gehören -- gut Freund dergleich Fall gewöhnlich bös Feind -- allgemein Satz Gestalt -- hören lesen -- erfahren erleben -- 
  letzter Fall -- 
  gut Freund zuckt Achsel -- meinen -- erwarten -- pekuniär Hinsicht Selig täuschen -- vorsichtig -- bloß Vermutung Erwartung gründen -- dergleich weisheitlehren -- wohlfeil Welt bekommen -- Veranlassung teuer bezahlen -- 
  fallen Vater wahres Wort -- Neider -- Mitleid -- 
  indessen -- ändern -- 
  Erbschaft wandert Hand Gläubiger -- beweisen -- behalten -- verlören -- zumuten können -- 
  Entschluß -- Anstellung suchen -- Unabhängigkeitsucht Vater Feind -- Verschwendung wohlwollend Freund -- 
  weisen -- leer Versprechung -- 
  Weg russisch Kriegsdienst suchen -- vaterland Beschämung verbergen -- 
  Nachtquartier Traum -- -- erwähnen -- entscheidend Schicksal -- 
  blühend Anlage schön Park -- niemals Wachen -- Träumen sehen -- erinnern -- 
  sogenannter englisch Gartenanlag Deutschland seltenes -- 
  herrlichst Blume Blütenbüsche niedrig Moosdach Einsiedelei -- rot Strahl untergehend Sonne schwankend Zweig beleuchten -- 
  Blume betrachten -- blendend weiß -- gefüllt Rose -- niemals zuvor -- erfreu -- öffnen Türe Einsiedelei -- Mädchen treten heraus -- -- alt Siebenziger müßen Beschreibung schön Mädchen erwarten -- -- stehen Traume anzaubern -- wissen -- Einsiedelei Gartenhau vorhall Himmel -- Engel heraustrat -- 
  Glück fassen Gießkann -- Weg stehen -- -- Blume begießen -- woraus schließen -- Erdentochter -- schön -- jemals Blume wandeln -- 
  tragen schneeweiß Gewand -- seltsam silbern Stern durchweben -- -- Wohnung Erde hindeuen -- 
  vorüber -- nicken freundlich -- Freude lieben Engelsgruß erwachen -- -- 
  niemals Traum halten -- Traum schön himmlisch Bild weichen erwachen Auge -- 
  indessen müssen Fortsetzung Reise denken -- 
  Gaststube Frühstück verzehren -- hör paar Fremde entzücken herrlichen Rosa Unika sprechen -- Bentheimischo Garten blühen -- 
  jeh Blumenfreund -- neugierig -- unbekannt Wunderrose sehen -- Beschreibung weiß Blume Traume einfiel -- 
  weisen allzuweit entlegen Dorf -- 
  finden prächtig Garten -- überraschen -- -- -- sogenannt englisch Geschmack anlegen -- 
  entzücken herrlich Wechsel Naturschönheit -- wild Felsenmass Gebirges -- anmutigst Blumenstücke Wasseransichte reizend gelegen Tal darstellen -- Menge selten Blume Gewächs -- Gärtner Bewundernde zeigen -- fast Rosa Unika vergessen -- Seitengang einlenken -- 
  -- sprechen -- Sonnenuntergang schön Unika zeigen -- erstenmal blühen -- 
  folgen -- wohlbekannen Gartenanlage Traum -- 
  weiß Rose blühen -- 
  Seitwärt blühend Büschen heben rot Abendlicht Moosdach Einsiedelei -- -- Tür öffnen -- himmlisch Gestalt treten heraus -- schön schön Traume -- Schneeweiss kleiden -- fehlt -- silbernen Stern Gewande Traumbild -- 
  ergreifen Gießkann tränken Blume Weg -- 
  raunen Gärtner -- Fräulein -- 
  stören -- Abends -- 
  Führer umwend -- gewahr -- Purpurrot überfliegen Gesicht himmlisch freundlich Gruß -- Traume entzücken -- verschwinden Auge -- 
  Traum halten -- leer Bild -- zugestehen -- pünktlich wiederholen Traume Wirklichkeit höchst selten -- Aufmerksamkeit erregen müssen -- 
  scheinen näheres Verhältnis schön Fräulein Traum andeuten -- Wunsch schweift dunkel Gebiet Sehnsucht hell Land Hoffnung -- 
  Begleiter hören -- schön Fräulein heißen Adelheid Tochter Baron Bentheim -- Schloß nebst weitläuftig Herrschaft gehören -- 
  Garten schönsn Anlage fast Werk Fräulein -- Bruder -- Major preußisch Dienst Feld -- Schicke schönsen seltenst Gewächs -- 
  Gärtner unerschöpflich Lobe -- 
  schön -- -- vergeß Schönheit himmlisch Güte Herzens -- 
  kurz vornehm General Hand beworben Fräulein Vater Liebe Jawort geben -- Verlobung seltsam Zufall zerstören -- 
  Bräutigam Wort zurücknehmen -- Vater Braut veruneinigen Zweikampf fordern -- angesetzten plötzlich sterben -- 
  neugierig Grund seltsam Ereignis hören -- Gärtner erzählt geheimnisvoll Weigerung folgend -- 
  Abend -- Schloß Menge Gast -- zahlreich Einquartierung überfüllt -- finden General -- Grille -- Zimmer -- Nebengebäude Nacht anbieten -- auszuschlag -- einzig unbesetzt Schlos bestehen -- Fräuleinzimmer nennen -- lang bewohnen -- Beunruhigung -- ereign -- übl Rufe stehen -- 
  Erzählung Warnung bewegt lachen ändert Vorsatz -- 
  Baron -- Sache ernsthaft halten -- -- lassen Gast Nacht verlangt Zimmer einräumen -- 
  General Zimmer begegnen -- wissen Gärtner angeben -- wiederholen erzählt Folge Vorwitz -- Vermutung seltsam Geheimniss Neugierde -- ergründen -- rechtfertigen -- 
  bekommen Lust -- Baron anmelden lassen -- Residenz -- einig besinnen finden -- bedrängt Lage günstig Aufnahme Vater geliebter versprechen können Beschloß Reise fortsetzen -- 
  Stadt -- 
  legen Wunsch nieder -- Traum schön Erscheinung sehen -- Unruhe verscheucht Traum Schlaf -- 
  Plan Art kreuzt Kopf -- Traum seltsam Erfüllung scheinen auffordern -- Schritt schön Ziel -- unerreichbar vorkommen müssen -- 
  Beschloß Mehr verworfen abenteuerlich Plan -- Baron vorstellen -- angenommen Name Dienst anbieten -- 
  Vorsatz früh Weg Bentheimischen Garten -- 
  einig Herumirr treffen Gärtner -- 
  -- rufen -- -- 
  Herr Baron zurückgekommen -- sogleich anmelden -- 
  Anerbiet überraschen -- anfangs ablehnen -- Gärtner -- Baron gestern Abend fremde -- Garten umgesehen -- fragen -- bedauern entbehrt Besuch äußern -- 
  winkt Gartenburschen -- Nachricht zurückkommen -- Herr erwarten -- 
  Baron empfangen artig -- 
  sprechen mancherlei Geschmack Gartenkunst hören aufmerksam -- dawider -- 
  Gespräch fragt -- leicht Wendung veranlassen -- Name -- 
  -- Vorbereitung glühend heiß -- verändert Name Ewald heraussagen erzählt -- Kameralwissenschafte legen -- Anstellung suchen -- 
  scheinen erfreut -- artig Weise verstehen -- Geschäftführer sämtlichen Angelegenheit brauchen -- bloß Entschluss beruhen -- Stelle -- Erwartung angemesseneren -- annehmen -- 
  einig -- schwer ankommen -- angeboten Gehalt annehmen -- 
  wissen -- Weigerung Punkt verran -- währ Glück Adelheid eintreten -- 
  schlagen -- 
  aufnehmen -- täglich Abgott Herzens -- 
  erscheinen liebenswürdig -- 
  Wink regiert Haus -- gleichwohl mißbrauchen uneingeschränkt Gewalt -- Vater einräumen -- niemals -- Wille Meinung Anderer Festigkeit geltend -- zeugen gewiß Erfolg Richtigkeit Ansicht -- 
  Geschäft Baron Örtlichkeit Aufenthalt ziemlich genau -- verwalten übertragen Aufsicht Zufriedenheit Besitzer -- 
  Adelheid helfen treulich Rat -- Kenntnis hinreichen -- 
  Neuerung alt Schlos vorschlagen -- Fall brechen Baron -- 
  Vorjetzt bleiben -- -- lassen Grund widerlegen -- 
  Gelegenheit fallen Zimmer -- -- Erzählung Gärtner -- Adelheid's Bräutigam geheimen ängsten -- 
  Bestimmteres -- wissen -- erzählen -- 
  günstig Ungefähr bringen Sache nah -- 
  siebenjährig Krieg führen öfters Einquartierung -- 
  Schloß Raum Kriegsgäste ungeladen Regel unartig Gast -- 
  quartieren jung Offizier -- willkommen -- bekannt Sohn Haus einführt -- erwünscht Nachricht erzählen wissen -- Rede -- wissen -- Gespenster -- bejaht leugnet -- Gespräch -- sehen -- Augenschein überzeugen -- Wesen geben -- Philosophie träumen lassen -- 
  fallen Offizier -- silbern Fräulein gehören -- Schloß umgehen sollen -- 
  Baron weiset Sache lachend erzählen Anekdote Erscheinung Schlos -- insgesamt Täuschung Zufall Furcht auflösen -- 
  Offizier -- Wein erhitzen -- fahren Frage heraus -- Vorfall General Täuschung -- 
  Bentheim geraten sichtbar Verlegenheit -- 
  leugnen -- Begebenheit unerklärlich -- 
  -- fahren fort -- Erklärung Rede -- General niemals Begebenheit Nacht entdecken -- sehen Notwendigkeit -- Geistererscheinung schließen -- 
  Offizier bestehen -- Abenteuer untersuchen -- 
  Widerspruch Baron Ängstlichkeit Adelheid's machen Neugieriger -- 
  -- flüstert -- schön nächtlich Abenteuer -- bevorstehen -- Komödie Roman dergleichen lesen finden -- 
  Erbot -- nachtwache teilen -- -- gehören -- dergleich Abenteuer können Person glücklich bestehen -- 
  zufrieden Bentheim ebenfalls -- 
  Tochter paar Wort Ohr -- erinnern -- verlangt Zimmer Gast Stand setzen lassen -- 
  aufgehoben Abendtafel entfernt Offizier -- voll Erwartung geheimnisvoll Abenteuer zeigen -- 
  Gast finden ziemlich geräumig Zimmer -- erbeten -- 
  Tisch liegen mitgebracht Waffe -- mehrere Licht erhellt Winkel -- Sofa zusammengerückt Stuhl Fall Ermüdung Matratze leicht Decke belegen -- Wandnische stehen fertig Bett -- 
  Mitte rund Tisch Wein -- Punsch Zubehör aufstellen -- Sprachrohr lehnen Fenster -- Klingel lassen Haus Notfall Beistand herbeirufen -- 
  besah Einrichtung genau -- beleuchtet Winkel untersucht Fenster Tür sorgfältigsten -- 
  setzen rund Tisch -- Gefährt Mut voll Glas fleißig anfeuerten -- verteilt Rolle bevorstehenden nächtlich Drama -- 
  Mitternacht nah -- bleiben totenstill -- 
  aussprechen -- 
  Gesellschaft lassen Augenlider sinken -- ermahnen vergebens gegenseitig Wachsamkeit -- 
  Umsonst -- Schlaf behaupten nächtliches -- 
  erwecken plötzlich schön Träum stark wiederholt pochen -- 
  fahren -- Licht brennen düster -- 
  taghell -- 
  Bedienter treten herein -- fragen -- Herr Gesellschaft Familie frühstücken wünschen -- 
  verdrießlich getäuscht Erwartung ungewiß -- Abenteuer -- Abenteuer verfehlen -- erheben -- 
  erwartet spöttisch lächeln satirisch Bemerkung Familie empfangen -- Baron fragen bloß -- Nacht beunruhigen sein -- Erzählung -- Abenteuer verschlafen -- folgen -- trocken Bemerkung -- -- Vorwitz unterlassen -- 
  fremd mancherlei Geist Geisterseh witzeln -- Baron hören ruhig -- werfen -- zufällig -- Frage -- Nacht Gefahr Abenteuers aussetzen möchten -- 
  fremde schnell heraus fast Frage übel aufnehmen -- Bentheim bleiben gelassen -- 
  Wort -- -- schuldig -- Ding Täuschung -- 
  gestern Abend Wunsch äußern -- verdächtig Zimmer Schlosses Nacht hinzubringen -- halten Vorhaben Anwandlung jugendlich Leichtsinn -- 
  währ vergebens -- Grund entgegenzusetzen -- bedienen -- dünkt -- unschuldig List -- 
  glauben -- Geisterzimmer bestimmen -- lassen anderer Zimmer bereit -- worin befremdend Vorfall erwarten -- 
  bleiben ungestört -- 
  gestern Mut nah kennen lernen -- glauben Bekenntnis schuldig -- Versicherung -- künftig Nacht -- Mut Versuch erkalten -- unheimlich Zimmer zubringen -- 
  Prüfen Unerschrockenheit -- Entschluß -- 
  hinzuzusetzen -- begegnen -- glauben -- Scherz Meinig Herzhaftigkeit treiben -- 
  Ehrenwort bürgen -- -- -- gestatten -- Täuschung schrecken beunruhigen -- 
  Erklärung sonderbaren Eindruck Abenteurer -- 
  -- sehen Ernst Baron -- Unheimlich Hintergrund -- Phantasie frei Lauf -- furchtbarsen Region Geisterwelt Schreckphantome bilden -- 
  gestehen -- Herz bang schlagen -- gestrig Nacht -- indessen bezeigt Mut Poltronnerie erklären -- müssen Baron Anerbiet annehmen -- 
  erwartet -- Bentheim -- sehen indessen Wagstück unbedeutend -- 
  zweifle -- Nacht geistig Wesen Überzeugung erhalten -- 
  Bereiten -- voll Besonnenheit begegnen -- zeigen -- 
  Näheres Erscheinung Zimmer bewußt -- General -- wissen -- offenbaren -- begegnen -- Vorfahr -- unser Eltern heilig Pflicht -- niemals Zimmer betreten -- 
  ferner unbekannt Erscheinung sprechen -- heiter Licht Sache verbreiten -- 
  Wirt spendet Abendessen Wein ungewohnt Sparsamkeit -- entschuldigt -- Nacht dürftig sorgen -- 
  finden Vorsicht Umstände angemessen entfernt verrufen Zimmer -- 
  zeigen Spur lang Verödung unverkennbar -- Unterschied unser gestrig Schlafzimmer auffallend -- 
  Tisch stühl Gast -- mitten weniger vermorscht alt Gerüll -- bilden unangenehm Kontrast -- unheimlich Umgebung stark hervorheben -- 
  Nische vermauert gotisch Fenster stehen ziemlich verwittert Hausaltar -- alt -- geschnitzt Heiligenbilder -- 
  einzig Fenster bieten Aussicht eng Nebenhof -- Gebäude einzig Licht Nähe lebend ankündigen -- 
  richten indessen -- 
  Flasche Wein -- Mut anfachen -- ausgeleert -- 
  dachen furchtbarst Möglichkeit -- Wirklichkeit überbieen -- schlimme fassen -- Phantom ruhig entgegen treten -- 
  Geisterstunde heran -- 
  raten -- Winkel nochmals genau untersuchen -- Gefährt Sitz bewegen -- 
  Schalt Gleichgültigkeit Ding -- Stunde Ungeduld entgegen sehen -- kämpfen vergebens Gewalt Schlaf -- Bemühung übermannt -- unbezwinglich Betäubung halten -- 
  einsam verrufen Geisterzimmer -- 
  tief Schlaf Gefährten scheinen erhöht Grauen -- Beherztest ergreifen -- 
  versuchen vergebens -- -- Schlaf herbeizurufen -- 
  aufgeregt Phantasie scheucht Sitz -- treiben unsten öde Zimmer umher -- 
  verwünscht unnütz Neugierde -- antreiben -- Geheimnis Zimmer erforschen -- 
  gering Knister morschen -- wurmstichig Gerätschaft peinigt Ankündigung nahend unheimlich Schrecken -- Augenblick enthalten -- Zimmer verlassen -- Nähe lebend wachend Wesen aufsuchen -- 
  beruhigend matt Lichtschein -- Fenster vorher finsteren Teil Schlosses bemerken -- Bewegung verraten scheinen -- Wachender Nähe furchtbaren Zimmer aufhalen -- Schloßherr Besorgnis Abenteurer bestellen -- 
  belebt Mut freuen -- hören leis vernehmlich Klopfen -- 
  Schauder -- schnell bekämpfen -- hindert -- nächtlichen Besucher sogleich Eintritt auffordern -- Pochen laut wiederholen -- 
  Pistole Arm Licht Hand -- festverriegelt Türe -- öffnen -- 
  hör leise Zuruf -- Umsehn erblick weiblich verschleiert Gestalt -- verborgen Tapetentür Zimmer treten -- 
  Sternschleier erkennen Gestalt Traume -- schlagen Schleier -- Adelheid stehen -- -- Mund gelegt Finger -- Stillschweigen gebieten -- 
  Geheimnis Zimmer enthüllen -- 
  Bangigkeit Schrecken Geisterwelt -- gering -- gewich -- Freude -- Geliebte Nähe sehen -- mächtig stören -- 
  Gefährte Schlaf erwach -- Kette verlegenheiter müssen seltsam Zusammentreffe entstehen -- 
  äußern -- lächelen -- 
  ruhig -- Huwald -- Schläfer stören -- 
  erstaunen -- wahr Name nennen -- bemerken fahren fort -- Ferdinand -- brauchst dein Name verhehlen -- Glück -- -- 
  entzücken Wort vertraulichen Ton -- sprechen -- müssen vorsehen -- Erwiderung Vertraulichkeit Name nennen -- wovon Nachtwandler -- -- erwachen -- 
  sprechen -- wissen -- Minute fliegen Pfeilgeschwind vorüber -- 
  Abschied fragen -- Bitte gewähren -- 
  versprechen Wunsch erfüllen -- währ -- ehe nennen -- 
  bitten Ring Erinnerungzeiche Stunde -- 
  Ring alt Familienerbstück trennen ungern -- geliebter Bitte versagen -- 
  ziehen schnell Finger fügen schön weiß Hand -- 
  Ring Hand siehst -- sprechen -- denk Wort -- 
  Erfülle Wunsch -- aussprech -- 
  stehen Nische Altar -- 
  Ferdinand -- fast wehmütig -- Liebe treu bleiben -- 
  bejahen tausend Eiden -- Wort Liebe -- sprechen -- 
  Denke dein Eid Altar -- rufen -- müssen grausam verfolgen -- Brächest -- 
  Wort Tür -- 
  bitten ebenfalls Zeichen Stunde -- deutet schön golden Locke -- sonderbar wehmütig -- 
  fordere -- Bittend -- währ -- Würdest Liebe verkennen -- unglücklich fühlen -- glauben Wort -- 
  Verschwand Tapetentür -- eintreten -- 
  versucht Tür öffnen -- nachzublicken -- Widerstand Schloß Bemühung -- 
  Erfreut schön Zukunft -- Blick öffnen -- Platz erwachend Gefährt -- weisen Frage verstellt Schläfrigkeit -- Traum Phantasie aufnahmen -- bunt Lust Schreckenbilder verarbeiten -- 
  angebrochen -- Bentheim Gast fragen lassen -- 
  beschämt zweitenmal Abenteuer verschlafen -- Offizier -- Verlegenheit entziehen -- Beleidigte spielen -- behaupten -- Hausherr eitel Furcht necken -- 
  indessen müssen gestehen -- -- Schlaf ungewöhnlich -- unbemerken -- vorgehen -- Unbehaglich Verhältnis größtenteils ausgleichen -- 
  Familie Frühstück versammeln -- bleiben Adelheid Ungeduld -- erscheinen -- glauben ungewöhnlich Bläs bemerken -- 
  fragt -- Folge unruhig Nacht -- 
  Gegenteil -- erwidern lächelnd -- Nacht ungewöhnlich fest Schlaf -- furchtbar Sturm laut gewahr -- 
  Nacht heftig stürmen -- -- fragen -- 
  wahrhaftig -- Baron lachend -- Erwartung unheimlich Abenteuer Sturm verschlafen -- Unerschrockenheit zweifeln -- 
  Prasseln Stein Nähe aufgewecken -- 
  Sturm alt Turm fast eingestürzen -- 
  Ihretwege gering Sorge -- Weg Zimmer -- 
  fallen hierbei Licht -- Nacht Fenster sehen -- erzählen -- willkommen gesellig Schein -- 
  Baron scheinen befremden -- äußern -- Seite Weg Zimmer führen -- fürchten -- Geheimnis verraten erklärt Licht möglich Täuschung Widerschein -- 
  Gespräch gehen Bericht Zerstörung nächtlichen Sturm -- 
  alt Hausofficient -- Namens Hartmann -- erinnern angelegentlich Notwendigkeit -- alt Turm -- vorzüglich gelitt -- herstellen lassen -- Hausherr bedeutend lächeln Zustimmung -- worauf alt sogleich eilt -- erforderlich Anstalt treffen -- 
  Decke Einsturz drohen -- Baron -- Eifer alte bemerkten -- Herstellung eilen -- alt Turm -- 
  mächtig Volksglaube -- 
  Erhaltung Turm -- Gott wissen -- -- binden -- wenigster -- glauben -- Dauer Haus -- 
  Verbindung knüpfen -- wissen sagen -- erzählen -- klingen gehört Fabel ähnlich -- 
  sonderbar indessen -- alt Turm Schwachheit anwandelt -- senken freiwillig -- schütteln Sturm -- -- öfteren Herstellunge ansehnlich Summe kosten -- 
  höchlich Leute verstoßen -- jemals Kosten Reparatur scheuen -- 
  ansehen alt baufällig Gemäuer -- 
  Offizier indessen Befehl Aufbruch bekommen -- verlassen Bentheim Freude -- Forschen Geheimnissen Schlosses unangenehm -- -- wiewohl Grund -- Entdeckung Geheimnisses fürchten -- 
  -- fragt Adelheid neu -- Unheimlich furchtbar Zimmer begegnen -- schaudert Frage unbekannt Schrecknissen -- 
  versichern -- Unnatürlich unangenehme erfahren -- Gegenteil schönsen Bild Traum umschweben -- unbedenklich verrufen Zimmer beständigen Schlafgemach annehmen -- 
  Adelheid bitten -- abenteuerlich Einfall abzulassen -- Versuch -- 
  Vater stimmt Tochter -- Wunsch bestehen -- Entdeckung einleiten -- 
  indessen necken Adelheid Furcht fragen -- jemals unheimliches begegnen -- 
  verneint Frage Versicherung -- Kindheit Gegend Schlosses scheuen -- niemals dorthin wagen -- 
  wissen Weg Zimmer -- fahren fort -- wissen -- 
  Scheu -- Fräulein -- -- genau Weg -- ungefähr geraten erschrecken -- 
  O -- -- erwidern -- sorgen -- 
  gewiß Waghälse Änderung -- Tür Zimmer fest verschließen -- 
  -- wenden -- führen mehrere Weg -- 
  fern Schloß glauben -- bemerken verborgen Drücker Wand -- versuchen -- geheim Tür öffnen -- gefürchtet Zimmer -- 
  bang -- Adelheid -- unmöglich -- 
  Zimmer -- Geschäft -- genau -- verborgen Zimmer führen -- 
  Bentheim bestätigen -- 
  Schlosses -- setzen hinzu -- abgesondern -- bewohn -- sogar Weg -- vorzeien unmittelbar Schloß Kirche führen -- längst ungangbar verschließen -- wahrscheinlich hergebracht Furcht -- 
  sicher Beweis Verbindung Zimmer bewohnt Teil Schlosses -- Gegenteil überzeugen -- indessen fragen -- bloß -- Adelheid Kindheit -- Bild gefürchtet Zimmer machen -- 
  unbekannte unwillkürlich Bild -- antworten -- -- 
  denken Zimmer ziemlich -- öde -- -- 
  denken -- wissen -- Fenster vermauert alt Altar -- 
  irren Phantasie -- fallen Baron -- Dekoration gehören -- bemerken -- einzigemal Leben Zimmer nähern -- General schnell Entfernung begreiflich -- 
  dennoch -- erwidern -- -- Fräulein -- 
  finden Nacht schwer Schirm -- wegrücken -- Täuschung vorbeugen -- Altar Fensternisch -- 
  Sonderbar -- sonderbar -- -- rufen -- 
  erschöpft Vermutung -- hinreichend Erklärung finden -- 
  angemessenster gut Grund vermuten lassen -- brechen diesmal Gespräch -- 
  entfernen -- treffen Hartmann -- groß Eifer Herstellung Turmes arbeiten lassen -- 
  neugierig -- Geheimnisse alt Baues erfahren -- lassen Gespräch -- 
  Anfangs fertigen bekannt Erzählung -- Geschenk unterirdisch Gnomenvölkchen -- Turm eingemauern -- Unglück Familie abwenden sollen -- merken -- Märche -- Menge Schlöss erzählen -- glauben -- 
  -- vertraulich -- gestehen -- Grund geheimnisse wissen -- Zweifel Turm Erscheinung silbern Fräulein Zusammenhäng müssen -- 
  scheinen Verbindung Erfahrung Erscheinung Schlos denkbar -- indessen lassen alte erzählen -- erfahren folgender -- 
  uralt -- Besitzung Bentheims erkaufen -- leben Fräulein Familie vorig Besitzer -- 
  bezaubernd Schönheit -- arge Zauberin -- 
  Zaubere Besitzer geschrecken -- Wahnsinn nahe -- 
  Zauberfräulein alt Turm Verwahrung bringen -- -- Zauberwerk abgelassen -- Hexerei anklagen -- bringen -- Wasserprobe reinigen -- 
  -- Gewohnheit -- gebunden Hand Fuß Wasser Schloßteich legen -- schwimmen -- müssen Beweis Bund Hölle gelten -- 
  sinken -- Beteuerung Unschuld Boden -- Verdacht reinigen -- 
  leblos hervorziehen -- halten Unschuld hinlänglich erweisen -- 
  versagt Begräbnis Gruft Familie bestatten Gang -- Kirche führen -- 
  -- -- finden Grab Ruhe -- verfolgen Bewohner Schlosses -- such Tod Turm Zaubereien stürzen -- Gefängnis verwünschen -- Herrschaft fallen -- 
  Hexenprozeß Erzählung verdächtig finden märch Unterirdische fast passend -- 
  Festigkeit Turmes ruhig -- Hartmann lassen arbeiten -- bauen Werk -- Belagerung aushalten sollen -- 
  Sorge Adelheid -- ungewöhnlich Unruhe bemerken -- 
  Vater scheinen auffallen -- fragen wiederholt Grund Unruhe -- hinlänglich Antwort erhalten -- 
  -- bestürzt -- sehen Unruhe Äußerung Tochter bemerken ahndend Kraft -- 
  mehrere Dienerschaft -- Eltern -- aufmerksam sehen bedenklich -- 
  bestätigt Erfolg trüb Ahnung -- 
  kommen Nachricht Armee -- jung Bentheim Schlacht bleiben -- Bestürzung Schmerz Vater Beschreibung -- 
  einzig Sohne verlieren -- beträchtlichst Gut verfügen -- Aussicht -- Tochter Rücksicht äußere Glück glänzendste Zukunft bereiten -- vereiteln -- 
  wahr herzlich Anteil -- Trauerereignisse Familie -- bringen schön Adelheid nah -- 
  gestehen -- Unglück Familie ahnden -- Bild Gefühl Geist verwirren -- allgemein Vorstellung Unglück fassen -- 
  Nacht -- ehe Trauerbotschaft ankommen -- Bild Bruder Vorstellung vermischen -- 
  fragen -- öfters dergleich Vorahndung -- entdecken -- froh betrübt Ereignis Haus begeben -- mehrere zuvor Bild Ahnung vorschweb -- dunkel verworren Beziehung geheimnisvoll Zimmer -- Ankunft zuvor wissen -- 
  Eigenheit -- schauervoll Verbindung bemerkt Nachtwandel -- ziehen dennoch mächtig schön Adelheid -- 
  ebenfalls Traum Zusammentreffen vorgespiegeln -- scheinen geheim Sympathie unser Schicksale hervorzugehn -- Unterpfand glücklich Zukunft anerkannen -- 
  glauben Adelheid Erwiderung Neigung bemerken -- Eindruck Trauerbotschaft neu -- Unzartheit Liebe sprechen -- Auseinandersetzung Berichtigung nötig -- günstig Aufnahme interessiert Person erwarten -- 
  Erschütterung Turme scheinen prophetisch Bedeutung bekommen -- Bentheim -- wiewohl Sohne Glück abgestorben -- Erhaltung Turmes abhängen -- drang möglich Befestigung alt Mauer -- 
  sonderbar scheinen -- Adelheid Bau ungern einigemal äußern -- 
  -- alt Turm stürz -- Bedeutung verlieren -- 
  alt Hartmann erkalten Eifer -- bedenklich -- 
  Fräulein wissen -- sprechen -- gewiß Bedeutung -- 
  fest glauben dunkl Ahndungvermögen Adelheids -- 
  indessen wachsen Liebe Adelheid täglich -- wagen -- Vater gestehen -- 
  währ Torheit -- Unbemittelt Aussichtlose -- Verbindung Fräulein suchen -- Glanz Bequemlichkeit Leben gewöhnen -- Unglückfall berauben -- gewohnt Art leben fortsetzen -- 
  Rücksichte weder verkenn -- tadeln -- Vater Wahl künftig Gemahl leiten müssen -- Schönheit Liebenswürdigkeit -- verbinden feinst Weltbildung -- übertrug reichlich Mangel bedeutend Vermögen -- 
  fest entschließen -- Baron Entlassung angehen -- 
  Reise Entfernung geliebter gewöhnen -- Vorfall ereignen -- ändern -- 
  Abreise übergeben Baron Band geordnet Papier Rechnung -- Lärm Haus entstehen -- Dienstbot Nachricht herbeiliefen -- Turm -- wissen Zufall -- eingestürzen -- 
  eilen Platz -- alt Hartmann entgegen -- Kästche -- -- Bericht -- zersprungen Mauer Turm verwahren -- 
  ahndet sogleich Schlüssel Geheimnis Turms Behältnis -- 
  Baron verschließen Kabinett -- lassen rufen -- alt Schrift -- vorfand -- durchgehen -- 
  Papier enthielt Geschichte Fräulein -- wovon alt Hartmann Sage erzählen -- 
  Vater Besitzer Schlosses gehörig Herrschaft -- 
  Wunsch -- männlich Erbe hinterlassen -- verleitet Gelübde -- Zuge heilig Land -- 
  Lösung Gelübde Herrschaft sicheren -- überlassen Freund -- Redlichkeit fest baut -- Versprechen -- Rückkehr -- -- Fall versagen -- unmündig Sohne anvertraut Gut zurückgeben -- 
  Urkunden Förmlichkeit -- entferntest Erbe gültig -- aufgesetzt vollziehen -- 
  sicher -- verbergen Fräulein Vater Urkunden Knopf Turmes -- bauen -- Geheimnis entdecken -- 
  Tochter bemerken zufällig Arbeit -- ahndet Wichtigkeit Schrift -- 
  Ritter bleiben Zug Gefecht Ungläubig -- Freund Angelegentlicheres -- eigentümlich Besitz anvertraut Gut setzen -- 
  Tochter vorig Besitzer fordern unmündig Bruder erblich Eigentum Anmaßer -- schützt Urkunden -- Besitz überließen -- leugnet Versprechen Zurückgabe -- 
  lang Streiten besann Fräulein Schrift -- Vater einst Turmknopf verbergen -- -- vorsichtig Geheimnis mächtig Feind preis geben -- verschweigen -- einst Bruder entdecken -- 
  Verdacht -- gefährlich Geheimnis bewahren -- hinlänglich -- verfolgen -- 
  versuchen anfangs Versprechen Drohung -- Entdeckung bewegen -- 
  beschuldigt Zauberei setzen Turm gefangen -- Geheimnis bewahren -- 
  finden Gelegenheit -- Nachricht aufschreiben -- verborgen Ort Mauer Nachwelt aufbewahren -- 
  Bentheim dankt Himmel -- Entdeckung lassen -- Überwindung kosten -- Unrecht besessen Eigentümer zurückgeben -- 
  lassen Turmknopf öffnen -- Papier finden -- -- denken Erstaunen -- Name früh Besitzer Vorschein -- 
  Ahnherr -- 
  Wolf Huwald -- 
  erinnert alt Nachricht -- Herrschaft verkaufen -- Ungläubig bleiben -- 
  finden Zweifel -- Abkömmling einzig übrig Nachkomme Wolf -- 
  Bentheim erstaunt Entdeckung -- sogleich erforderlich Papier Taschenbuch beweisen -- 
  Glückwunsch verbat -- wissen -- -- Reichtümern Welt -- glücklich können -- nämlich Adelheid -- 
  Tochter Erröt bekennen lieb -- verraten Geheimnis -- 
  Bentheim Einwendung schließen beglückn Bund Liebe -- 
  beschäftigen -- Baron Zeugnis Abkunft vorlegen -- dachen Ring -- Adelheid nächtlichen Besuch geben -- 
  sicher Beweis Abkunft -- Baron -- sogar Braut geben -- Hand merkwürdig Stunde legen -- 
  verlangt Erklärung -- fragt Adelheid -- unbekannt Ring Hand bemerken -- 
  wissen -- 
  beschreiben Ring genau -- besinnen -- finden Nachsuchen ähnlich Ring ihrigen -- müssen glauben -- freilich unangenehm -- Ring nächtlichen Wandlerin Weg entfallen -- 
  nah Geschenk erzählen -- 
  Baron Nachricht nächtlichen erschein Tochter Zimmer verlegen -- Adelheid versichern -- niemals -- wissend -- Anfall Nachtwandel -- -- Wissen -- gehen Schlafzimmer Weg Gemach -- Besuch unmöglich -- 
  indessen Sache gewiß -- 
  erinnern möglich Zusammenhäng Nachtwandelns erprobt Ahndungvermög -- bitten -- Weg Fräuleinzimmer genau untersuchen -- finden unbekannt Zusammenhäng -- Ring -- verloren müssen -- 
  Adelheid -- obwohl ungern -- zureden -- gehen -- nebst Baron -- führen -- wüsen -- verschließen gewesen Gang -- 
  schmal Treppe führen aufwärts -- 
  stieß Tapetentür -- Behauptung bestätigen -- 
  Türe führen berüchtigt Zimmer -- gefürchtet Gespenst -- hold Adelheid erscheinen -- 
  Unbegreiflich bleiben -- verschlossen fast eingerostet Türe Nachtwandlerin eröffnen lassen -- 
  Trumm eingestürzt Turme machen vorderen Ausweg Zimmer ungangbar -- nötigen düstern -- unheimlich Weg zurückzuwandeln -- 
  Treppe herabgestieg -- lang -- verfallen -- dunkel Gange umsah -- schreckt Adelheid -- zeigen Wand -- gewahr -- 
  behaupten -- 
  weiß Schatten sehen -- Gefühl sagen -- Grab Nähe müssen -- 
  Baron ausreden -- bleiben -- 
  fallen Grab Fräulein -- Hartmann erzählen -- beschließen -- Zustimmung Baron -- nachsuchen lassen -- 
  Hartmann -- Arbeiter -- begleiten -- 
  finden Mauer Zeichen -- Vermutung bestätigt -- weggenommen Stein Sarg Vorschein -- 
  lassen Decke Sarge abheben -- Bild Traume -- Adelheid's Ebenbild -- bekannt Gewand silbern Stern kleiden -- liegen Sarge -- kenntlich -- Tod berühren -- Gesicht lieblich bezaubernd Schönheit lächelnd -- 
  stehen Adelheid Nacht -- Traum -- Geliebte entgegen führen -- 
  silbern Fräulein -- -- rufen Arbeiter Hartmann -- Ausruf -- Gewand silbern Stern -- Geliebte sehen -- wecken dunkel grausend Ungewißheit -- nächtlich Wandlerin Adelheid -- 
  fallen Blick gefalteten Hand tote -- erblicken Ring -- -- schaudernd -- Braut Sarge verloben -- 
  Zeitlang starr Schreck stumm stehen -- Hartmann fragen -- tote -- 
  indessen Nachtscen lebendig -- 
  Weigerung Erscheinung -- Pfand Treue zurücklassen -- scheinen dunkl Band tote lebend hinzudeuen -- 
  verlangen -- Erblicke Ringe unausgesprochen Wunsch erraten -- bekommen unverkennbaren Sinn -- verfolgt -- verkannt Person -- Sorgfalt Glück verdanken -- einsam Grab -- fern Sarg angehörige erblicken -- 
  erscheinen Schutzgeist Liebe Glückes -- 
  befehlen Sarg Schloß tragen Anstalt feierlich Begräbnis Familiengruft treffen -- 
  Baron billigen Vorhaben -- Adelheid erkannt Sargbewohnerin ebenfalls Tod wohltätig Urahnin Haus -- 
  Begräbnis bleiben Gruft -- Ring betrachten -- zuweilen unheimlich Gefühl erfüllen -- 
  -- Sargdeck abheben lassen -- kurz schön Leichnam Asche zerfallen -- Zeichen -- scheinen -- Ruhe finden -- 
  Woche feierlich Verlobungsfest Adelheid ansetzen -- 
  Ring fertigen lassen -- Scherz Finger Braut prüfen -- entziehen schnell Hand -- O -- bitte -- rufen -- Augenblick Geduld -- 
  schließen Schatulle Ring -- 
  verloren Eigentum zurückgeben -- fahren fort -- bitte -- errat -- aussprechen -- 
  zeigen Hand -- nächtlichen Verlobungring -- 
  -- fragen -- 
  Ring verloben -- erwidern -- nicken bejahend -- 
  sonderbar Verkettung -- -- rufen -- 
  -- unausgesprochen Bitte entgegenkommen -- neu zweifelhaft -- Adelheid -- nachtwandelnder Ebenbild Ring empfangen -- 
  Braut deuten Ausruf -- erzählen -- Ring -- Vermutung gemäß -- Gang finden -- 
  furchtbar Fräuleinzimmer Gefahr Störung bewohnen -- Bauer fürchten silbern Fräulein -- silbergestickt Sternschleier begraben sehen -- gespenstisch Erscheinung umhergewandeln -- 
  Baron erzählen -- Nacht -- falsch Zimmer täuschen -- Gestalt silberglänzend Schleier drohend Stellung Bette sehen -- Nacht wahr Fräuleinzimmer veranlassen -- drohend Miene Erscheinung Täuschung mißbilligen scheinen -- 
  lassen Untersuchung dergleichen Ding ruhen -- lieb -- Adelheid Verlobung Ahndungvermög verlieren -- -- gestehen -- trüb froh Augenblick geben -- 
  kommen bedeutend Traum -- -- Adelheid nehmen -- sehen zuweilen Bild Zukunft -- -- fromm Liebe Abgeschieden danken -- froh heiter Zukunft -- 
  -- Kind -- Wundergeschicht erzählen -- Traume unser lieb Kriegsheld froh Bild sehen -- 
  Trauet Erfahrung -- nah Grenze Geisterreiches anstreifen -- Ding -- 
  hören -- kratzen Türe -- 
  Jäger -- 
  hören Hund -- 
  Vater -- rufen Julie -- Vater -- Bianka's Stimme -- 
  öffnet Tür -- treu Tier freudig Spring Schreien Zimmer stürmen -- begrüßen -- fordern Umkehr wiederkommen -- folgen -- 
  Herr finden -- -- 
  Oberforstmeister lachend -- 
  Bruder Huwald -- rufen Thalheim -- Streiche -- 
  Gestehe_es -- Sohn -- 
  -- Wärst bös -- erwidert -- Überraschung ansehen -- 
  solltest Schnepfenjagd finden -- Walde -- Jäger hergerufen -- 
  Hörner klingen unten -- Erwartet -- Jäger kleiden -- reich Beute Jagd -- treten Herein -- 
  Traum -- Julie -- -- 
  rufen Oberforstmeister froh Umarmung -- 
  Jäger Wildbret -- -- Okuli -- -- 
  * 