bischöflich Stadt Basel leben fünfzehnhunderen jung Bürger -- Namens Johann Wipper -- Handwerk Schneider -- 
  finden Unlust Gewerbe Krieg ziehen -- darinnen Sicherheit Kopf Leben geben -- 
  liebsn reich vornehm Herr -- Hand Schoß legen fröhlich Treiben Mühe Arbeit genießen -- 
  Tag -- festlich Zug Herr Bischof pauken Zimbeln Straße -- überfiel Meister Wipper Unmut dergestalt -- flugs Nadel Schere -- ausraufen -- 
  welch elend Mensch -- 
  indes Tier Walde Vögel Luft gemächlich schön Himmelsblau draußen ergötz Erzbischof Gleich darinn herumkutschen tausendfältig Weise erlustieren -- räucherig Klause sitzen schwitzen Kummertuch nagen -- 
  -- Hochzeitkleid -- fertig -- mahnen glücklich erbärmlich Schicksal -- 
  Ade -- Hochzeitkleid -- schaffen -- 
  hiermit legen Arbeit völlig Seite geraten obendrein Gedanke an Heiraten -- zuweilen Kopf ebenfalls warm -- 
  Junggeselle -- Neigung heilig Ehestande verspürn -- 
  sogar nahe -- 
  nämlich Geselle leben -- verplemperen Hedche -- Tochter Meister -- arbeiten -- 
  hedchen hübsch -- rührig Kind -- bloß -- Eltern häusch Garten -- Geldkast liegen -- 
  Hedchen Wipper Zeit Müßiggang Hang Unordnung vorrücken -- denken Tag -- wahrlich -- Dirne Frau nehmen -- heißen Rute Zeitleben aufbinden -- 
  brechen Vorwand arm Hedche -- Sache Gemüte ziehen -- 
  Oho -- denken -- reicher Mädchen Basel -- Hedwig -- Mühe nehmen ausgehen -- 
  Schalt selber -- tun -- -- faul Zeisig reichen Heirat Ruhe Wohlstand kommen -- 
  putzt Stelle heraus -- Stadt umher -- -- anhaltend Sitz behagen -- 
  Meister Johann klopfen mehrere ehrsam Bürger -- Tochter Mitgift hoffen -- 
  Liebst versehen -- Geschichte Hedche gehören -- Gedanke hoch -- Schneiderwerkstatt hinaus unfleißig Temperament Freier Ohr kommen -- 
  jung Tochter schmuck ansehen Meister vergaßen -- wissen gemeiniglich alt Vater Gedächtnisse darinnen nachzuhelfen -- -- Johann Wipper überall lang Nase abziehen müssen -- 
  Ei -- denken -- Stadtdirne -- 
  Land kernhafter Hauswirtinn -- -- Spiegel freundlich tun -- -- brauchen Hand voll Körbe Wasser springen -- -- 
  benachbart Dorf kommen -- Stadt -- 
  überall anfragen -- Mädchen hart Taler wohnen -- 
  Ursache -- Stadt Körbe zugezogen -- gelten Land -- überdies hiesig rot stammhaft Dirn schlank Schneidermeister Umstand blaß zerbrechlich finden -- 
  Abends wild übel aufgeräumt Dachstübchen -- 
  letzter -- vertrauen baldig -- reich Heirat -- Arbeit Überfluß gehalt Kundschaft einbüßen -- 
  stehen Schneidertisch -- wenigster Notdurft liefern -- -- papieren Maß -- höhnisch Frage scheinen -- selber anfangen denken -- 
  Bestellung -- brummen -- zuletzt Brief Tisch entdecken -- 
  Brief Hauswirte -- darinnen unfein schuldig Mietzin mahnen -- folgend Früheste Geld Empfang nehmen -- -- saumselig Zahler Haus werfen -- schlecht geraten nebst Werktisch zurückbehalen -- 
  hinzufügen -- 
  hälf Nachsicht liederlich Wirt -- Gewerbe zuliegen -- Irre herumläuft Dieb Mörder -- nebst Bisschen einziehen -- 
  Handwerk golden Boden -- Müssiggang Laster Anfang -- -- Meister Wipper aufbringen -- Brief sogleich Zähn zerriß -- Schere Hand -- sehen -- wohlgetan -- sterben -- 
  -- fast schwer -- leben -- fremd Blut sehen -- -- 
  Seil -- Winkel hervorlugen -- Anblick ersparen -- 
  denken Halsschmerz -- verursachen verwerfen Ausweg -- 
  fallen Hoffnung -- Entdeckung Schatzes -- 
  ernst Wille -- -- -- -- rufen -- wahrlich allerernstest Wille -- Schatz baldmöglichst aufzufinden -- -- 
  wendet Gedächtnis -- reichen Heirat gleichfalls ernstlich -- 
  indessen verlieren -- wagen -- betrüben Lage Gedanke Gast -- ungestüm folgend ankündigt -- leidlich Schlaf Aussicht geben -- Wanderstab Hand verlassen abermals Haus Stadt -- 
  frei Feld fallen -- rein Mutmaßung -- eigentlich Schatz -- Blindlings losgehen -- finden -- 
  gehören -- dergleich gemeiniglich Erde liegen -- weder Tau Regen treffen können -- 
  setzen -- Stück Boden finden -- überall vergebens umhersehen -- womit Schatz heben -- Grabscheit -- überdies -- Gedanke -- gewiß -- besonderer Gebräuch gehören -- gänzlich unbekannt -- 
  fallen Mühlstein auf's Herz -- Überlegung anfangen -- Rheinstrom dicht -- unfehlbar hineingesprungen -- denken -- erstaunlich Unterschied -- Rheinlachse essen -- essen lassen -- 
  Furcht letzt Ereignis -- 
  Höhe blicken -- stehen plötzlich Berg -- 
  Berg Eingang -- -- eisern Türe wohlverwahren -- 
  Meister Wipper erstaunen -- lang betrachten -- 
  nämlich Gegend -- sagen -- auswendig -- Berg eisern Türe gewahrt Mal -- 
  -- meinen -- gehen Ding -- glauben -- Berg bloß seinethalben hingestellt -- 
  verzweifelen indessen -- Scharfsinn Weg hinein finden -- eisern Türe selber Auftat -- 
  Rat zuvor teuer -- er_es -- 
  tausend Frage -- worauf Meister Wipper Hineingeh Antwort -- z. B. Berg hingestellen -- Gast darinnen behandeln -- 
  unzählig Kerze erhellt Gewölbe -- entdecken -- schön sauber -- ausraufen -- -- häßlich -- unsauber Geist unmöglich hausen -- Wenigkeit verschmähen -- zeugen Aufspringen Türe -- -- hell Vollmond scheinen -- Gegend Mensch erblicken -- 
  Himmel Name -- 
  gleichwohl Schritt Höhle hinein Seite -- irgendwo Unheimliches Anzug -- 
  bang Klopf Herzen gewiß hinaus Nacht erklung -- Schlotter Knie überboten -- 
  gewölb Rücken -- künstlich Sonnenstrahl beleuchtet Garten gelangen -- Maler schön mal vermochen -- 
  Blume Frucht Jahreszeit Weltteil -- -- fast wissen -- geschehen -- Tasche Aprikose -- Kokosnüsse -- Anana köstlich Eßwaar ziemlich vollgefüllt -- denken -- Erlaubnis geben -- 
  Zweifel stehen -- gute -- Hasenpanier ergreifen -- -- fallen Marmorpallast Auge -- heraus treten Jungfrau -- wunderschön -- bezaubern Dastand -- schwerlich Stelle -- unbeschreiblich Milde angesichts -- 
  Jungfrau tragen golden Krone Haupt -- Glanz hellgelben Haar ringsherum übertreffen -- 
  Meister Wipper Begriff -- Fuß fallen -- tausend Schrecken bemerken -- dergleichen lassen -- maßen Jungfrau Füße -- Leib -- zeith gewaltig Schönheit Antlitzes entgehen -- häßlich Schlange ausgehen -- mehrere Ringel aufrollen -- 
  Schrecken verschwinden -- Stimme -- lieblich Klang Harfe -- anreden -- 
  Gott Gruß -- Fremdling -- 
  ansehen bemitteln -- 
  Gut ermangeln -- nimm Willkommen -- 
  fassen Hand führen eisern Truhe -- 
  Fürcht -- -- Lärm -- Paar liegend schwarz Ungeheuer erheben -- Schneider Gewalt loszureißen suchen -- 
  still -- rufen Ungeheuren Augenblick Lämmer -- schwänzelen Meister herum -- -- trotz gut Anschein -- Rücken frei halten suchen -- 
  Jungfrau Deckel Truhe aufheoben unübersehlich Vorrat funkelnagelneuen hart Silbertaler Schneider liegen -- dacht Gedanke -- 
  Himmel -- Gefallen Einraffen dürfen -- 
  denken -- bekommen Erlaubnis hierzu -- 
  Meister faul stopft Tasche voll -- wobei ärgeren -- Frucht -- belad -- groß Raum einnahmen -- -- vorteilhaft -- Silber anfüllen -- 
  gleichwohl scheut -- zeigen -- ungebührlich Weise abbrechen -- 
  Tasche übervoll -- bemühen -- Taler hinein pfropfen -- Jungfrau -- 
  Maß -- Freund -- Plätzchen überbleiben -- 
  Meister Wipper versetzen lachen -- 
  Sorge -- lassen -- 
  Raum Tasche euer köstlich Silbermünze abtreten -- 
  Gefallen -- sprechen Jungfrau -- hüt Haus Garten genommen Vorsatz wegzutun -- verlieren -- 
  Erdgeister -- Raum ärg schalten -- legen dergleichen Verachtung Vernachlässigung können abnehmen -- ehe Gebiet verlassen -- -- 
  hierauf führen Truhe -- abermals schwarz -- schnaubend untiere liegen -- -- -- flugs zehmen demütig -- 
  erschrak Meister Wipper -- Deckel aufgehen eitel Goldmünz entgegen glänzt -- Jungfrau Erlaubnis -- silbernen -- erteilen -- 
  arm Schneider -- 
  Lebelang Gold Name Ansehn -- vorhin denken -- allerwenigsten -- gewachsen können -- 
  Warnung -- Silber allzusehr übernehmen -- Wind schlagen -- 
  Tasche fassen -- -- -- Fäuste -- 
  Gräm -- hierauf Jungfrau -- Gedanke Miene erraten -- 
  Schatz nächstens -- 
  -- rufen Schneider -- Freude bringen Vergessenheit -- Arm Leib Gönnerin legen -- 
  Hieb Schlangenschwanze schreien sogleich Schmerz laut -- lassen Goldstücke Hand fallen -- 
  Kribbelte Wibbelte Ringsum Erdgeister -- grimmigst Gebärde zurannten -- gebieterisch Wink Jungfrau augenblicklich jagen -- 
  Gebot hierauf verloren Goldstück sorgfältig sammeln -- Abwesenheit Gewalt auslassen möchten -- 
  fügen -- indes Befehl ausrichten -- hinzu -- -- -- -- Gesindel Meister -- 
  mußt wissen -- Tochter gewaltig König -- 
  fremd Prinz werben Hand -- erfahren -- Liebeshändel -- Trug List Weiber umging -- schlagen -- 
  Unglück Zauberer -- hierher entführen Verwünschung unter Hälfte Leib abscheulich Untier umwandeln -- 
  Gestalt elende verweilen -- entschließ -- Hand geben rein Junggeselle dreimal küßen -- 
  Nacht Vollmond stellen gewöhnlich Berg hinaus -- eisern Türe Haus führen jeder Mal aufgehen -- sobald Unverheirateter nahet -- 
  -- jung Leute -- 
  teils machen Versuch -- berechtigen -- teils warnen lassen -- 
  Solltest ebenfalls Lust Lösung Zauber bezeigen -- -- -- voraussagen -- Reinheit Ehrlichkeit deiner Junggesellenstandes gehörig Obacht nehmen -- Versuch vermeiden -- Ungelegenheit zuziehen können -- 
  -- versprech Hand Herz falls Richtigkeit -- 
  welch Stande mögest -- Purpur decken Niedere -- Erbin ungeheuer Reich -- sogleich erfolgt Entzauberung Gemahl erheben -- 
  Schneider Freude -- -- Prinzessin Kist Kast Krone Thronen -- 
  glauben nämlich -- erforderlich Reinheit besitzen -- sogleich Anstalt Kuß -- 
  verbat zuvor Einmischung Schlangenschweif -- 
  Besorg -- antwortet Prinzessin -- 
  vorhin geschehen -- Bestrafung Vorwitz -- 
  -- ernst Ding gelten -- getrost Werk schreiten abschrecken lassen -- Widrig Kuss wahrnehmen solltest -- 
  hierauf neigen Meister Wipper Demut Bescheidenheit Lippe Mund hinüber -- 
  Natur unterer -- tierisch Teil Leibes -- plötzlich menschlich Oberen übergehen -- verziehen Kusse Gesicht Prinzessin -- 
  Mund -- ähnlich -- Auge schießen Tigerblicke -- schlagen Hand Kralle Schulter Küssend -- Zuflucht andächtig Vater -- Seele sicher -- Leib geschehen -- 
  vollbrachtem Kusse Dame vorig liebenswürdig Wesen -- 
  freut Station Erlösung zurücklegen -- äußern Seufzern Wunsch -- ebenfalls glücklich überstehen möchten -- 
  Meister Wipper -- sanft -- hold Zug Gesicht betrachten -- schalt Furchtsamkeit hierauf Kus Vorbereitung -- 
  mal Geist Ungeheures menschlich Hälfte Dame verbreiten -- Fall -- 
  Perlenreih Mund scheinen dreimal fletscht Gesicht herüber -- 
  rissen Hand arm -- totenbleich Schneider dergestalt -- Pflaumenbaum -- Riese schütteln -- dasmal wissen -- Kuß vorüber Zeitliche Ewig verwechseln -- fallen tief Ohnmacht -- 
  -- ergötzen Anblick lieblich Angesicht auf's -- 
  überstanden Schreck zucken allzu heftig Glied fallen Ungelegenheit -- Dame drohen -- Unwürdiger -- 
  denken Schneider -- Kus schlimm -- fürchterlich Anblick Rachen Wut -- zusammenrütteln -- Gedanke Leben -- 
  Wut Mal wiederum steigen -- bleiben übrig -- zerreißen -- 
  Ungelegenheit -- ungelegener schwerlich -- böse -- schnell Tod -- 
  übersann zeitig Leben finden -- Erfordernis -- rein -- ehrlich Junggeselle -- verschieden Auslegung erleiden können -- 
  Fall nämlich Reinheit Gesinnung Anschlag bringen -- -- 
  Hedche gegeben Wort halten -- 
  freilich bloß Furcht Ordnungsliebe gewöhnlich gerecht Vorwurf Mädchen -- 
  Sache bleiben indessen -- Grund -- -- 
  kränken tief Seele -- Glück Hand lassen -- 
  -- denken -- Prinzessin wehmütig -- Ade -- Allerschönste -- 
  Eurer Ungelegenheit allzuarg Floh Ohr setzen -- 
  -- beginnen Prinzessin wein wehklagen sprechen -- -- lose Knecht -- fürstlich Lippe Mal entweihen -- Fühltest -- Werk ausführen -- 
  -- erheben denken -- tief erniedrigen -- 
  -- -- 
  Schneider Furcht -- Träne Vorwurf Schöne können Kus verlein -- eilen schnell hinweg -- letzter Frage Ohr drang -- 
  froh -- -- Tasche Hand voll -- hübsch Einrichtung anfangen Geselle halten -- arbeiten -- mir_es Welt lassen -- 
  er_es ausgeredet -- herum erschrecklich Getümmel -- höchstens Spanne lang -- Leutche entstehen -- Goldstück -- Meister vorhin Wiederaufsammel verlorener übersehen -- Auge halten -- Verachtung unterirdisch Schatz zieh Rede setzen -- 
  Meister Wipper freilich vernünftig Vorstellung -- 
  gehen Bürschche Ohr hinein -- heraus -- 
  bestehen -- Barschaft Garten Genommene zurücklassen -- hierzu gutwillig verstehen -- arbeiten Seite hinauf -- Kletterstange -- 
  kni Wade -- indes Tasch Schulter kroch Kratzt stoßen -- 
  abgeschüttelen -- sitzen drückt zwickt krallt hämmert arm Kreuzträger -- Schmerz laut aufschreien müssen -- 
  schrie -- desto Geschmeiß rannen herbei -- Spaß nehmen -- 
  Ständen Alter Mensch Oberwelt beschaffen -- überaus -- winzig -- Statur -- 
  peinigt ritterlich Tracht -- Nase riten Seite Spore einhieb -- an Welt reisen gedachten -- 
  Meister Wipper schütteln soviel -- Kerlchen sattelfest Anderer scheinen Leben Art reiten betreiben -- 
  Schneider -- Angst Ziel wissen -- werfen hoch Verzweiflung sämtlich Goldstück Hand -- leert Tasche völlig -- 
  lassen Leute -- machen Krahfüß -- wünschen Leben schlagen durchdringend Gelächter -- Meister Wipper hören -- atemlos erschöpfen gewöhnlich Welt zurückgelangen -- Mond Sonne Platz -- 
  hause bekommen Schneider hart Kampf Wirt -- Woche vertrösten lassen -- Einsah -- Gerät Schuldners lösen -- 
  wovon Zahlung -- wovon leben -- 
  Verzweiflung Pein Leute -- nebst geschenkt Geld -- Bisschen übrig -- Barschaft weggeworfen -- 
  Verlust -- verbinden Merkmale ausgestanden Marter Körper Sporen aufgerissen backen überzeugen -- Begebenheit bloß Traum -- wofür halten -- 
  -- trostlos Zustand bedachen -- verwünschen tausendmal -- Kuß wagen -- 
  Trau -- rufen -- selber zerreißen Hasenherzen -- zugefallen -- 
  Gott -- niemals Gedanke geraten -- trübselig Schneiderhandwerk erlernen -- 
  Nadel -- scher Bügeleisen scheinen Fluch wachsen -- Weg Glücke vertreten -- 
  Mann wunderschön Fürstin -- 
  stehen feige Schelm -- Leben wagen -- -- schand -- Elend Kerker behaupten -- 
  Gedanke Meister tiefsinnig nächster Vollmond einzig Hoffnung -- Herz fassen -- Berg aufsuch Kuß Stande bringen -- 
  inzwischen -- Mund teils Borg -- teils bekannte durchbrachen -- 
  Bild schön Prinzessin stehen Bette -- Nacht anbrach -- leidhaft Prinzessin Stelle Bilde treten -- 
  unverrichtet Sache abziehen -- predigen starkklopfend Herz Aufhören Tugend Mut Laster Feigheit -- 
  trotz rieselen -- ausgehen -- Höhle aufsuchen -- ziemlich stark Schauer Glied -- 
  Leute besorgt -- neulich -- sogleich Empfang unterirdisch Gut -- Weg gehen -- desto fürchterlich stellt Gebärde Prinzessin Kuß -- 
  überwand Scheu wohlbekannt Gegend -- 
  -- Berg eisern Türe -- 
  Nirgends entdecken -- glauben müssen -- Prinzessin völlig verlieren Verzweiflung trostlos -- hülfsbedürftig Lage Zauberer heiraten -- Schlangenhälfte angehext -- 
  Meister Wipper stehen wiederum Fleck -- worauf Kurzem verschiedentlich befinden -- 
  benachbart Buch strecken stark Nebenast tief Erde herab -- gut Leben Arm reichen wollen -- 
  Schnupftuch Hand nehmen Hals geschlung -- bang Herz Entschluß gewöhnlich entzweischlagen -- 
  dasmal Umstand hinderlich -- Entfernung lachen Leute vernehmen glauben -- worin Tod bestärken -- 
  Bedenken -- dergleich leichtfertig Gesindel Schlafe Mensch oftmals stark Einfluß äußern -- legen Gras nieder geraten Ermüdung ziemlich tief Schlummer -- 
  träumen -- unterirdisch Prinzessin wissen Zufall Schlangenschwanze -- Hand vermutlich Schein -- Bein bekommen Liebe Höhle verlassen -- Hedchen Anzug zeigen -- -- gefürchtet Kuß erleichtern -- 
  obschon Sache Garte Hedchen Eltern vorfiel -- Mädchen Prinzessin Zug verleugnen -- bezeigt Unwille -- Meister vornehm Name nennen -- -- wofür ausgeben -- sehen -- Anrede ungehudelt lassen -- 
  Aha -- denken Schneider -- vermutlich prüfen -- selber hoch Stand liebesen -- -- Hedwig -- vollbrachen Kuß glücklich -- drang baldig Trauung -- 
  groß Rätsel finden -- Hedchen Eltern kommen -- Sache gutmütig gefallen lassen Komödie Anstoß mitspielten -- Prinzessin Mensch -- Hedwig -- 
  Hochzeitfest Meister Wipper führen Braut Abend gering Wohnung -- 
  folgend -- erwacht -- plötzlich verwandeln Prinzessin Fürstenpracht -- ebenfalls reich Anzug Mensch -- 
  hoch -- weithinlaufend Wand glänzt Gold Elfenbein -- Wort Prinzessin -- 
  -- hänschen -- zufrieden -- 
  Antwort Augenblick erfolgend Aufwache ersparen -- 
  köstlich Aussicht finden Buch -- Leitung besseres Leben vorhin beinahe annehmen -- liegen -- Zustand fern ändern -- immittelst angebrochen -- 
  Traum indessen Meister bedeutsam -- sofort entschlagen -- 
  -- trösten -- Glück Traume Weg zeigen -- worauf finden denken -- Versuch Wink wert -- 
  Hedchen Eltern freilich zerfallen -- sicher Auge machen -- Schwelle betreten -- 
  Meinetweg -- 
  Traum gelogen -- vorbereiten -- -- gerade Weg wohlbekannt Garten -- 
  Astloch Brettwand sofort -- Wunsch verhieln -- 
  leibhaft Prinzessin Hedwig Anzug Laube sitzen stricken -- 
  frisch Andenken -- übel hoch Person Traume nehmen -- sogleich Hedche halten -- -- Verdruß Wachen ersparen -- hinein -- Gute -- schön Hedche -- 
  alt Liebe rosten -- kommen -- Vergebung bitten -- 
  -- versetzen Mädchen -- allerwärts herum fragen überall lang Nase abgezog -- Hedche -- 
  -- Schöner -- nimmermehr -- 
  Ei -- dachen Meister Widder -- spielen Hedche Anstoß -- -- kennt Gesicht allzugut -- selber Irre -- 
  fest überzeugen -- Prinzessin -- desto leicht süß Wort -- Mädchen -- trotz gegeben abschlägig Antwort -- anderer Sinn -- alte einführen -- vorschlagen -- früh Unbilden Erwähnung -- -- 
  Meister Wipper wohlgemut Haus ankommen -- dasmal -- 
  Ade -- dachstübchen -- ade -- traurig Schneidertisch -- rufen -- 
  sehen Ziel Wunsch -- Hand verhaßt Nadel Scher entran -- Ziel beschleunigen -- lassen eher -- Aufgebot Kirche geschehen Vorbereitung treffen -- 
  Hedwig Eltern scheinen -- verwandter bekannte -- wissen -- anderer Mädchen -- Tochter -- Bräutigam Vermutung unfehlbar Zauberkräft einstweilen Haus führen -- 
  Meister Wipper Wunder -- Prinzessin Abwesende aussehen -- 
  Betragen wissen Schneiderstochter völlig zeigen halten Bräutigam Unfleiß -- behauptend -- Ehemann anderer Mensch müssen -- 
  freilich anderer Mensch -- pflegen lächelnd sagen -- erwarten -- kommen -- 
  -- Hochzeit Kraft Schneiderfamilie -- Wipper Abends Braut Behausung anlangen -- freuen kindisch Erwachen Verwandlung folgenden -- 
  -- Desto groß erstaunen -- -- scheinen -- Gelächter Schlafe aufschrecken -- Morgendämmerung Dachfenster Schneidertisch -- Wort -- 
  alt Elend herum erblicken -- 
  Gelächter scheinen sogar zuzunehmen draußen Dach Hereinzukommen -- 
  sogleich springen Bette Fenster -- 
  Wort -- Prosit -- Ew -- fürstlich Gnade -- draußen entgegenschollen -- Stimme nämlich Mann -- Ritt Nase ewig Andenken bleiben -- deutlich Übrig unterscheiden -- gewahrt Mindest -- 
  unstreitig Leute Nebelkappe -- worin sterblich Auge entdecken -- Dach klettern -- 
  lachen schwatzen meinetwegen -- 
  rufen Meister Wipper -- werfen Fenster legen Bette -- Meinung -- neckisch Gesindel früh aufgewecken -- glücklich erwachen folgen -- 
  eingeschlafen -- heftig Rütteln Körper fahren -- 
  -- Siebenschläfer -- rufen Frau -- Festtag vorüb -- Arbeit -- 
  raffen Meister Wipper jähnend rieb Auge -- Mund bleiben stehen Schlafmütze fallen Schrecken Hand -- Zweifel verschwinden -- -- Prinzessin -- Hedche selber Frau bekommen -- 
  begriff Lachen Kobolde -- auf's draußen vernehmen lassen -- völlig -- 
  Traum zugeschicken -- Wachen Auge Betörung halten -- Hedch -- wahr Gestalt sehen -- fälschlich verwünscht Prinzessin vorkommen -- 
  müssen ergeben -- Sauer -- 
  Arbeit Hedchen Vater sorgen Neuverehelicht ruht rasten -- hermacht alt Arbeitsscheu aufgeben -- 
  streng Hausregiment führen freilich -- 
  Meister Wipper Folge einsehen -- -- zuvor -- befinden -- Arzt schwerlich Ordnung bringen -- vergeben Leute -- Prinzessin -- pflegen Frau lieb Hausehr nennen -- Ehre Haus Leben retten -- 