-- Sündflut Prinz -- Hof Kindesbein vorsagen -- Folge charmant regieren -- gerne lassen -- 
  König Huldibert -- Vater -- berühmtesten Professor berühmtest Universität Welt Bildung holen lassen -- Prinz Häckerling Gelegenheit -- entgegengesetzt Idee -- Begriff -- System -- Meinung sonnenklaren Beweis tot lachen -- künftig Bestimmung eingedenk -- 
  zwölften Weltwund -- müssen schön Kunst herhalten -- 
  währen -- tanzt damalig Vestris -- komponieren damalig Haydn -- Poesie betreffen -- damalig Götte Schule -- 
  obendrein Ausbund Schönheit -- Reich -- Erbschaft bevorstehen -- Glanz Größe Reiche umher übertreffen -- müssen Liebe blind gewöhnlich -- Jagd -- 
  benachbart Prinzessinn Ruhe lassen Vätern Ruhe -- 
  schön Prinz Auge -- Not tun -- gut Vater Thron Meistbietenden verkaufen Huldibert Hof privatisieren -- 
  benachbart Prinzessinn miteinander König Huldibert berühmt vornehm Sohn -- 
  Verheiratung Prinz Häckerling einzig Rücksicht -- 
  scheinen Stolz königlich Paar Schwiegertochter tauglich -- Thronerbin hunderttausend Meile entlegenen ungeheur Reich -- Schönheit Ruf Stadt Stadt -- Land Land -- König Huldibert Schloß ausposaunen -- 
  König Königin entdeckt Prinz -- würdigen Vermählung allmählich -- Wahl fallen -- 
  Prinz fest Glauben leben -- Natur expreß Ideal aufwachsen lassen -- überdrüssig warten -- lassen übel böse fallen -- Gesandtschaft Hof Königs Isegrim geschickt -- Tochter -- bezaubernd Isola -- Gemahlin abholen -- 
  entsetzlich Gesandtschaftspersonal ernennen equipiern -- Hofnarr naseweise Frage aufwarf -- lang Reise hunderttausend Meile zweimal wollen -- 
  Mensch einfallen -- 
  ehe schwerfällig Gesandtschaft König Isegrim anlangen -- Prinzessin Isola längst verheiraten verstorben -- Fall ledig lebendig finden -- gewiß unscheinbar eher König Huldibert Hofe -- König Gemahlin längst Vätern Mütter versammeln -- 
  Ruf -- Isola's Schönheit hergebrachen -- Flügel -- ansehnlich Zug borgen -- Jakob Degen Flugmaschin Atem denken -- 
  Frage zerbrach Mal Könige Staatsrat Köpfe -- allgemein Achselzuck Erfolg qualvoll Nachtwach -- 
  Sache -- Preisaufgabe -- gesandter Sekretär weniger Woche König Isegrim hin -- glücklich beendigt Auftrag -- Prinzessin Gesandten -- schaffen -- 
  unmöglich Sache scheinen -- desto hoch Preis setzen -- versprechen König Huldibert glücklich Spediteur reizend Tochter -- Prinzessin Floribella -- Gemahlin -- 
  straßenecken Zeitung Floribella Weise ausgeboen -- unbefugen Schriftsteller -- Wohlfeilheit dergleichen Preisaufgabe vorlauen auslassen -- Ohr nehmen -- Mann -- vorig Regierung Land verweisen -- Seele denken -- Versprechen -- Königs Wille ausführen -- sicher Geleit ansuchen -- 
  Grund Mann damalig Landesverweisung liegen Paar Siebenmeilenstiefel außerordentlich hervorstehend Höcker -- womit Brust Rücken versehen -- 
  Mittel Stiefel betreiben nämlich Botenlauf außerordentlich -- obendrein lebendig Postkalesche -- Höcker satteln verstehen -- vorn hinten Passagier reiten -- 
  Reisemaschin aussehen -- gewährt reisend -- Ort Stelle -- unleugbarst Vorteil -- Mann -- Name Höckerlein -- Kunde -- fördern -- hundert Höcker hingereichen -- 
  gesamt Publikum gewinnen -- verlieren einzeln Innunge Gewerbe -- 
  leiden z. B. Roßkämm -- Wagner -- Landkutscher Schmied gewaltig -- Schuhmach Einbuße -- Höckerlein Siebenmeilenstiefel vortrefflich zusammengezaubern -- niemals besohlen ausgebesseren -- 
  minder Höckerlein schneidern Sattlern Dorn Auge -- Kleid Sattel ungünstig Geselle lassen -- günstig Leute einrichten -- 
  Gastwirt murrn laut -- üblich geworden Riesenschritt Mensch einkehren -- 
  weiber schwanger -- Höckerlein Land herumgingen -- 
  fürchten nämlich -- Höcker versähen -- gewiß Nase geschehen -- unförmlich -- gar_nicht aussehen -- ordentlich Kuß geben vermöchte -- 
  murren Menge Gewerbe dauern geraume fort -- Zollbedient Postmeister Beschwerde einreichn -- Hand Fuß -- 
  Post Mietpferde Grund Höckerlein Gehör finden -- Mann Urtel Land ewig verweisen -- 
  König Huldibert schwanken Augenblick -- Höckerlein jetzig erbieten annehmen -- 
  Mißgeburt unmöglich schön -- sechzehnjährig Prinzessin geben -- 
  Hoffnung -- Mann -- ohnedies inzwischen alt müssen -- ungereimt Ding prätendieren -- Reichtümern Titel abfinden -- lassen König Geleitsbrief ausfertig abgehen -- 
  Prinzessin Floribella fallen Ohnmacht -- Höckerlein Schlos einstellten -- König reden folgend Maße -- 
  Höckerlein -- denken eurer bewußt -- wichtig Sache bedienen -- versprech -- eu Wort erfüllen -- Prinzessin Isola hiesig Schloß ankommen -- paar tüchtig Hand voll edelst Edelsteine paar hundert schön Rittergüter -- 
  sollen Oberreisemarschall Hinfüro jedermänniglich ansehen -- eur Belieben stehen -- Qualität Dienst leisten möget -- 
  sehen -- Mann bildschön Prinzessin Haus -- 
  antworten Mißgeburt -- -- Herr König -- sehen -- 
  glauben vielmehr -- gerecht Natur enorm Häßlichkeit nächster Anspruch Frau enorm Schönheit geben -- 
  wahrlich -- keineswegs gesonn -- selber Fuß treten -- 
  -- bedenken -- versetzen erschrocken König -- Tochter Ohnmacht fallen euren Anblick -- geschehen -- eu Weib -- 
  hiervon Tigertier rühren -- erwidern kaltblütig -- Prinzessin allmählich Häßlichkeit gewöhnen Stachel ansehen -- schön Rose zuteilen -- 
  Schönheit Urteil Spiegels vergessen -- fügen hinzu -- Spiegel Häßlichkeit vergessen -- Ordnung -- 
  König -- kecken grausam Rede gewaltig betrübt -- versprechen möglich Prinzessin -- obendrein schön gut Wort -- 
  Höckerlein bleiben -- Prinzessin verlangen -- 
  Huldibert entlassen hierauf Weisung -- Stunde -- berufen Staatsrat -- 
  Achselzuck geben -- verdroß -- Stelle abdanken -- 
  freilich bleiben königlich Wort -- derjenige -- bewußt Sache ausführt -- Prinzessin Floribella versprechen -- destowenig Straßeneck Zeitung stehen -- 
  Gesandte Ausweg finden -- 
  König nämlich Höckerlein immerhin Prinzessin zusagen -- Sekretär -- vorläufig bestimmen -- Sättel Siebenmeilenstiefler einnehmen -- gedacht Erfüllung Versprechen hintertreiben -- 
  Sekretär nämlich unterwegs Höckerlein Brüderschaft -- Ort Bestimmung Rückreise dreitägig Schlaftrunk beibringen -- Schlaf Siebenmeilenstiefel ausziehen -- niemals ablegen pflegen -- 
  geschehen -- Sekretär Körper paar ähnlich Vorsprüng -- Höckerlein Natur erhalten -- Kunst anfertigen lassen -- Rückreise schlafend Platz gänzlich einnehmen -- 
  mißbilligen König -- Sache betruge beruhen -- außerordentlich Wohltätigkeit Betruges anschaulich -- lassen sich_es fallen -- Drang -- Menge Kostbarkeit Höckerlein -- Entschädigung -- zurückgelassen -- 
  Verlust Siebenmeilenstiefel weit Rückreise Leben unternehmen -- König Familie gesandter vollkommen einig -- 
  Reiter Pferd Kostbarkeit Gesandtschaftszuge tragen -- König Isegrim sogleich schließen können -- würdig Hand -- worein Hand Tochter Isola legen -- 
  Höckerlein selber köstlichst Zeug kleiden -- Sattel gesandter seltenst Perle ausgeschmücken -- 
  gesandter Naht Kleid brillanten besetzen -- Sekretär Rubinen Smaragde überschütten -- tragen überdies herrlichst Edelsteine gefertigt Blumen Früchtestrauß -- Geschenk Prinzessin Isola -- ungeheur Brillant Karfunkel schwer -- Minute Hand halten -- 
  Ambassade Ohren ergötzen -- heftet Sekretär -- ungefragen -- golden Schelle -- Gesandte Höckerlein tief Demut verbeten -- 
  Höckerlein -- Last zurückfiel -- ächzt -- Kraft -- Zauberstiefel versahen -- abscheulich -- Reise fort unermeßlich Reihe aufgesperrt Nasen Mäuler hindurch -- Ehre Hoffnung spornen -- Äußerste -- Bürde Ort Stelle glücklich anlangen -- 
  Geschäft reüssiert Erwart schnell -- 
  köstlich Blumen- Früchtestrauß entzücken König Isegrim -- 
  gebot Tochter -- Prinz Häckerling fallen -- Verlauf gesandter bevollmächtigter antrauen -- 
  Glück hoffnungreichsten Blüte -- 
  Prinzessin Begriff schön -- Vater versprechen Umstand -- Heckerling Erstgeborenem Thron anhängig -- 
  bleiben übrig -- Sekretär Geschäft Siebenmeilenstiefel -- 
  mehrere gar_nicht vorwärts -- 
  scheinen -- Pferdemetier -- Höckerlein widmen -- ächt Pferd Natur verhelfen -- Schlaftrunk schlagen -- Portion verdoppeln verdreifachen -- 
  gesandter Angstschweiß -- Unglück Höckerlein Rückkehr ungnädig Blick denken -- König Huldibert Gemahlin Tochter -- abwerfen -- 
  gelingen Sekretär Vorhaben -- Siebenmeilenstiefler Zank mehrere Lastträger verwickelt -- freimütig Demonstration zusetzten -- körperlich Müdigkeit Wirkung Schlaftrunk Hülfe -- 
  Gesandte Entzück -- Sekretär Mitternacht Siebenmeilenstiefel hereintreten -- 
  Befehl sogleich berühmt Mechanikus geschickte Sattler Residenz Schlafe pochen -- Sekretär Maß nehmen Sattel Zeug verfertigen -- 
  Ambassadeur Höckerlein bequem sitzen -- bestellt Sitz -- Gestell Sekretär abgeben -- Viertelelle lang breit -- paar golden Lehne Anhalt -- 
  suchen unwillig Gesicht Sekretär Vorstellung unbeschreiblichen Ehre -- widerführen -- gewöhnlich Falte bringen -- 
  Tagesanbruch begeben gesandter Monarchen -- Eile erfordernd Umstand -- erlangt Erlaubnis -- Nachmittag schön Isola abreisen -- 
  Verhinderungsursache kommen -- Mechanikus Sattler Galgen Haustüren setzen -- 
  nämlich herannahen Mittagsstund allaugenblicklich vorhalten -- Galgen andeut -- Glockenschlag zwölf unfehlbar hängen -- Sitz Sattel zuvor fix fertig sein -- 
  Stunde Uhr Galgen weggenommen -- Sitz Sattel obendrein sinnreich schön finden -- Mechanikus Sattler Gefahr laufen -- Hexenmeister verbrennen -- König diesmal Auge zugedrücken -- 
  einzig Bedenken waltet Sekretär äußerst solide massiv Arbeit ertragen -- 
  gesandter warten Ungeduld -- König böse -- Pünktlichkeit Mechanikus Sattler eingeschärfen -- 
  überein -- Sekretär Verbrecher sond Gleich -- schicken Leute -- greifen Siebenmeilenstiefel samt Bein -- erwarten lassen -- -- Leib schneiden -- 
  Leute kommen unverrichtet Sache -- 
  Sekretär nämlich reiflich Überlegung -- zeith ärgerlich Last tragen -- jetzig Übermaß Gang Berg schützen -- Siebenmeilenstiefel Promenade Hand benutzen -- 
  sitzen Prinzessin gesandter -- Sekretär Lachen Steckbriefe -- erlassen -- vorkamen -- Herde Schnecke -- Hase einholen -- 
  Mensch wissen -- Isola Bräutigam Arm führen -- 
  König Isegrim lassen Kollegium -- schwierig Sache vergebens Rat fragen -- Köpfe Fuß legen -- Kollegium klüg -- 
  fallen gesandter -- vorig Besitzer Siebenmeilenstiefel -- -- Konnexion müssen -- lassen -- schlafend -- Wohnung bringen -- 
  erwachen klagen erschrocken Höckerlein -- boshaft Sekretär insgesamt himmelschreiend überlisten -- beschwören -- Hülfe Freund Freundin -- Weg baldigst Rücktransport denken -- 
  Schreck vorüber -- erbot Höckerlein -- Fee -- Stiefel verdanken -- zitieren -- -- -- Paar dergleichen abzuschwatzen -- 
  Wind bekommen -- gesandter unschuldig Stiefelraube -- aussehen -- weder Bitte Drohe eher bewegen -- König Isegrim Ehre verpfänden -- Gelingungsfall Huldibert Tochter Gemahlin verschaffen -- 
  Hof Königs Huldibert inzwischen Bedenklich ereignen -- 
  Prinz Häckerling nämlich Tag Markt paar Altertumskenner gewahr -- Haar fassen halten -- 
  Frage erfahren -- angelangt weiblich Bildsäule Ursache -- Altertum -- modern Zeitalter zuzuerkennen Gesonn -- 
  Prinz vergessen Beweis Beweisführer Statue -- Stelle -- fremd Kunsthändler -- lassen Schloß schaffen -- Könige Vater -- müssen künftig Geliebte aussehen -- 
  Original -- Natur Stück -- nunmehr Immerfort sehnen müssen -- vereinigen -- 
  König Huldibert glauben anfangs -- vielgeliebt Sohn spaßen bloß -- lächelnd -- Prinzessin Isola anderer Sinn -- 
  Prinz rufen -- Isola -- Isola -- 
  Zug Statue -- bleiben -- -- gesandter Stelle behalten -- 
  erschrak König Huldibert wunderlich Äußerung -- beunruhigt -- vorübergehend Laune Grund -- 
  Prinz verliebt Statue -- unterhalten Nacht Traume Original -- übrig -- nahe -- -- Traumbild sprech -- Tanze -- Sing -- 
  Schlafe hinlänglich unterrichten -- kurz Ballen Papier Auge -- Mund -- Haar Wuchs Einzig verdichten komponieren -- 
  Prinzessin Isola fing despektierlich reden -- arbeiten tief Sehne Tränensystem hinein -- unmöglich Ding glauben -- gradeweg König Huldibert verlangen -- sollen Befehl geben -- gelieben Statue lebendig -- 
  reißen langmütig König Geduldfaden -- -- ungeraten Sohn -- musterhaft Erziehung geben möglich Wissenschaft auffüttern lassen -- albern Ding zumutest -- 
  Einsperren eitel Brot Wasser vorsetzen -- unnütz Gedanke Trieb hübsch vergehen -- einseh Lernest -- vernünftig Kronprinz gebärden -- 
  kräftig Wort anschlugen -- führen König Drohung -- 
  Mitleid Königin Mutter verwandeln heimlich Brot -- Prinz erhalten -- köstlich Leckerbisse Wasser Wein -- Gefangener Denkweise beharrn -- König Huldibert Fluß Woche dreist sagen lassen -- 
  unverzüglich frei Fuß stellen -- wollen -- Thronerbe Kopf Wand entzwei rennen -- 
  Wort mütterlich Mitleid zugeflüsteren -- 
  ausgemacht -- Wirkung verfehlen -- 
  König Huldibert lassen -- vernehmen -- Messer Gabel Schrecken herunter fallen -- eilt Hand Serviett -- Schlüssel -- spornstreichs Gefängnistür -- notgedrung Güte versuchen -- 
  Prinz hören geöffnet Türe -- springen hinaus Zimmer -- Bildsäule befinden -- liegen halb Knium -- 
  König schicken Leib Seelenarzt -- Moral Unmoralphilosophen vergebens Hals -- 
  Prinz werfen gedruckt Heilmittel -- gekocht -- Fenster hinaus -- 
  -- König -- hausfrieden erhalten -- sogar nötigen -- Weltweis -- allgemein ächten halten -- Narrenhaus placieren -- Prinz Häckerling vorstellen -- dergleich Passion -- kultivieren geruhen -- niemals gescheite herauskommen -- obendrein Bildsäule schönen -- höchstalltäglich Verhältnis bestehen -- Altertumskenner -- antik sitzend Venus halten -- Ignorant sond Gleichen müssen -- 
  Letzterer scheinen beinahe -- 
  Fußgestell Jahrzahl Künstlernamen entdecken -- ebenfalls neu angehören -- 
  Hieraus schließen -- Porträt -- Künstler damaligen gewöhnlich arm -- Phantasie Marmor ausdrücken -- 
  -- unbefangen Phantasie Marmorbilde entdecken -- Phantasie halten -- Umstand -- -- Schicksal Weisen Narrenhause zuwider -- äußern Erkühnte -- 
  glauben übereinstimmen -- Bildsäule gestohlen müssen -- Trost Prinz Häckerling -- 
  hoffen Zeichnung -- überall herumschickt -- -- Eigentum Marmor -- selber Anspruch -- 
  vergebens -- 
  Vermutung -- König Huldibert betrüben -- tragen Beruhigung -- 
  König Isegrim -- meinen nämlich -- müssen unfehlbar Antrag ablehnen Siebenmeilenstiefel Rüstkammer nehmen -- ausbleiben Gesandtschaft erklären -- 
  Sohne Urbild Statue verschaffen -- Sinn treiben -- veranstalten wöchentlich Bälle -- weiblich Jugend umliegend Hof einladen -- 
  wimmelten Landstraße Balllustig Prinzessinn -- 
  reisend Pferd Land -- 
  Postmeister entliefen -- Bauer müssen -- tagtäglich Spannfuhr -- Pflug Acker ruhen lassen -- häßlichsen Teufel sehen -- allerschön Prinzessin -- 
  Prinz Häckerling ungerühren Tränenreich Vorstellung Bitten Mutter Schwester Hofballe Original Statue umgesehen -- finden -- allemal heraus -- Sinn erpichen -- -- -- Prinzessinn Umkreise tausend Meile durchgemusteren -- Tochter Standesperson anfahren -- 
  Menge glänzend Fest vergebens verherrlichen gescheiter Mund wäßrig -- Reihe Bürgerstöchter Bäuerinn -- 
  König -- 
  meinigen -- 
  Bäuerinn -- Pferdegeschlecht Königreiche zeitig Anstrengung ziemlich ausrotten -- dauerhaft Fuß bedienen müssen -- machen außerordentlich Strecke Wege -- Glück Prinz versuchen -- 
  Umsonst -- 
  Urbild Statue -- Prinz Häckerling bleiben Wahlspruche -- Sinn erpichen -- -- 
  Aufwand -- verursachen -- Staat bedenklich Lage geraten -- 
  Schatzkammer finden Schatzmeister -- darinn Langeweile aufgeknüpfen -- Staatsbeamt bettelt Hand Hand Bauersmanne Tür Kellermeister -- Köch -- Fleischhauer -- Zuckerbäcker -- Seifensied -- Kaufleute -- Schneider -- Schuhmacher -- Tanzmeister u. S. W. -- auserlesenst Paläst Spottpreis erstanden -- 
  König Königin seufzen ungemein -- Prinzessin Floribella vollends -- 
  Malheur -- halb Prinz heimlich verloben -- allezeit unmittelbar Verlobung Schlag rühren müssen -- 
  Abends -- Prinz gewöhnlich Gedanke verlieren -- Spaziergang Fluß versuchen -- stehen Einemmal dunkl Herr -- -- überaus hagern Statur -- Schutzgeist ansehen belieben -- 
  Herr bescheiden Prinz geheimnisvoll östlich Königreich -- erfahren -- 
  Anbruch Tag setzen Prinz Pferd -- 
  Leibkavalier müssen begleiten -- geliebt Statue golden Futterale Pferd mitnehmen -- 
  riten Aufhör -- Grenze ankamen -- 
  einsam liegend Wirtshause unsichtbar Drache -- erkundigen Prinz -- weshalb ringsum öde liegen -- 
  sprechen gerne -- Wirt Achselzuck -- blicken Schüchter -- schrie -- Spieße stecken -- 
  Prinz -- erbost ungesittet Benehme -- Stock aufheben -- Mann Knie fallen -- 
  Augenblick treten Herr herein -- hierher bescheiden -- Abenteuerlicher aussehen -- Nacht -- dünn Körper völlig Horn bestehen -- 
  Wirt bezeigt Angekommen Ehrerbietung -- Prinz zufrieden -- Hörnern weder Pferdefuß Schweif entdecken -- -- Amm lehren -- unerläßlich Zeichen verdächtigst Herkunft -- 
  hörnerne erklären nunmehr Prinz Gastwirt Schrei -- 
  Mann nämlich Fee -- Gasthof zugehören -- Strafe -- ehemalig Hotel mächtig Frau -- Reise übernachten -- dummem Geschwätz plagen -- doppelt Kreide bedienen -- hierher verweisen -- drach unsichtbar Luft schweben -- eiskalt -- glühenden Schweif Mund fahren -- weit Fee gedacht -- redet -- unmittelbar Sache gehören -- 
  Fremd -- bloß Neugier übernachten -- -- kommen schlimm -- vielmehr weg -- 
  fast fremde -- einkehren -- Wirt begraben -- 
  hörnerne fügen hinzu -- Prinz Häckerling schauerlich Anstalt befürchten -- Beruf -- Leibkavalier Schicksal bürgen wollen -- 
  Prinz entlassen hierauf Leibkavalier -- Dorfe -- Galopp erreichen -- Dankgebet aufgehenden Stern kniend verrichten -- worüber Schulze beinahe arretieren -- Abenteurer halten -- glauben -- Leute -- Stern Kleid tragen -- Leibkavalier -- Stern Himmel Aufmerksamkeit wert halten -- 
  Prinz köstlichst Fingerzeig hörnern Freund bekommen -- 
  Aurora -- geliebt Urbild Statue -- nämlich Reiche Besitzerin Gasthofs Staatsgefangene leben -- Fee Blumenstrauß Gesicht werfen -- 
  Prinz Häckerling erkundigen -- Prinzessin Aurora unmanierlich Manier kommen -- hören hierauf -- schön Aurora Prinzessin -- ordinär Blumenverkäuferin -- Tadel Blume ungezogen Grade entrüsten -- 
  Blumenmädche gerne Spröde spielen Freier verwerfen -- Fee verurteilen -- Schlos einsam leben -- Mann finden -- ihretweg Feuer Wasser Gefahr Ungemächlichkeit -- 
  Prinz sogleich Mann erkennen -- offenherzig werdend Freund gestehen -- selber viel Aurore Befreiung erwarten -- 
  nämlich Freierschaar -- meister Hoffnung -- Versuch -- Auroren Fee Gewalt entreißen -- Mal Horn -- Mädchen Geschick entscheiden -- 
  besonderer Gnade Fee bewußt Bildsäule abgelassen -- Messen Markt herumgeschicken -- Liebhaber zeigen -- 
  Prinz finden hierin -- Sprödigkeit schöne -- natürlichst Zusammenhäng Ordnung Ding -- Auror Stück -- beschließen -- Trennung aufheben -- 
  Frage Charakter Fee antworten hörnern Prinz -- 
  -- Charakter -- einzig haltbar Stück bestehen -- 
  ächt Weiblichkeit hoch Potenz sagen -- komisch kläng -- tragisch Situation passen -- 
  Heckerling Augenpaar -- frivolen -- Äußerung verfinstern -- fahren Hörnerne fort -- 
  Verzeiht -- Herr Prinz -- euren verliebt Zustand Augenblick vergessen -- 
  -- gewiß -- Weiblichkeit wunderlich Laun -- Moment Gefallen untertänigst glauben abneigen -- Fee Launen Hülle Fülle -- 
  längsten dauern -- Beleidigung Eitelkeit erzeugen -- arm Aurora leiden -- 
  Frage -- ihretwillen -- antwortet Freund Prinz -- einseh -- Mitternacht Kopf stellen -- Kunst wiederholen -- Weg -- nehmen -- Auge liegen -- 
  ungewohnt Stellung kosten Prinz Häckerling anfangs Mühe -- 
  gelingen -- 
  Monat treiben -- Hörnern -- Wohl Gutbefinde erkundigen -- einstmals erkennen -- Pfad entdecken -- vielmehr Kopf Methode -- aufzuräumen -- toll Toller -- meinen Hörnerne -- gewinnen Spiel Pfade Spur -- 
  Monat Häckerling Morgen blumig Straße -- Seite Wald umgeben -- Flusse endigen -- lauter hoch Flamme aufstiegen -- 
  hörnerne dieserhalb Gratulation -- Lehrzeit überstehen -- nächster Mitternacht Haus dürfen -- Straße -- Wanderung vorbehalten -- unfehlbar liegen sehen -- 
  Just Feuermauer -- fügen hinzu -- Palast Fee -- gelieben Aurora gefangen halten -- 
  Prinz wissen -- Hörnerne zucken Achsel -- hierüber sagen -- höchstens Wahrheit Aufgefunden bekräftigen dürfen -- 
  Mitternacht Häckerling Weg -- finden träumen -- 
  schön Irrwisch -- Leben sehen -- flackeren -- erleichtert Weg -- obendrein verkürzen scheinen -- 
  Berg herum kommen -- finden Fluß Welt feurig Brett verschlagen -- Türe Wand Schlos befestigen -- Fluß herüber rot Flamme ausspien -- 
  Fluß äußerst Flamme vertragen scheinen -- fing Prinz -- bloß Theaterspuk halten -- 
  merken indessen Ungrund schön Hoffnung allzubald -- 
  nah hinhorcht -- verbrannt schön Backenbart total -- 
  meister verdroß -- Fluß -- Benehme Feuer abgelernt -- respektwidrig betragen -- allemal Leibeskräften lachen -- sobald Prinz Fuß Welle setzen -- bejahrn Baum -- hinauf klettern -- himmelhoch Mauer sehen -- allezeit Kopf gewaltig schüttelen -- glauben -- einfältigst Weg Welt -- 
  glauben -- 
  munter Salamand -- prasselnd Flammenschlosse herausgeschlüpfen -- einzig lebendig Wesen -- obendrein Hündch Fuß nachfolgen -- 
  Prinz mißvergnügen Fluß -- verwünschen sodann Rückwege Mittenächt -- fruchtlos Kopfe zubringen -- beschließen Hörnern Meinung tüchtig sagen -- 
  Salamand -- aufgesperrt Maule Weg stellen -- eins Kopf versetzen -- Besann -- Tier Vermuten feenreich gehören Tod verdrußlichst Händel verwickeln können -- 
  Hörnern Ankunft dachen Gasthofe Tierchen -- sichtbar -- Hörnerne verschmerzt Handvoll Schimpfrede -- hören -- Prinz Häckerling Tieres Meinung begreifen -- 
  Heckerling Frage -- Salamander Lieblingsspeise -- antwortet Freund -- Reiche Fee -- wohin Tier gehören -- weder Tier Mensch essen pflegen -- schön Aurora bloß Luft leben müssen -- 
  Hin- herreden geraten Prinz Häckerling -- Salamander Billet Herzenskönigin Mund stecken -- worüber Hörnern Freude -- Genie pries -- stumm Abgesandt schön Aurora begreifen -- 
  Prinz -- ungewohnen -- Gesicht lacht -- Kopf Unternehmung schütteln -- fragt -- lachend Strom kopfschüttelnden Baum Raison bringen -- 
  hörnerne hierin dienen -- 
  Strom -- -- Zusammenfluß mokant Volke -- lachen Sentimentalität nehmen lassen -- Baum sein Heer verstorben Moralphilosophe -- Tod kritisieren vergessen können -- 
  Prinz Häckerling bitten -- Freund nunmehr lassen -- quälen hierauf unwillig kopf folgend Gedicht -- 
  unvergleichlich Aurora -- 
  Fürwahr Welt Nest voll Ratz -- Reiz hell umfunkeln -- Ton zart ummunkeln -- Sphärenklang Konzert Hund Katze -- 
  O Edelstein -- Poet schwatzen -- O Urstoff -- Stern Karfunkel -- Erde -- dunkel -- Klafter tief nägeln kratzen -- 
  Herz toben ärger ärg Wüterich -- Heraus Knopfloch lodern -- Näht reißen -- Ehre -- 
  -- einzig -- beschwören -- Reiche -- Verzeihung kühn Forder -- Reich -- Flammenschlosse Dietrich -- 
  Grade Mitternacht fertig -- sonach verlieren -- 
  finden -- Gegend völlig gestern aussehen -- 
  Hauptperson heutig Vorhaben -- Salamand -- lassen blicken -- 
  Prinz Willen poetisch Bitte Glück Strom werfen -- Salamander schleunigst herbeikommen äußerst unterwürfig Bewegung Fehler Verspätigung abbüßen scheinen -- 
  hierauf Prinz Häckerling Billet Mund stecken -- eilt Tier Feuer -- legen halb Stunde -- Prinz lang Ewigkeit vorkommen -- folgend Antwortschreiben tief Erniedrigung Füßen -- 
  Prinz -- 
  hoffen -- dein Stern Karfunkel -- sagen -- Schnabel wachsen -- Tier schicken -- 
  jeder Tier wissen Flammenschloß aufzuschließen -- sobald schicken -- Zähn Klau auszuweich Rücken schwingen -- 
  Wahl bleiben überlassen -- 
  ewig scheiden -- keiner benutzesen -- 
  Aurora -- 
  Prinz küßte einzeln Buchstabe Billett -- Simplizität Höchste scheinen -- menschlich Geist jemals hervorbringen können -- 
  finden überaus -- notwendig -- Rechtschreibung unleserlichen vernachlässigen -- hoch Gemüte -- -- erachten -- Zeile hauchte -- schimpflich -- Unwürdigkeit fesseln lassen -- 
  beschließen sogleich gut Tier benutzen -- Vorsatze wankend -- bildschön Löwe Walde hervorspringen -- höflich Anrede -- sogleich vorbeigehen Rockschoß Leib reißen -- paar Reihe konditioniert Zahn zeigen -- Prinz Häckerling schließen -- bewenden lassen -- 
  äußern Häckerling Salamander -- Tier sehen wünschen -- worauf Löwe sogleich Wald zurückeilen -- königlich Tiger Heraussprang -- 
  Kragen Hals gebissen -- Baum Haupt Bewegung Prinz Rücken Bestie -- Ungebührlichst schütteln -- denken Kluge Prinz -- Respektwidrig bleiben -- Baum insgesamt abhauen lassen -- Gewalt stehen -- dasmal gewiß -- 
  schlimm Tier unmöglich -- 
  bitten -- 
  Prinz vergebens Walde blicken fürchten -- schön Aurora Zöger böse -- schick Tier -- lassen Ufer Stromes Geräusch groß Sagemühl vernehmen -- 
  Prinz wenden Gegend ungeheures Krokodil gewahr -- Wetz Zahn beschäftigen -- Erblicke Mensch wütend losschoß -- 
  Prinz halb Stunde fahrend Gegner Rachen -- Platz vollauf -- auswichen -- Krokodil Strome wenden -- 
  mißmutig -- Tier Mut aufgeboten -- stehen arm Häckerling -- müssen gestehen -- einzig Dietrich Flammenschlosse -- übrig -- unbequem Handhabe Welt -- 
  Glück soweit begünstigt -- unzerriss Rücken Krokodil gelangen -- Riesenleib Sitz -- festhalten -- fallen Wasser -- Falle Tod unzertrennlich -- 
  hört Geist Welle höhnisch Grabelied pfeifen -- -- denken -- Betrübnis -- 
  schrecklich Schluß gnädigen Handschreiben exaltiern plötzlich -- empörendsen Hohnlachen Welle Krokodil hinaufschwingen -- 
  -- Verlust Nase -- barbarisch Geschöpf rein Gesicht gebissen -- 
  glauben -- 
  -- denken -- fest anhalten -- Flammenschloß Zunge Krokodil auflecken -- Tür sodann gesprung -- hindurch -- Haar versengen -- 
  Jenseits feurig Wand -- Strom fortdaueren -- Krokodil honett Tier Sonne -- schwamm gelassen Reiter an Ufer -- weint Kind -- hundsföttischerweise Nase kommen -- 
  Strom innerhalb brennend Mauer lautlos manierlich -- Prinz klar Spiegel betrachten -- 
  Himmel -- arm Herr -- 
  schön Aurora zuzumuten -- Prinz heiraten -- Nase -- 
  -- schön Nase kurz wahr Zankapfel väterlich Hof -- Poet Hand gerissen -- schön Vergangenheit häßlich Gegenwart Anschlag bringen -- 
  Mutlos schlich Prinz Marmorpalaste -- stehen -- 
  Behielt Pracht anzustaunen -- sogleich ungeheuer Mohr hoch Portal treten -- einlud -- Sessel -- -- nieder lassen -- 
  obschon glühend Eisen bestehen scheinen -- werfen Prinz Verzweiflung Überzeugung -- Mensch Nase verlieren -- hinein erwartet Schicksal -- 
  fallen passabel -- 
  Glut -- fürchten -- finden Kissen -- herrlichst Rose bestehen -- Prüfung Lehr- Wunderzeit scheinen beendigen -- 
  Garde baumlang Adonisse hindurch tragen -- Zimmer -- einzig unermeßlich Rubin hauen -- Fee niedergesetzen -- schön -- Prinz Wort offen Mund stecken bleiben -- 
  raffen -- Fee -- 
  Silbe -- 
  kenn Wunsch auflegen -- Wort Leute dein Schlag -- 
  Kommen -- 
  führen Schranke -- Diamant geschniten -- holen vollkommen Assortiment menschlich Gliedmaß -- darinnen befinden -- Nase Backenbart hervor -- kleben beid Häckerling Gesicht -- -- Eile -- Leute draußen ankleiden unwürdig Neigung zuführen -- 
  wenden Fee Rücken -- 
  Prinz auffiel -- vergessen -- Nebenzimmer Löwe Tiger mitgenommen Tracht äußerst geschmackvoll vertauschend Spiegel gegenüberstand -- schön Nase -- Nachruf weihen -- vorig Glanze gehörig Ort stehen Spur Verkittung übrig -- 
  hierauf -- umkehren können -- Sache ewig Liebe gewiß -- 
  Anordnung Fee bringen -- Auror heirat jemals Aufhöre lieben -- -- späterhin verlieben wollen -- abscheulich finden -- 
  Dummer Schnack -- Häckerling entrüsten -- tragen sogleich abgelegen Zimmer geliebter -- 
  lassen Knie nieder -- beschwören -- längst ersehnt Hand geben sogleich Hof folgen -- 
  Mädchen schön Prinz halb Einwendung -- Sittsamkeit damaligen bringen -- 
  Schloßkaplan traut Paar -- letzter Wort -- schelln Schlitten herbei -- bestimmen -- Neuverehelicht Feenreiche hinaus transportieren -- 
  Prinz wundert Fuhrwerk heißest Sommertag -- schön Aurora erinnern -- mächtig Fee -- 
  zögeren -- Schlitten fliegen Fluß -- Eisrinde -- Feuerwand Sommer hindurch -- Pfeil -- 
  Tagesanbruch steigen Gasthofe unsichtbaren Drache -- Hörnerne -- Fleisch -- Paar tausend Glückwünsche empfangen -- Fuhrwerk bestellen -- 
  Feenschlitt sogleich zurücklaufen -- 
  Prinz -- überaus Edel -- Beilager -- Herz fühlen -- Aufschub leiden -- versprechen Kutscher Station groß Ehrenstelle -- eiligst königlich Schloß Vater schaffen -- Leute tun Möglichste -- Reiter -- Statue golden Futterale vorantrug -- Hand voll -- Platz Ehre behaupten -- 
  König Königin freuen ausnehmend -- Sohn -- deswill Sorge schweben -- Gemahlin vorstellen -- 
  wunderen Königspaar -- Prinzessin Tochter Sessel verlassen -- 
  Witz Hofe geraten heimlich Gärung -- Art sprechen -- Hof Glaube stören -- bloß schlecht Erziehung Grund Benehme Prinzessin legen können -- 
  Prinz selber besann -- Gemahlin sogar Trauung sitzen bleiben -- sitzend -- allezeit Stellung Bildsäule sehen -- 
  wissen -- Stolz besonderer Pflegma zuschreiben -- hoffen Fall kurieren -- 
  -- meinen -- Rat -- 
  -- meister hoffen -- -- Rat teuer -- 
  Prinzessin entdecken nämlich Gemahl -- unter Hälfte Körper gut Konservation Reiz -- Fee versteinern -- 
  König Königin rang Hand -- Prinz trostlos Nachricht zubrachten -- 
  Arzt Priester herbei holen -- beiderseitig Segen Versteinerung vermögen -- sprechen Vater Mutter ziemlich heraus Prinz -- dergleichen steinern Hälft sein Königshause Gebrauch -- weshalb Prinzessin -- 
  kommen schön Prinz -- 
  Liebe bloß Träum beruhen -- halten Traume fest -- Gemahlin Bad schicken -- Stein völlig auflösen -- 
  Arzt Chemiker lächelen -- hört -- Wasser Versteinerung auflösen -- wissen freilich -- Bad -- Rede -- Feenreiche liegen -- Wasser Fee besonderer Bewandtnis -- 
  Prinzessin wissen -- freut -- Gemahl Heilquelle Gebrauch -- 
  -- Prinz -- leben Zustande Fee -- 
  steinern Unterteil Ableiter Alter -- 
  Gemahl sagen -- Auflösung Spur zehnjährigen früh Leben -- nächster Gestalt sichtbaren -- 
  gelingen Prinz Badekur bewegen -- Achselzuck andeuten -- König Reich zufrieden stellen -- 
  mehrjährig Baden Vater -- Thronerbe sehen -- äußerst ungelegen -- 
  wünschen -- weise beredte Mann Königreiche Sohne Vorstellung -- lassen Mann sogleich Narrenhause herbei holen -- 
  Häckerling Klemme -- Prinz einigemal stutzig -- 
  Natur helfen -- 
  Prinz Häckerling appellieren Ewigkeit Liebe -- langweilig Kur aufmerksam -- Weise Hinfälligkeit menschlich Reiz malerisch beschreiben -- -- Reiz -- 
  Herz Aurore Reize ewig leben -- 
  überdies behaupten Prinz Häckerling -- Mensch -- einsähe -- Gemahlin Stück Natur geschnitten sein -- nirgendhin Narrenhaus gehören -- 
  Weise bitten Gnade -- bringen -- Bedenken gewähren -- 
  betrübteren Hof Königs Huldibert -- 
  Gemahlin schwankn bleich Schatten umher -- 
  Prinzessin Floribella Ursache rot auszuseh -- weitläufig Hofstaat erbleicht Umstand Jähling -- halb Dutzend berühmt Schminkehändler Kurzem Zahlung einstellen müssen -- 
  Abend Abreise Prinz Prinzessin Häckerling Bad -- finstersen Gesicht -- -- wissen schneiden -- 
  hoffnungsvoll jung Paar Bestimmung nachgereisen -- Erscheinung Hof -- Stadt Land Unruhe setzen -- 
  rücken nämlich dick -- dick Wolke -- bemerken -- näher nah -- 
  Profession Gedanke Wolke -- 
  Spaziergänger Exempel -- fürchten -- Hemmung Geschäft bevorstehen -- 
  Kornsammler hoffen -- nahe segenreich Ernte Wolke vernichten -- 
  philosophisch Arzt erklären Wolke Augenfehler Mensch -- epidemisch Stadt Land anstecken -- 
  erklärt Dummkopf -- Umstand -- glauben -- 
  Wunder -- Meinung weitesen greifen -- 
  bloß Bauersmann Dummkopf -- Meinung -- lassen Gesundheit Auge Wolke abdisputiren -- 
  Bauersmann -- 
  tages sinken Wolke allmählich Schloßplatze nieder -- 
  halb Schock Genie kommen herbei Geflogen -- Deckel aufmachen -- geschehen -- steigen äußerst zahlreich Gesandtschaft König Isegrim heraus -- Mitte weltberühmt Prinzessin Isola befinden -- 
  Huldibert Gemahlin erschraken -- Nachricht voraus Schloß eilen -- 
  Traume einfallen lassen -- Seite Verlegenheit bevorstehen -- 
  philosophisch Arzt vorhin Augenübel -- treten nunmehr -- 
  Gesandtschaft starren Gold Edelsteinen -- ansehen -- böse Auge bekommen -- augenschirm Mode -- -- gesund Auge behalten -- tragen müssen -- Mann Geschmack heißen -- 
  Hieraus beweisen Arzt -- vorhin Grund -- nennen nunmehr Dummkopf -- vorig Ausspruch allzu buchstäblich nehmen -- 
  denken -- Gesandtschaft Lage Ding verheimlichen -- bekommen Wind -- König Huldibert Mühe -- Leute begreiflich -- -- Gott Name Prinzessin zurückreisen können -- 
  Hülfe Million vollwichtig Überredungs-Gründ dahingebracht -- 
  Höckerlein -- mitgekommen -- Ohr -- Anspruch Floribelle geltend -- 
  König Huldibert fragen -- Sache verhalten -- gesandter -- halb tot vorgefunden Umstand -- bitten Privataudienz -- 
  werfen König Füßen -- berichten Treulosigkeit Sekretär -- Auftrag Höckerlein sodann übernehmen -- 
  Fee sogleich -- erscheinen -- König Isegrim prächtig Gastmahl einnehmen -- Prinzessin Isola Sohn Gemahl antragen -- 
  Isegrim Wort geben -- 
  hierauf Fee Erbiet kommen -- Prinzessin Gesandtschaft schleunigst Portofrei Prinz Häckerling übermachen -- 
  Obendrein Fee versprechen -- sehen -- Isola Schönheit Tugende gemäß behandeln -- Gegenfalle schrecklich Rache Prinz nehmen -- 
  König Huldibert stoßen hierbei heiß Seufzer -- zitternd gesandter Wort Zunge zerschmolz -- 
  Befehl Gebieter -- endigen -- 
  Wolkenschiff ausrüsten -- Absegel bereit -- bitten -- eingedenk Eurer Majestät geleistet Versprechen -- König Isegrim Augen -- Höckerlein behalten -- 
  lassen König Isegrim ungnädig -- erzählen -- 
  meinen -- Wort geben -- Höckerlein Prinzessin Floribella Frau bekommen -- ruhen -- geschähe -- 
  müßt Wort halten Prinzessin Isola -- ungelegen kommen -- 
  raten gesandter -- König Prinz baldmöglichst Heirat Isole bewegen -- Isegrim Zorn Einverständnis Fee Königreich verheeren können -- 
  Prinzessin Floribella -- Höckerlein Hand vorenthaln -- 
  Wort reichen Königin -- herbeigekommen -- Ratgeber Backenstreich herüber -- Stelle Tod abgehen -- 
  Arzt -- vergebens herbeigerufen -- behaupten diesmal einstimmig -- Mann Übermaße zurückgetreten Hoffnung ersticken -- 
  -- Warnung Spiritus setzen -- Archiv hundert neunzig Volumen Akte aufbewahren -- Gesandtschaft schreiben lassen -- 
  König Huldibert -- brühheiß -- Isegrim Rache denken -- schicken sogleich Sohne -- heißen -- Verlust künftig Thron -- schleunigst zurückkehren -- 
  hoffen bewundernswürdig Gestalt Prinzessin -- gleich Welt geben -- 
  verstockt Häckerling -- abzureisen -- erstaunend empfindlich -- Vater -- zeitlich Königreich halber -- ewig Liebe grob Zumutung Stande -- 
  Umstand bleiben König übrig -- Prinzessin Isola -- wissen -- woran -- leidwesen anvertrauen -- bitten -- Sache übel nehmen -- 
  Isola Kind -- vergeben vergessen -- glänzend Bäll -- Ehre anstellen -- froh frei herum tummeln -- 
  Destoweniger Höckerlein Sinn -- Floribelle heiraten -- wankend -- Mann ziehen Wendung -- -- Gemüte -- körperlich Konstitution äußerst litt -- 
  schieben Höcker Brust Rücken -- unförmlich Nase spitzig -- Nadelöhr bringen -- 
  Anliegen Prinzessin Floribella könig könig Prinzessin Floribella weisen -- 
  verlangen bestimmt Erklärung König -- Ausschuß weis Mann Rücksprache nehmen -- Höckerlein -- -- Heirat Häckerling Isolen rückgängig -- königlich Wort -- bloß Heirat halber geben -- Gültigkeit verlieren -- 
  lassen Höckerlein abweisen -- 
  behaupten -- Versprechen erfüllen -- Wahnwitz Prinz Häckerling Last legen können -- 
  König Tochter gestehen -- hierauf genügend Antwort Bereitschaft -- fahren Gedanke Kopf -- begreifen -- -- 
  entdecken nämlich Höckerlein sechsmalig Verlobung -- Unglück -- verlobter Schlag treffen -- 
  glauben Hoffnung gewiß benehmen -- 
  ankommen lassen -- Höckerlein -- bleiben Floribelle übrig Trost -- Verlobung -- Freier befreien -- 
  sterben -- Höckerlein -- 
  schieben Hochzeit Monat Monat -- Woche Woche -- allerlei Vorwande hinaus -- Nachricht Höckerlein ableben -- täglich hoffen -- Kind heiligen Christ -- pflegen Bräutigam gewöhnlich Person erscheinen -- erkundig -- glücklichste Leben anbrechen sollen -- 
  Aufschubsursach ersinnen -- müssen Werk geschritt -- schwach Hoffnungsschimmer -- Höckerlein Hochzeitstage sterben -- sterben Hochzeitstage -- 
  bekommen Manne außerordentlich -- 
  damalig erscheinen zuweilen unbekannt Prinz Hofe -- Schönheit einzig Welt Stich halten -- -- scheinen -- Prinzessin Isola ungern tanzen -- 
  Prinz Häckerling -- Anfang -- hören lassen -- zuweilen Besuch -- 
  Kur Gemahlin Folge bleiben -- Wade entsteinen -- 
  übrig Körper kosten -- sogar Hofleute Dichter rot -- Reiz Lobrede halten müssen -- 
  Gemahl übertrieb fast Schuldigkeit Ehemann -- Gattin Gesellschaft ausschließend besitzen -- 
  -- Ohr lauter göttlich Ding vorsagen -- meschant Blick zuwerfen -- Rede ungehobelen herauskamen -- 
  merkt spitzfindig Hofleute -- ordentlichen Dolchstich Herz -- gut Hoffnung denken -- Prinzessin Häckerling Herzen tragen -- 
  vormals Hörnerne -- Anfangs vertrauen besessen -- Auge -- -- beinahe seltsam scheinen -- Weise Narrenhause fast Prinz einzig Umgang -- 
  Häckerling geben -- Weise Hof -- vernünftig Mensch -- zurückgebracht -- 
  absolut Narrenhause leben sterben -- -- -- nirgends wissen -- Leute dran -- 
  finden Prinz Häckerling -- unausstehlich Person -- Gemahlin -- leben lassen -- er_es finden -- eilt väterlich Hof -- Vater Mutter ziemlich kleinlauen -- sehen -- Traum Lügner sein -- Gemahlin Stück schaffen -- 
  wollen Augenblick verstoßen Prinzessin Isola heiraen -- 
  Wort schließen erfreut Eltern Herr Sohn erstaunlich Liebe Arm -- Wunder Heldenentschluß -- schön Prinzessin Welt Jawort geben -- 
  Lob- dankgebet Prinz Entschluß erschollen sogleich Kirche -- Mensch zweifelt Prinzessin Isola's Einwilligung -- Prinzessin -- 
  nämlich Prinz Häckerling wissen -- Regenwurm Füßen krümmen -- führen Mißgeschick Gemahlin Gemüte -- -- wiewohl verblümt -- Narr -- entschlössen -- Bösewicht -- aufhören Narr -- Rednertalente Königreiche unvermögend -- Prinzessin anderer Sinn -- 
  Erscheinung erfüllen Mensch Furcht Schrecken -- 
  Wolke -- Isola Luft geschwommen -- stehen gut Andenken -- Ursprung ungeheuer Wolke -- nah nah ziehen -- erraten -- 
  morgens klärt Sache vollends -- 
  Stadtsoldat Tor kommen Haus -- klagt Weiber -- Zeit schlecht -- Nacht Wache ungestört Schafkopf spielen können -- 
  nämlich Armee hunderttausend Mann Luft herunter fallen -- Hals Kopf Hasenpanier ergreifen -- Schlag -- 
  wirbelt Trommel Straße -- 
  Schlos -- Bette -- wissen fürchterlich Geschichte -- 
  Isegrim Fee gewaffnet Gefolge anlangen -- fahren königlich leibwach Schlafe -- 
  Gewalt Gewalt vertreiben scheinen blutig Maßregel -- 
  lassen Ankommende Gutem ablösen -- 
  König Huldiberts Schlafzimmer endigt halb Stunde -- 
  Prinz Häckerling -- Prinzessin Isola angetan Schimpf ewig Nachkommen Thronfolg ausschließen -- 
  Isola heiratet überschön Prinz -- Bäll Eindruck -- nunmehr herauskam -- Sohn Fee -- 
  übergeben Königreich -- Luft stiften Zubehör versehen -- 
  Höckerlein Floribella erben Huldibert Krone Tod ausrufen -- 
  Isola -- Fee König Isegrim Armee Luft absegeln -- Höckerlein Ursprung saalbadern -- 
  Person erzählen -- Findelkind Morgen Zimmer Fee unverhofft finden -- 
  Fee -- unverheiraten -- alt Dienerin Erziehung anvertrauen -- 
  schön aufwachsen -- 
  Fee -- Braut -- plötzlich erblicken -- -- zufällig Ähnlichkeit erschrocken -- vorn -- hinten Nase -- Stabe berühren -- 
  Wirkung ausbleiben -- 
  hierbei versprechen -- verlassen -- Alter entfernt halten -- solange Höcker trügen -- niemals fehlen -- 
  Lastträgermetier bloß Liebhaberei treiben -- Mensch Liebhaberei müssen -- 
  Zweifel gestehen -- entschließen sollen -- entschließen -- entschieden Hang Originalität spüren -- 
  Gerechtigkeit widerfahren lassen -- hierdurch verschrien Dilettantismus Ehre -- -- 
  Prinz Häckerling Herold Pferd reißen -- Thronfolg Schwager proklamieren -- 
  Volk -- zeith bloß Prinz Titel -- verdienstlos Person verehren -- königlich Proklamator -- 
  Unglück brechen Seite arm Prinz herein -- 
  Gemahlin Sohn gebären -- Affen Gebühr ähnelen -- 
  Liebe anfragen -- bekommen Gemahlin Korb -- 
  Gesellschaft -- unerträglich geworden Frau -- finden Wort -- Feenpalaste voraus -- verdrußlichen Umfang bestätiget -- 
  Wunderlicher -- Land glücklicher Paar Prinzessin floribell Höckerlein -- 
  schwer schön Prinzessin Ehe -- -- Höckerlein -- ehrlich Schlag Mensch obendrein Kopf fallen -- 
  Umarmung nutzen Überfluß Rücken Nase Prinzessin Auge -- 
  Ding -- Höckerlein schön Mann Königreiche vorkommen -- ärgern -- Leute hierüber gut Gewissen Meinung -- 
  Kurzem vollkommen Wunsch -- 
  nämlich König Huldibert Betrübnis sterben -- Fee Krönungsfeste Nachfolger erscheinen -- Höckerlein -- überaus schön Erstgeboren Arm nehmend -- 
  künftig dein Platz behaupten -- 
  Altere -- übrig Mensch -- 
  berühren Höckerlein Stabe Rücken Nase -- 
  alsbald erscholl lang allgemein -- 
  Ah -- 
  -- schreien Odem -- 
  leben König Huldibert -- gut schön Mann Königreiche -- 