Weg -- -- 
  rufen schnarrend Stimme Gebüsch -- Wagenlenker -- angehören -- arbeiten mühsam Pferd schwerbepackt Reisewag umherliegend Felsenstücke Berg herauf -- 
  meinen nämlich Langenwiese -- ergänzen Flötenstimm Frage -- Frauengestalte treten Wagen hervor -- 
  zerschlagen Glied -- fahren Sprecherin fort -- rechtfertigen bescheiden Zweifel -- wirklich Weg befinden -- 
  schön Feueraug blickt dunkel Lockengewühl entgegen -- wiederholen freundlich Frage -- 
  Weg -- erwidern -- erlauben -- lang -- schmal -- steinig Platz nennen -- führen Wagen Langenwiese -- indessen Viertelstund Fußweg ermüden -- O -- Geringst -- unterbrach -- Stunde Fuß -- lang unsanft schaukeln -- 
  erbieten Begleiter Wald -- nächster Gasthaus -- reisend Wagen erwarten -- Erbiet freundlich annehmen -- 
  unterwegs erfahren -- Ilmenau Ziel Reise -- Dame stärkend Waldluft Gebrauch Schlackenbäder Gesundheit herstellen hoffen -- 
  Gefährtin sorgen zartest Aufmerksamkeit -- -- gehüllen weit Staubmantel -- dicht verschleieren -- langsam -- jemals Anteil unser Gespräch nehmen -- 
  unser angenehm Waldweg allzueilig zurücklegen -- finden Wirtshau Wagen angelangen -- 
  verschleierter verneint Frage Reisegefährtin -- gesonn Gasthofe abtreten -- wenden -- dankt Harmonikatön -- -- hören -- Begleitung -- 
  Bewegung teilen Staubmantel -- Schleier wich blond Madonnenkopf wenden paar blau Augenhimmel -- Süß Liebe Bitterkeit Schmerzes aussprechen -- 
  Antwort stockt Lippe -- 
  Auge ruht Augenblick forschend seltsam Ausdruck -- -- schön Gesicht tief Schleier hüllen -- leis Freundin -- 
  kurz Weg ermatten -- 
  Laß Minute ausruhen -- 
  folgen maschinenmäßig Wirtshaus -- 
  Trug Erfrischung -- 
  Freundin -- vorkommen -- leisen Wink Verschleierten -- laden nehmen -- 
  schwach -- Verhüllter -- halten Ermüdung -- 
  schnell -- 
  stützen Arm Sofakissen -- legen Kopf Hand -- scheinen -- auszuruhen -- 
  sprechen indessen mancherlei benachbart Gegende -- Schönheit Merkwürdigkeit -- 
  Sahe Gegend Saalfeld -- lispeln verschleiert fast accentlos Frage -- 
  mehrere Mal -- erwidern -- stehen Denkmal teuer Heldenopfer -- blutig Schlacht fallen -- 
  Bezeichnet Denkmal Stelle -- Prinz fallen -- fragt -- Stimme scheinen zittern -- 
  genau -- antworten -- Denkmal Seite Landstraße errichten -- abwärts -- nahe Busch -- Focht unglücklichen Schlacht -- -- sprechen fester Stimme -- erheben langsam liegend Stellung -- Schleier zurückschlagen -- 
  blass Rose Wang glühten schnell hoch Purpur -- Auge flammend anblitzten -- 
  -- Antwort -- Freund kämpfen Stelle -- fruchtlos -- bleiben -- ergänzen Seufzend -- kläng Erinnerung Trauerglocke Grab geliebt Held -- 
  Meinung berichtigen -- winken schmerzhaft Hand schweigen -- 
  Lasse wehmütig Erinnerung aufwecken -- setzen leise -- hörbar -- hinzu -- neigt Abschied -- 
  Freundin verstehen -- Wink eilen Diener herbei -- Schlag öffnen -- Augenblick Wagen schön Fremden Gesicht -- 
  2. Wille schön unbekannte folgen -- Mittag vorüber -- Versprechen rufen Paulinzell -- Gesellschaft Freund Freundinne antreffen hoffen -- ehrwürdig romantisch Ruine alt Klosterkirche betrachten -- 
  Wirtshaus herum Amthofe Weg nehmen -- verspäten -- glauben Freund Resten Vorwelt Bewunderung umherwandelnd finden -- hören bekannt Stimme Name rufen -- winken hinauf -- Hügel -- Gesellschaft Linde versammeln warten -- 
  günstig Licht Anblick prächtig Ruine genießen -- Zerstörungen Fanatismus -- -- -- meister schaden -- Finanzgeistes -- herrlich -- -- alt Art Kunst zeugen -- beschließen -- Abend -- Beleuchtung Monde -- Weg antreten -- 
  Führer ausersehn -- mehrmals Gegend bereiset -- Ruine Zeichnung -- Modell Beschauung kennen -- 
  heit Himmel lassen hell Mondnacht hoffen -- Wölkche -- einzeln blau Luft schwammen -- Magie Mondbeleuchtung Abwechslung Helle Dunkle erhöhen -- 
  Anblick Ruine -- Amtshof Abendseite nähern -- Überraschend Imponierend -- 
  Verfall ziemlich hoch Turm ziehen Auge -- 
  sogleich wenden Blick achtsäulig Portal -- geräumig Halle Schiff Kirche führen -- 
  sehen Säulenreihe Kirche -- -- Vorsprunge -- Säule tragen -- hoch -- Verfall uralt Baues mehrere Mal abgestorben jung hervorgewachsen Fichten -- 
  Beschauung Mondlicht scheinen Ansicht -- Anblick -- günstig -- -- Mond verdeckend -- Ruine Wirtschaftgebäude dunkle -- beschattet Maß zeigen -- 
  beschließen -- Weg Morgenseit nehmen -- Sonne Untergang zuneigen -- schlagen Spaziergang Wald -- Zelt hervortreen -- Ruine romantisch gelegen Seite Ferne Mondbeleuchtung betrachten -- 
  3. 
  umdämmert -- schwärmt Gesellschaft fröhlich Walde umher -- 
  suchen heimlich Plätzch vertraut Gespräch -- pflückt Waldbeere schmücken Kleid Hüte rötlich aufblühender Heide -- 
  -- schön Fremd zuweilen still Nachdenkend -- neckt Abenteuer -- gutmütig erzählen -- behaupten -- rätselhaft verschleiert -- angelegentlich Monument Saalfeld erkundigen -- können -- Prinzessin -- Bade erwarten -- 
  hoch schwarz Ficht Tann Anfing dunkel -- finden Einsamen Gesellschaft -- schließen nah -- Mutwille -- Geister treiben -- Erzählung Wirtes Ruine neuerlich zeigen -- kleinlaut -- Dämmerung ausbreiten -- verstummt weit -- öde Stille -- Berg dicht Walde umgeben -- 
  Schauerlich düster -- Julius -- heilig Pauline Ort Kloster aussuchen -- 
  Vorliebe tief Abgeschiedenheit -- vormals gewiß rauh Gegend schwer Vergehen abbüßen -- 
  währ interessant -- Geschichtebücher befragen -- 
  Ausbeute finden -- erwidern Theodor -- -- aufgezeichnen finden -- Suchen wert -- 
  O teilen -- wissen -- Herr -- rufen Frau -- -- -- nah Paulina's Ruhestelle -- interessant -- 
  täuschen finden -- entgegnen Theodor -- unvollständig Notiz stören Phantasie -- aufgeregt -- 
  denken Paulin schön Unglückliche -- heilig Jungfrau -- geweiht zell leiden unbefriedigt Sehnsucht vergessen vertrauern -- Art schöner Helois -- kalt Schicksal geliebter trennen -- fremd Vergehung abbüßt -- dunkl Geschick unschuldige verflochen -- 
  Chronik lesen -- St. Paulina Gemahlin -- Tochter thüringisch Markgrafen Morichon -- Kaiser Heinrichs -- 
  baut Kloster Paulinzell -- Königsee Ilm -- 
  Sohn Werner Abt Gerung einführen -- Kloster riten -- abzuholen -- fallen Pferd brechen Arm -- Verletzung sterben -- prosaisch Relation gewinnen -- 
  jung schön betagen Matrone verwandeln -- Jungfrau Mutter ritterlich Sohn -- Wirklichkeit schön Zauber Phantasie zerstören -- 
  -- Mathild -- Sohn schlagfertig Ritter Mutter alt Matrone -- 
  häßlich Armbruch abrechnen -- Zug Kloster Abtes Gerung Bild Flucht Ägypten denken -- 
  romantisch Stoff -- fallen Otto -- Mathild Bewunderer -- -- bringen Bild Paulina's Geschichte -- 
  Bedeutung Abt bekommen -- 
  -- setzen Julius hinzu -- öffnen Ungewißheit Chronist -- Paulina Morichon's Gemahlin Tochter -- weit Feld -- 
  ahnden deutsch früh Cenci -- 
  düsterschön romantisch Kloster treu Abbild tief gebeugt -- verdüstert -- schön -- trefflich Gemüt -- 
  Werner -- fragt Amalie -- Name abte -- 
  Gerung vielmehr -- erwidern Theodor -- Werner heißen Paulina's Sohn -- 
  Sonderbarer -- -- fahren Amalia fort -- durchblätterten vorhin Fremdenbuch -- Name -- Werner Pauline -- Bleistift schreiben dornig Rosenkranz umschlungen finden -- 
  -- -- -- rufen Otto -- Gespenster glauben -- Pauline Werner Revenant sogar Beschauer Ruine einschreiben -- 
  wissen -- Mönch -- Wirtsleute Ruine sehen -- Werner -- begegnen Pauline Ruine -- 
  Spott -- Amalie -- Stand Name -- Carlos Elisabeth leicht Zügen hingeschrieben -- lassen hieraus verborgen Verhältnis Paulina's schließen -- Besucher Ruine -- Zusatz deuten -- 
  -- antworten Julius -- mager Chronist Urkunden Paulinzeller Archives lesen -- Jahrhundert verbrennen -- vermodert zerstreuen -- 
  finden -- wissen -- suchen -- 
  Theodor erinnern -- Geschichte Paulina's Kloster Ort Stelle mitteilen versprechen -- 
  führen Blatt erneuern Versprechen -- 
  Verfasser -- setzen hinzu -- lieb Freund -- interessiert lebhaft Ruine -- geschichtlich artistisch Beziehung -- 
  forschen alt Urkunden hört mündlich Überlieferung -- 
  tragen fast Paulinzeller Archiv -- Erzählung Resultat erriet -- 
  kleidet Art novellenmäßig -- sonderbar -- Erzählung ähnlich Verhältnis -- vermuten -- Erzähler vorgreifen -- 
  -- Julius -- Name Carlos Elisabeth Fremdenbuche heilig Paulina -- Besucher Ruine deuten -- 
  klingen vorhin dunkel Erinnerung -- 
  Drang Julius -- nah erklären -- 
  4. Sache liegen nahe -- -- Person bekannt Familie betreffen -- 
  hören mehrere -- indessen verübeln -- bloß geben -- eigentlich Interessant -- nämlich Erzählung Name -- 
  jung Gräfin Pauline Mutter Tod väterlich Haus erziehen -- 
  streng Aufsicht -- Vater anvertrauen -- hindern -- Paulin Spaziergängen öffentlich Ort zuweilen jung Mann -- Auge überall suchen -- ihrigen begegnen -- 
  gefangen Offizier -- Werner nennen -- vergeblich Versuch gelingen -- Miniaturmaler Aufseherin Institutes -- Paulin Erzog -- einführen -- 
  liebend indessen schüchtern Wort Liebe heimlich begrüßen -- Nachricht schnell Annäherung Armee -- schleunig Entfernung schwach Besatzung gefangener nötig -- 
  Werner Wohnung geliebter kurz Abschied eilen -- eilfertig drängen Vorsteherin verdächtig -- weder Bitt Versprechung bewegen -- Unterredung -- letzter Anblick geliebter gestatten -- 
  feindlich Truppe Stadt räumen -- deutsch Truppe besetzten -- 
  Kommissarius -- Stadt Gegend Name rechtmäßigen Regent förmlich Besitz nehmen -- Paulines Vater -- 
  Feierlichkeit überall begrüßen Paulin -- Festlichkeit Kranz überreichen -- fesselt Schönheit -- Anmut -- Bewegung begleiten -- Auge -- Aufmerksamkeit kommandierend General -- schön -- mittlerer Alter fast jugendlich lebhaft feurig Manne -- 
  mehrere Fest -- Seele Königin schön Paulin -- Woche erklären Paulines Vater Liebe -- 
  Zufriedenheit Vater allgemein bewundert Kriegsheld -- Glücksgütern reich -- Ruhm -- leiden Zweifel -- Paulin Zustimmung halten Vater Bewerber gewiß -- General überall bemerkbar Mann vorzog -- verbergen -- geistvoll Unterhaltung -- Betrag -- wohlgefällig Zug Gesicht ziehen fühlen -- 
  dennoch erblaßen -- Vater Bewerbung General Hand -- 
  suchen vergebens Ausflücht -- -- ergriffen freundlich Ermahnung Vater -- entdecken sogar früh Neigung Werner -- 
  Unbekannt Ansicht Welt -- ahndet -- Entdeckung Hoffnung benehmen müssen -- erscheinen Vater Weigerung bloß -- verändert Maske Wünschen entgegenstehend Liebe -- Wahl Kloster -- Gehorsam Wille Vater -- Folge Entdeckung -- 
  schwärmerisch Paulin -- Wahl Wunsch Vater vereiteln -- Tod Rittmeister Vernier -- -- verstellen fein Schonung hinterbracht -- scheinbar Teilnahme Vater Trauer -- bewirkt Monat Erfüllung väterlich Wunsch -- 
  Bemühung General -- jung Gemahlin Freude Jugend Schönheit glänzend gesellschaftlich Verhältnis genießen lassen -- verdunkelen Werner's Bild -- 
  fühlen glücklich denken selten Glück -- einst Träne Wunsch Vater opfern -- 
  Werner leben abgeschieden Freund Erinnerung -- Herz -- 
  indessen Stunde -- energisch Gewalt Liebe Erinnerung umleuchten -- glänzend Pracht Leben erscheinen bloß vorüberrauschend Fest -- Freude heimisch -- Beziehung verlieren -- 
  einst -- froh Siegesnachricht feiern -- Paulin -- umstrahlt leuchtend Kerze -- feiern glänzend Kreis Gast Gemahl Huldigungen Reiz annehmen -- General plötzlich Gesellschaftssaale rufen -- 
  Paulin blicken -- unerklärlich Angst treiben -- -- bemerken -- freudig arm jung Offizier eilen -- 
  Ahndungsvoll bebend sehen Gesicht fremde -- 
  Sohn -- 
  Tod erstanden Sohn -- rufen General -- führen Offizier Rausche Freude Gemahlin entgegen -- 
  Pauline sinken Anblick leblos Boden -- 
  5. Augenblick treten Wald überraschend schön Anblick unterbrechen Erzählung -- 
  beleuchtet Mond hoch Mauer -- ausgedehnt Ruine -- 
  linke treten Säulenreihe Schiffes -- entblößen verfallen äußern Mauer -- hell -- weiß Mondlicht hervor -- Seite liegen Schatten -- 
  vorn -- ehemals hoch Chor Altären stehen -- drang voll Schimmer Mond -- 
  fallen prächtig hoch Portal Kirche -- malen Schatten Säule -- wandelnd -- dunkel Gestalt innerer Mauer nördlich Abseit -- 
  Krümmung unser Weg zeigen freistehend Seite Säule deutlich -- öffneen tief Einsicht Länge Schiffes vorderen Portal -- Pfeiler Vorhalle innig seltsam beleuchten unermeßlich Perspektive verlieren scheinen -- 
  Ausruf Bewunderung unterbrechen Betrachtung -- Stelle ankamen -- vormals Hochaltar stehen -- 
  Baum bezeichnen zufällig -- 
  bewundert schön Verhältnis innerer Portal -- ungewöhnlich Höhe Täuschung Mondbeleuchtung riesenhafen heben -- 
  Nische -- Sage Paulina's Grabstätte enthalten -- liegen Dunkel -- Täuschung Raum -- decken halbversunken moosbewachsen Steinplatte Rest heilige -- 
  betrachten ernst ruhig einsam Stelle -- Abendwind -- Zweig Holunderbusch Grab flüstern -- unterbrechen Stille -- 
  durchwandelt einigemal Schiff Abseite Kirche nebst Vorhalle -- Einzeln betrachten -- Gesamteindruck feierlich ernst Umgebung aufnehmen -- 
  Beschauung Teil sparen folgenden -- 
  ermüdet begeben Mittagsseite Kirche gelegen -- Amtshause gehörig Gärtche -- lagern weich grün Moosbank schönbelaubt Birnbaum herrlichen Anblick mondbestrahlt Ruine nossen -- 
  -- Blume umblüht alt Birnbaum mächtig Ast Häupt hinstrecken -- ehedem Platz fromm Beter kirchlich Prozession vormalig Klosterbrüd -- Gärtche liegen ehemalig südlich Abseit Kirche -- Eingange gelangen außen Weg hoch Chor Kirche -- Paulina's Grabstelle südlich -- 
  Seite Garten Säule Schiffe begrenzen -- Moosbank hoch Bogen Säule gegenüberstehend Säulenreihe -- Portal -- Abseite hoch Chore führen -- nochmals Bogen Paulina's Grabnische -- 
  sehen Perspektive hoch Bogen -- Punkt -- Zerstörung Altär -- einzig Heiligtum Kirche -- Gebeine Stifterin -- frommen Sage Volkes -- aufbewahren -- 
  Mond zaubert Schatten Baum -- Wind bewegen -- fantastisch Scheinleben verödet Raum -- still Leben andächtig Zurückgezogenheit stillere Pflanzenwelt übergegangen -- Wipfel Baum lispelten Nadel Blatt leisen Nachhall ehemalig Höre Vigilien -- 
  mahnen Seite versprochen Mitteilung Paulina's Geschichte -- 
  ziehen Blatt hervor -- erinnern -- Windlicht Lesen besorgen -- Julius Fortsetzung vorhin unterbrochen Erzählung -- 
  6. Julius beginnen -- 
  Paulina Ohnmacht erwachen -- finden Natalie -- ehemalig vertraute Liebe -- 
  schwach fühlen -- dennoch notwendig -- erforderlichen Aufschlüsse Vorfall Folge geben -- 
  General -- überwältigen Freude -- totgeglaubt Sohn sehen -- schnell Ohnmacht Gemahlin bemerken -- Veranlassung -- 
  schreiben Zufall Rechnung heftig Überraschung -- Wirkung fühlen -- erschrecken Sohnes scheinen Anblick unerwartet Zufall ebenfalls Verborgenes deuten -- 
  jung Offizier anderer -- Werner -- Gefangenschaft -- unerkannt bleiben -- Vorname Familiennamen führen -- 
  Bedeckung Anzahl gefangener angreifen -- Werner -- Kamerad günstig Zeitpunkt benutzen wissen -- nebst befreien -- ehrenvoll Teilnahme glänzend Sieg -- Vater eilen -- neu Oberbefehl fechten -- Zustimmung Verbindung geliebter erhalten -- 
  Unbenachrichtigt Veränderung väterlich Haus finden Geliebte Mutter unwiederbringlich hoffnunglos verlieren -- -- 
  Natalie führen sogleich jung Grafe Werner Pauline -- -- unvermeidlich Zusammenkunft -- vertrauen Auge Freundin ausstellen -- 
  gönnen Ungestört -- tränenvoll Umarmung schmerzlich Wiedersehen -- Auge auswein Herz Schmerz ergießen lassen -- 
  Erhebung Geist beschließen ewig Trennung -- liebend Herz edl Gemüter -- 
  Geschick -- währ gute feindlich -- scheinen Entschluß reinsten Willen begünstigen -- 
  Vater wiedergefunden Sohn schnell entlassen -- vereitelte wider erwarten schnell geschlossen Friede Hoffnung unglücklich liebend -- Schlachtgewühl -- feindlich Schar Ruhe finden -- nah -- Welt Glück -- ewig Zurückfloh -- 
  stark fühlen -- tief Empfindung bewegen -- Liebende tadeln -- Vertraulichkeit -- Nähe -- Familienverhältnis gestatten -- fordern süß Name früheren -- kurz Zusammenleben gewöhnt -- ehrfurchtvoll Beziehung gegenwärtigen -- 
  Reise -- General Familie Bad -- bringen Liebenden nah -- 
  Ruine Paulinzell erneut früh Schwüre ewig Liebe -- wahrscheinlich doppeldeutig Name -- Werner Pauline -- Fremdenbuch eingetrag deutungvoll Kranz Dorn Rose umwunden -- 
  einst -- schön warm Abend nördlich Deutschland verhängnisvoll Herbst -- suchen General Gemahlin weitläuftig Garten Schlosses -- 
  Gewitterwolke -- heißen sammeln -- ziehen herauf Fing -- fern Blitz entladen -- 
  Besorgt Gemahlin -- Gewitterfurcht kennen -- durchsuchen Laube -- finden entfernt Pavillon -- hingelehnen Sofa arm liebkosend jung Offizier geschlungen -- Kniet -- 
  Ausbruch Schreckens Unwillen verraten Liebende -- Offizier wenden Eintretender -- General erblicken entsetzen Sohn Arm Mutter liebend umfangen -- 
  Furie getäuscht Liebe beleidigt Ehre reizen Zurückschaudernde wildesten Wut -- rein Unbescholtenheit schön Verbrecherin -- selten Glück stolz -- stehen schauderhaft Erzeugnis ungeheuerst Schuld -- 
  gesprochen Wort Abscheus drängen Lippe -- 
  Bittend nahen Sohn -- entehrend Beleidigung treiben -- flehend erheben Schuldig Hand -- unwürdig Mißhandlung Zürnende stoßen hinweg -- 
  Beschützend stellen Sohn Weinend beteuern Reinheit Liebe -- Ergrimmt hören -- schmähend fassen Brust treten entrissen Ordenskreuz Fuß -- 
  halten beleidigt Ehre Krieger -- 
  Säbel zischen Scheide -- Augenblick flammen Deg Vater Haupt Sohn -- 
  Schlag fallen Schlag -- Blitz spiegeln glänzend Kling -- beleuchten unnatürlich Kampf -- 
  vergebens ringen Paulina flehend Hand -- Donner überbrausen Stimme -- reißen empor Kämpfende trennen -- wild -- selbstvergessen Wut führen General fruchtlosen Hieb -- Augenblick röten Klinge Sohn Blut bloßgegeben Seite Vater -- 
  Fluch -- schreien General verwundet Brust -- sinken letzter kraftlos Hieb -- Strom Blutes weitgeschlagen Wunde preßen -- entseeln Boden -- 
  Vatermörd -- rufen Donner Sturm hingesunkenen blutig Leiche -- -- Vatermörd -- hallter unendlich Echo Herzen -- 
  Verzweiflung wenden blutig Klinge Brust -- währ Sühnopfer entsetzlich Hand fallen -- Offizier -- General suchen -- Lärm gefechte herbeieilen -- verhindern -- 
  Offizier -- Freund Unglücklichen -- erriet gräßlich Begebenheit -- treiben Grafe eiligst Flucht -- 
  General -- meinen -- können Leben rückrufen -- dürfen Sohn sehen -- Strafe übergeben müssen -- vergessen -- 
  Vorstellung Graf Wernern Flucht bewegen -- 
  werfen scheidend Paulin nieder -- Abscheu weisen -- 
  fliehe -- Unglücklicher -- -- rufen -- fliehen -- niemals -- niemals -- sehen -- 
  schnell Tod fassen -- ehe jemals nahe -- 
  furchtbar Donnerschlag scheinen Wort Schicksal zuzurufen -- 
  Graf verhülln Gesicht -- furchtbar Gewitternacht -- still Stürme Inneren -- verlassen Geliebte väterlich Schloß -- 
  wählen -- wohin Weg richten -- 
  Krieg Preußen Frankreich ausbrechen -- Begier Kampf Sieg ziehen preußisch Krieger französisch Heer entgegen -- 
  Graf Werner eilen -- Schlacht -- willkommen Tod finden hoffen -- 
  fochen Oktober Jahr Saalfeld -- Ungeduld streben rasch Vordringe tapferen Krieger zuvor -- heldenmütig Prinz Opfer mutig Angriff -- 
  Werner kämpfen Löwenkraft -- 
  fochen Seite Prinz -- nahe Mitte Feind glücklich befreien -- Prinz verwunden Boden sinken -- 
  unglücklich Werner Tod finden -- sehnsuchtvoll suchen -- 
  siegern verwundeter aufheben -- -- gefangener erkennen -- sorgfältig bewachen Frankreich abführen -- 
  heilt Kunst Arzt Wunde -- krank Gemüt vermögen Kunst heilen -- 
  Schwermut Melancholie -- still Wahnsinn -- 
  leben Frankreich anständig Versorgung -- einzig Wunsch -- gewiß Erfüllung fest Vorstellung Wahnsinn -- bestehen Sieg Vaterlande -- erfechen helfen -- 
  lassen unschädlich Wahn -- freudenleer leicht Schimmer Frohsinn überglänzen -- 
  Armer Unglücklicher -- -- seufzn mehrere Stimme Gesellschaft -- 
  seufzen leise -- klar -- Graf Werner -- Graf O .. -- Bekanntschaft Frankreich -- Person -- 
  Innig vertraut kurz -- niemals Geheimnis tief Schwermut entdecken -- ungemein anziehend -- 
  Interesse Paulinzell -- Feuer -- heilig Paulin -- Schutzheilig sprechen -- Art -- verschieden Überlieferung verarbeiten -- ähnlich Begebenheite Geschichte Leben Liebe schließen -- 
  verschweigen indessen Vermutung bereiten -- Blatt unglücklich Freund -- neu Interesse erhalten -- vorzulesen -- 
  7. Umfanget -- einsam Klosterhalle -- heilig Rest altehrwürdig Pracht -- 
  baut Liebe -- Haß lassen verfallen -- stets unterliegen Schön Dunkler -- 
  Glück erblühen -- fordern streng blutig Tränenopfer bringen -- 
  verbunden Herzen qualvoll scheiden -- Grausam trennen -- vereinen leiden -- 
  O steigen herauf -- mitternächtig Schatten -- Verlassen Grabeszelle finster Raum -- Erheben eur Gruft schwer Platte -- Umschwebt Auge -- Bild luftiger Traum -- -- dunkel Stunde gestatten -- Sprecht Nachtgeflüster Baum -- Grab heilig Boden sproßen -- Sprecht Leid Glück -- nossen -- 
  Sprecht -- kalt Stein heißen Menschenbrust einst ausgeglühen -- 
  Vergißt müde Auge weinen -- 
  Keimt unten Trost verzweifelnd Gemüt -- 
  Saht Land -- modernd Gebein schön Lenz Glauben jung entblühen -- 
  Liebe selig Frieden störeen -- verbinden -- Angehöret -- 
  deuten düster Geflimmer -- fern Chor Grabesstein entstrahlen -- 
  nahen Dom bemoo Trümmer -- Grab schweben Blasse Nachtgestalt -- Mondsstrahl -- matt Schimmer Säulenreihen bewegen Bild malen -- bist_es -- wehmutvollen Ernst Miene -- Erkennt Auge -- -- heilig Paulin -- 
  kommst Trost lichterfüllt Ferne -- Himmel Frieden strahlen Angesicht -- 
  Mensch -- -- lernen -- Halten Gewalt irr Wahn Gericht -- heilig gelten droben Stern -- 
  -- rein Herzen Stimme sprechen -- 
  Rose blühn rauh Dornenkrone Himmel ewig Frühlingzone -- 
  Lesen letzter Verse bemerken fast störend Unruhe Zuhörer -- 
  -- schreien Mathilde laut -- heftig Schauder zittert Glied -- 
  sehen -- -- fragen Theodor -- glauben -- täuschen -- 
  -- 
  -- fragn mehrere -- blickn starr Ort -- Theodor Auge zuwenden -- 
  blass Schein bewegt Ferne Schluß Aussicht verschieden Säulenbog -- 
  -- Amalie erzwungen Fassung -- dicht Nische Chor -- 
  Frau schauderten -- 
  sehen Paulina's Grab -- 
  -- Theodor verweisend -- -- 
  Schatten fürchten -- 
  sehen -- -- sitzen -- Mond hoch steigen -- 
  beleuchten Stelle -- vorhin -- -- 
  bewegen -- -- rufen Mathilde -- Frau eilen -- 
  kindisch Furcht -- -- wiederholen Theodor unwillig -- Mondschatt verjagen lassen -- gegenseitig auslachen -- beherzt -- 
  Holunderbaum vergessen -- sehen -- Mond Äste beleuchten -- Wind bewegen -- 
  sucht Herzhaftigkeit abgewinnen -- 
  sehen deutlich Bewegung mondbeleuchtet Zweig -- zeigen -- Täuschung entstehen -- 
  Gestehen -- Amalie -- äußerst täuschend -- sehen -- -- -- -- -- 
  unverkennbar schweben weiß -- düster Schatten Grabstelle Paulina's hervor -- Chor Kirche gegenüberstehenden Seite -- 
  Beherztest verstummten -- 
  denken Flucht -- blickt Tür -- nahe schwebt Gestalt Paulina's Grab -- weiß -- faltigen Totengewand -- 
  lauter Schrei Entsetzen zittert Gesellschaft -- 
  Paulina -- 
  Paulina -- rufen bewußtlos Angst mehrere Stimme -- 
  nennen Name -- -- 
  tönt sanft leis Stimme -- Paulin -- 
  8. Theodor -- Besinnung wiederkehren -- treten Erscheinung Schritt entgegen -- 
  Mitternacht umher -- -- 
  fragt fest Stimme -- 
  Fall -- antwortet Gestalt -- ebenfalls Chor Kirche Garten treten -- Fall Nachtgeist -- Spiel -- 
  wahrscheinlich führen gleich Absicht hierher -- Ruine Mondbeleuchtung sehen -- 
  tun leid unangenehm Art stören -- setzen hinzu -- leicht Verbeugung wenden -- 
  Theodor stehen betreffen -- 
  unbefangen Herzhaftigkeit -- Erscheinung angereden -- werfen Schein Gespensterenglauben -- überdies fest Ton Anrede leicht Auflösung Abenteuer gesellig Zusammentreffen anstrich pedantisch Ungeschicklichkeit bekommen -- -- Angekommen -- Verlegenheit setzen -- 
  entschuldigt Entgegentrete Geisterfurcht Gesellschaft -- -- Gespräch -- Lektüre Ungewohnte Ort erhöht Stimmung -- 
  gegenseitig Hülfe -- fremde mischen gesellschaftlich Gespräch -- 
  erkennen melodisch sanft Ton sogleich schön unbekannte Mittag -- 
  Schleier Mondlicht Täuschung Geistererscheinung erhöhen -- 
  gesprächig Lebhafter unser früh Zusammentreffen -- 
  scheinen -- währ Schmerz nehmen -- Geist bewegen frei Aussicht ungetrübt Zukunft -- 
  scheinen Begleiterin ernst -- froh -- beinahe exaltiert Stimmung Freundin besorgt -- 
  Gespräch bitten Paulin -- Erzählung Leben heilig Namensschwester -- unterbrechen -- fortsetzen -- 
  ergriff Blatt -- setzen Nähe -- -- Mond schön -- blass Gesicht wiedergekehrt Heiligen verklärn -- 
  schauerlich Mut Anblick -- ähnlich Stimmung scheinen Gesellschaft verbreiten -- 
  sehnt nah -- lager Fremdartig -- berühren Scheut -- 
  Lesen Paulin Geschichte bemerken Träne Auge fast glänzt tiefblau Auge schwärmerisch Lächel feucht Wolke -- 
  9. fahren fort lesen -- 
  Altar heilig Kreuz stehen Priorin Klara jung Ritter Werner -- Blick wohlgefällig Säulenreih Kirche hingliten -- Bild Verzierung lächelnd -- ernst hafteten -- 
  zuweilen blitzt Auge hell Feuer -- flüchtig rote überflog Wange -- gehen Licht Gedanke -- verklärt jugendlich Schönheit -- 
  jung -- Herr Ritter -- Priorin -- verwundern Beifall betrachten -- dennoch sprechen euer Wort -- fast euer Blick Ernst Erfahrenheit geübt Meister -- 
  euer Reise Italien heilig Land sicherlich schön Kirche Münster sehen -- 
  arm Kirchlein freilich Prachtgebäude messen -- sä -- unverhohlen sagten -- mißfällig -- gut Rat gäbet -- gut -- 
  irret -- fromm Frau Priorin -- entgegnet Ritter -- meinen -- werfen Auge umher -- Bau Bildwerk Eurer Kirche mäkeln meistern -- 
  Krittel leiden -- nutzen selten -- verderben Mensch Wohlgefallen Freude -- leiben -- solch töricht Ding beginnen -- 
  vielmehr lob Meister -- euer Kirche bauen -- 
  verständig überlegen -- Kunst ausführen -- italisch griechisch Meister bestehen -- 
  überdies Bau verborgen Funke legen -- herausspringen zünden -- Auge treffen -- 
  meinen -- -- 
  fragt Priorin -- 
  -- fahren Ritter fort -- Werk gleichsam Samenkorn -- dergleichen äußerlich anmutig Gestalt -- Gestalt innerer Leben -- regen -- -- Grund finden -- ausdehnt herrlicher Gestaltung -- 
  vorhin ansahen -- Gebäude Eurer Kirche betrachten -- Keimen Samenkornes -- 
  Zeichen trefflich Geist -- Werk Geist zünden -- Keim neu Werk wecken -- 
  Meister -- vorhin -- verständig geordnet messen -- denken Kirchlein groß Raum -- Säule Pfeiler streben -- wachsend Zeder -- groß Höhe -- vermehren Schiff Halle -- steigen schön gewölbt Portal hoch hinauf -- Glanz Licht Hochaltar Wölbung erreichen -- würden edl Masse anstaunen -- 
  solch Werk dämmeren Geist vorhin -- -- -- 
  verstehen -- Priorin -- währ Werk Platz -- Kloster -- 
  -- erwidert Ritter -- Kirche euer Klostergut erschöpfen überdies Eurem Münster passen -- Riesensäule Kirchenhallen -- 
  überall nachteilig -- Ding streben -- ergreifen -- Mensch Kreis -- 
  sprechen wahr Wort -- Priorin seufzend -- Möchten beherzigen -- 
  -- vergeben -- Sprecht Scheu -- fahren Ritter fort -- sehen -- herrlich deutsch Kaiserkron -- glänzend Sonne Europa -- Grafenburg Raum finden -- 
  welch Mann Rudolph -- ehe Krone Hand strecken -- 
  Welch edl -- trefflicher Held Baierherzog Otto -- 
  Krone Last zerbrach Herzogtum Leben -- 
  rechtlich häuslich Hermann lassen Glanz verlocken zerrissen schön Gewebe Leben -- verstören Freude Burg -- gefährlich Herrscherskleinod Hand Mächtigen zurückgeben -- gebühren -- 
  -- Brecht -- sprechen Priorin -- gründen -- Markgraf Thüringen -- -- -- 
  verleumden -- hoffen -- Feind Neider -- erwidern Ritter heftig -- 
  gewiß -- tönt sanft Stimme Nähe jung Nonne treten Seitenhalle -- unselig Unruhe -- Deutschland verwüsten -- ewig dauern -- 
  Ritter vergaß schön Erscheinung zürnend Rede fortsetzen -- 
  Kostgängerinne -- Priorin -- Herzugekommen deutend -- kommst hierher -- Paulin -- 
  vergebt -- ehrwürdig Frau -- antworten -- 
  betet Halle Muttergottesbilde -- euer Gespräch -- zuhören -- ziehen Gedanke Gebet -- 
  Bau Kirche redeten -- -- sprächt heimlich Wort Seele -- 
  erhöhen erweitern -- -- Kirche Traum -- erstenmal beten -- stehen Altare heilig Kreuz -- Braut herrlich schmücken -- freut schön Kirchenbaues -- 
  Traum längst vergessen -- euer Rede rufen Gedächtnis -- 
  seltsam -- sprechen Priorin -- jung Ritter -- baukundige Meister sprechen hören -- 
  Ei -- entgegnen -- meinen -- Ritter sollen bloß Schwerte drein schlagen -- 
  Ehre Gott -- Ritter Höchste -- Stein Balken ordnen -- -- schön Dom zusammenfügen -- Gemüt Andacht wecken Kyrie Gloria freudig widerhallen -- gleichwie Stein fromm heilig Am -- 
  Schwert müßig -- -- Ritter Streich abzulernen suchen -- -- Andacht erwecken lernt Meister Kunst -- wundervoll Werk -- 
  Gespräch führen Priorin Ritter Kirche Halle -- fragt Malerei Bildwerk -- 
  Paulin fragt hört wohlgefallen Antwort -- 
  Halle treten -- bleiben Ritter ernst Miene Muttergottesbilde stehen -- Blick ruhen angeheften -- 
  Bild müßen Nachsicht -- Herr Ritter -- Priorin lächelnd -- bloß Werk andächtig Liebe heilig Mutter -- 
  sagen -- erwidern Werner -- Bild zierder Eur Kloster -- 
  keiner -- gleichen -- 
  neu -- bitte -- nennen Meister -- Wunderbild malen -- Eile -- spotten -- unterbrach Priorin -- Bild lieb Tochter Pauline malen -- 
  brauchst Andacht schämen -- Kind -- 
  welsch Meister -- Bild heilig malen -- Paulin zugegen -- Probe Kunst zeigen -- bestehen -- Angesicht für Muttergottesbild abzumalen -- fromm Tochter verweigern Antlitz standhaft -- Frevel halten -- Bildnis Kloster Anbetung aufstellen lassen -- Maler malen -- Angesicht -- malen heißen brünstig Gebet Bild -- sehen -- 
  meinet -- gelingen -- heilige preisen -- Fleh Magd erhöret -- 
  Ritter aufhören -- Bild betrachten preisen -- Paulin fragen -- worüber Rat begehrn -- Schleier zurückwarf -- Auge himmlisch Angesicht wenden -- Schleier -- Engel licht Wolke entgegenblicken -- 
  Paulin bemerken -- Frage vertiefen -- erstaunen -- Priorin sprechen Ritter heimlich -- welsch Maler -- heiligste Muttergottesbild Pauline bilden -- schön bilden Natur Pauline -- 
  sprechen Ritter Kloster -- 
  entdeckt Priorin -- Paulines Anblick unbezwinglich Sehnsucht Herz erfüllen -- Sohn thüringisch Markgraf Egbert -- Pauline unwiderruflich Kloster vermählen -- Wille -- Hausfrau erwählen -- 
  -- Herr Ritter -- erwidert Priorin -- Hoffnung zusagen -- Paulin -- vernehmen -- weder Nonne -- Noviz -- Kloster Pflege Erziehung anvertrauen -- 
  Eltern -- geistlich Stande bestimmen -- Geheimnis -- 
  Mann -- erhalten -- -- Tochter vornehmen reich Ritter -- Name Moricho -- 
  Summe -- jährlich Kind auszahlen -- bezeigen Reichtum Vater -- 
  Moricho -- Kind -- Lieb scheinen -- fern erziehen lassen -- kund -- 
  Kennt Ritter Namens -- wissen -- Eurer Liebeswerbung wenden -- 
  indessen verbergen -- Markgraf -- euer Vater -- lang Kloster besuchen -- reichlich beschenken -- 
  besonderer Wohlgefallen Paulin finden -- fast väterlich zusprechen -- loben -- Hindernis fürchten -- 
  Ritter Name Moricho unbekannt -- Priorin -- 
  beschließen -- Hofe Kaiser fragen -- Priorin -- Sohn mächtig thüringisch Markgraf willkommen Bewerber Liebling -- gestatten Zusammenkunft Auge Pauline -- segnen jung -- schönaufblühend Liebe Abschied Ritter segenswünsch Gebet -- 
  Ritter Werner Hofe Kaiser Heinrichs Nachfrage Ritter Moricho halten -- finden Markgraf Egbert Nähe Klosters -- 
  wohlgefallen jung -- fast kindlich Paulina -- Priorin väterlich Zuneigung bejahrt Mann halten -- anderer Art -- Paulina's selten Schönheit Herz Markgrafe heißest Liebe entzünden -- gleichwohl tief Inneren verbergen glauben -- -- Unterschied Gesinnung Tochter -- Braut Pauline erwarten lassen -- vorzüglich -- Entdeckung fürchten -- Leidenschaft verzeihlich Torheit furchtbar entsetzlich Verbrechen umwandeln -- 
  Markgraf Egbert früh Zeit Kloster teur Pfand anvertrauen -- Frucht Liebe -- -- mächtig Liebenden -- mächtig Kirche ewig verbergen bleiben müssen -- 
  Vater Mutter weder Kind Pfleger -- selten wagen Markgraf Zügen ungefähr Kloster verweilen -- Zögling schön Kind Liebling auswählen -- 
  schmeichelt Möglichkeit -- vorgezogene nah -- bloß Wohlgefallen angehören -- 
  letzter Besuch fürchten -- hören wünschen -- bestreiten Heftigkeit Behauptung alt Diener -- einzig Mitwisser Liebe -- Pauline Kind Geheimnisses -- 
  Frage Name -- Kind aufnehmen -- freilich Schleier heben -- Markgraf Bild entsetzens Schleier erblicken fürchten -- scheut Berührung -- 
  Ungewißheit -- Täuschung Möglich -- einzig Trost -- Paulina's Bild tief Leben verweben -- tragen -- -- Geliebte denken -- 
  suchen vergebens Neigung verbergen -- Rächerin früheren -- verboten Liebe erscheinen -- 
  zuweilen Vorstellung Leidenschaft Nahrung -- 
  glaubt Geschick entgehen -- Seite angefangen Werk gewaltsam fortgerissen -- scheinen hoch ergreifen -- Widerstrebe Ziel leiten -- 
  dreimal -- Rudolph -- Otto Hermann -- sächsisch thüringisch Fürst mißglücken -- Markgraf Egbert erringen -- 
  Freiheit verhaßten Regierung Kaiser Heinrichs -- 
  groß Zahl Fürst Bischof Markgrafen deutsch Königskrone bestimmen -- Rom bringen Kardinal Legat begünstigt künftig Reichsoberhaupt -- apostolisch Segen -- Versicherung Gelingen kühn Unternehmen -- Ablaß zukünftig -- gelingen fördern fördern unternehmen -- 
  jeder Kleinod kirchlichen Löse Bindegewalt apostolisch Stuhl aufgeboten -- zögernd Egbert rasch anzufeuer -- -- verzehrend Leidenschaft -- Sehn entsetzen -- untätig Kloster treiben -- mutmaßen -- 
  zögern gelten Unentschlossenheit -- Verheißung aufbieten -- 
  treiben finster Sturmnacht Mauer umhe -- redet alt Diener -- kenn euer Herzleid -- tief verbergen meinen -- 
  lieben schön Pauline Kloster -- 
  Nehmt Eurer Hausfrau -- Forschet nimmer Geheimnis Geburt -- bleiben euer Gewissen ruhig -- 
  wissen -- euer Tochter -- 
  Bestandest ehedem -- fragt Markgraf -- 
  -- entgegnen Benno -- Papst -- irren -- 
  wünschen -- sehen -- wünschen schön Fräulein Tochter -- 
  Egbert lassen überreden -- 
  begib folgend Tag Priorin -- erklären Absicht Pauline -- 
  Priorin -- näh Verhältnis Markgrafen Pauline ahnden -- entsetzen bloß Gedanke -- Vater Sohn Nebenbuhler sehen -- halten ratsam -- Markgrafen früh Liebe Sohn verbergen -- 
  glauben geliebt Pflegetochter Werner Rückkehr sichern -- Entscheidung Ritter Moricho -- Paulina's Vater berufen -- Vorwissen Paulina verfügen dürfen -- 
  Egbert hören entsetzen Namen Moricho -- 
  Name -- Liebe hören nennen scheut -- vormals Paulin Kloster anvertrauen -- 
  langgefürchtet Gewißheit stehen Schrecken -- 
  vermögen Besonnenheit sammeln -- Priorin heftig Bewegung verraten -- 
  kenn Ritter Moricho -- erwidern erzwungen Stolz -- sehen -- Markgrafen Tochter versagen -- 
  Werner indessen vergebens Hofe Kaiser Ritter Moricho fragen -- 
  Auskunft -- 
  gering Glück forschen Höf Fürst -- 
  Überdrüssig lang vergeblich Suchen ziehen Paulines Kloster -- überzeugen -- Moricho -- aufzufinden -- erscheinen -- Tochter zurückzufordern -- 
  finden Priorin hoch Bekümmernis -- suchen vergebens -- Entdeckung Kummer bewegen -- 
  scheinen beruhigen -- Grund Wahrscheinlichkeit aufbieten -- beweisen -- Ritter Moricho müssen verschollen -- fremd Land -- Ungläubig -- bleiben -- hoffen -- Markgraf Sohn Zustimmung Paulina's Vater erhalten -- Hoffnung -- Liebling retten -- vernichten -- 
  halten -- Sohne Neigung Vater Paulin entdecken -- 
  entfernen -- beschwören nochmals Ritter Moricho aufsuchen -- Werner -- ungeduldig Hindernis -- Liebe entgegen stellen -- unzufried Bedenklichkeit Priorin -- eilt -- Vater aufsuchen -- Rat Beistand begehren -- 
  Markgraf Egbert indessen längst drohend Streich fallen -- 
  Befang wild Leidenschaft -- vergessen Besonnenheit Tätigkeit -- Weg deutsch Kaiserthron nötig -- 
  Mangel Zusammenhäng Plan -- Säumnis Übereilung stört Ausführung -- 
  verbündeter verlieren vertrauen -- mehrere verlassen -- 
  entschiedenst Augenblick sprechen Kaiser Empörer -- 
  unsicher -- Riesig begleiten -- ziehen Markgraf Burg Burg umher -- suchen weniger treu verbündeter Untergange entgehen -- stolz Ziel Streben erreichen -- 
  Werner suchen geächteter -- Flüchtig vergebens -- 
  lang umherziehen beschließen Aufenthalt geliebt Paulin zurückkehren -- entschließen -- besitzen -- Beistimmung Priorin -- Gewalt -- 
  Brief Pauline machen erster Hoffnung -- gebrochen geächteter heben Furcht vormals gewaltig Markgraf -- Priorin zeigen Paulin froher Aussicht Zukunft -- 
  Voll schön Hoffnung ziehen Werner Kloster -- weinend trostlos Priorin entgegen -- 
  Ritter Moricho Boten senden -- Pauline Vater zuführen -- 
  Vergeben Priorin jeder versuchen -- Auslieferung Liebling auszuweichen -- Bote Glaubwürdige unzweifelhaft Zeugnisse versehen -- Ritter send -- einst Paulin Kloster übergeben -- müssen nachgeben -- 
  Kummer erhöht Ungewißheit Paulinen's Zukunft -- Bote verschweigen tief Geheimnis Ort -- Reise richten -- 
  Werner wüten -- Nachricht vernehmen -- 
  forschen Umwohner Kloster Weg -- Paulina's Entführer nehmen -- vergebens -- 
  wissen Bestimmt nachweisen -- 
  schwach Wahrscheinlichkeit bauend -- Weg Braunschweig wählen -- sammelt Leute -- Spur verfolgen -- traut Auge -- Paulin -- begleiten Landleute -- Kloster zueilen -- 
  überraschen entzücken fliegen geliebter entgegen -- abwenden Zeichen Grauen weisen Pauline -- 
  fliehe -- Unglücklicher -- -- rufen -- fliehen -- schnell Tod fassen -- ehe jemals wiedersehen -- 
  starr Schrecken stehen betroffener Paulin fliehen abwenden vorüber Arm mütterlich Freundin Klara -- 10 -- 
  Fremd schmerzlich Bewegung ergreifen -- 
  bestreben -- unterdrücken -- verraten Eindruck -- Erzählung scheinen -- 
  halten Lesen -- Begleiterin nähert Zeichen Besorgnis -- 
  weisen dankbarem lächeln -- bitten Fortzulasse -- 
  -- setzen hinzu -- dergleich rasch Vorsätz freveln -- Frevel bleiben jeder Gelübde -- Heiligst -- 
  ahnen -- Pauline Frevel büßen -- glücklich -- büßet Tod -- herb Schmerz -- 
  sprechen Wort erhöht Anstrengung legen Schluß -- ermatten Arm Hals Freundin -- 
  streng -- Amalie -- Ernst Augenblickes milderen -- vergessen -- Augenblick -- geängsteten -- verstört Gemüt Trost bleiben -- unzerreißlich Bande Gelübd fest fest heilig schlingen -- 
  O -- kenn Lockende heilig Versuchung -- erwidern Fremde -- Gemüt erliegen -- 
  vergessen -- frevelhaft Anmaßung -- trügerisch Einsicht Augenblickes -- unverletzlich Heiligkeit Gelübd ewig Wahrheit stempeln -- gewiß -- niemals bleiben Frevel ungestraft -- 
  streng -- wiederholt Amalie -- Gelübde -- jemals trüglich Einsicht beruhn -- 
  gewiß niemals -- antworten weich dennoch überzeugend fest Ton -- bleiben ewig -- Weg gut Ziel -- 
  neigt Wort leisen Kuß Amalie -- -- wenden -- winken lesen -- 
  fahren Erzählung fort -- 
  stürmisch Abend sitzen Markgraf Egbert -- flüchtend Verfolger -- voll düster Verzweiflung Mühle Eisenbüttel -- 
  Benno Mönch sitzen -- Müller spähen draußen Dach Mühle -- Straße ruhig -- erlaucht Gast sicher -- 
  zuweilen kommen einzeln Wanderer begehrt Einlaß -- erzählt -- unkundig -- sprechen -- forschenden Mönch Markgrafen -- Fürst abfall -- Reichsacht scheuten -- Markgraf feig Unentschlossenheit handeln versäumen -- 
  -- setzen hinzu -- Gemüt leiden -- Sinn mächtig -- 
  -- -- hört Markgrafen tief kummervoll seufzen -- zuweilen durchschaur Ahnung nah Wahnsinn müssen abmühen -- unterscheiden -- Wahn künftig -- anfang Gedanke umspinnen -- 
  Wanderern unheimlich bang Seufze gehen stürmisch Nacht hinaus -- trüben Gast Herberge verweilten -- 
  spät Nacht Reisiger erzählt Unglückbotschaft -- 
  markgräflich neu teils schlagen -- teils Kaiser übergehen -- 
  kann_es verargen -- setzen Erzähler hinzu -- Markgraf Egbert Kaiser Heinrich anhaben -- -- Otto -- Rudolph Hermann -- 
  Fürst vorhersehen -- 
  Mönch fordern Erläuterung -- 
  Denkt Prophezeiung -- -- habe_es Rudolph zuvorgesagen Otto -- Markgraf -- pünktlich zugetroffen -- 
  meinen -- -- fragen Benno Mönch -- 
  -- Welt wissen -- Wälschland -- erwidern Reisige -- prophetisch Weib Kaiser Heinrich weissagen -- Feind besiegen können -- Natur ungeheur Frevel erzürnen -- 
  vermögen Hildebrand Heinrich -- 
  Bund böse -- 
  Frevel wider Natur -- 
  Markgraf Teufelei treiben -- ähnlich Ding -- passen Weissagung -- 
  richten Heinrich -- 
  Markgraf Sprecher letzter Rede starr ansehen -- 
  Weissagung -- achten -- 
  Augenblick Entscheidung klingen voll tief -- furchtbar Bedeutung entgegen -- 
  ungeheuer Gelächter -- wild Geist Inneres verkehren -- fromm Regung fratzenhaft Larve umgestalten -- springen -- Ei Bursch -- -- rufen -- Stimme kreischen widerlich -- verstehst Teufelei -- 
  Fort -- hinaus -- Platz -- Meister -- 
  reisig lachen wild Markgraf -- schüttelt Hand -- Pfiff Schelmenlied hinaus -- 
  Antworte -- sprechen Markgraf Mönch -- Giebt's groß Sünd -- schlecht Gesell nennen -- 
  Hilf Herr -- -- erwidern Mönch -- Sünde entsetzlichsen -- 
  Ablaß -- -- 
  fragt Markgraf -- zittert Frage -- verlassen letzter Kraft -- 
  halten Mönch Schulter -- 
  Priester Welt -- antworten Mönch -- 
  Markgraf schauderen -- 
  mühsam erhalten aufrecht -- 
  starren Mönch wild Blick -- 
  heilig Vater -- fragt -- grell Ton Verzweiflung halln schwirrend Wänd Zimmer -- 
  Mönch faltet Hand -- 
  heilig Vater -- sprechen -- löset sünd -- glauben -- 
  sicher geringeren -- rufen Markgraf gräßlich Frohlocke -- Auge flammt Blitz umher -- Ablaß -- Werk fördern -- -- -- 
  Nacht heftig Bewegung umh -- einzeln Wort -- -- unterbrochen wild Gelächter ausstassen -- bestätigen Vermutung Benno's -- Leidenschaft Unglück Herr Gemüt zerrütten -- 
  Morgendämmerung kommen indessen günstig Nachricht -- 
  zerstreut Truppe sammeln -- fremd Reisiger Tapferkeit Entschlossenheit Markgrafen rühmen -- wunderbar Beredsamkeit vertrauen Heerführer Glück -- herstellen -- 
  kommen Boten gesammelt Heer begehrt Befehl Markgrafe erneut Versicherung unwandelbar Treue -- 
  Markgrafen schaudert froh Botschaft -- scheucht neu wild Gelächter Grauen -- einigemal düster Wolke umfing -- glücklich Begebenheite bestätigen -- 
  ordnet Besonnenheit Schlacht -- Angriff bereit -- dick Nebel bringen Unordnung Ausführung Plan -- wankelmütig Fürst drohen neu verlassen -- 
  Harret -- -- rufen Markgraf -- siegen -- 
  Stimme furchtbar gebietend zuversichtlich -- 
  Fürst Ritter versprechen abwarten -- 
  winken Markgraf vertraut Riesig -- 
  Nimm -- sprechen -- Schar Knechte zieh Kloster -- unfern nächster Stadt liegen -- 
  fordre Name Ritters Moricho Priorin Fräulein Pauline -- führet Mühle Eisenbüttel -- 
  Müller pflegen -- kommen -- 
  Priorin Fräulein weigern -- zeigen Pergament -- ersehn -- Ritter Moricho senden -- 
  wild Zuversicht Markgraf Heer umher -- 
  Verwundert -- anhaltend dicht Nebel -- feindlich Truppe verderblich -- 
  benutzen schnell Unordnung -- hindert Stellung Vereinigung Schar -- Fürst sehen unvermeidlich Niederlage Feind -- einbrechend Nacht aufschieben -- 
  Froher Jubel schallt Heer -- rüsten -- Strahl Morgen Schlacht beginnen -- 
  ziehen Markgraf Egbert einzig Knappe begleiten -- still Lager mühl Eisenbüttel -- 
  Mühle rauscht Gänge Sturmwind streut Schaum -- Räd schnell Umtrieb emporrissen -- umher -- 
  Egbert schauderen fast -- Knappe Roß -- Müller sprudelnd Schaum -- naß durchkältet -- finsteren Gewühl Gebraus Räder -- Stampfen scharf Säg hindurchschreten -- 
  finden bereit -- Müller -- Mönch harret Eurer -- Braut sitzen weinen -- 
  fragen Vater -- rufen heilig Hülfe -- 
  Egbert schreiten stumm Müller -- Tür öffnen -- 
  Pauline treten Glorie leidend Schönheit entgegen -- 
  O Herr Markgraf -- klagen -- führen Engel -- 
  Nehmt Unglücklichen -- schändlich Freistatt -- heilig Altar weggerauben -- 
  schützen -- führen Mutter Klara -- 
  Irrtum -- schön Paulin -- erwidern Markgraf -- entführ glauben -- Geleit Riesig hierhergekommen -- -- euer Hand werben -- hoffen -- euer Jawort versagen -- 
  starr entsetzen hören Pauline Rede -- 
  lieben Anblick -- fahren Markgraf fort -- -- 
  Priorin Werbung -- 
  Nacht Verbindung -- 
  nächster Morgensonne begrüßen Markgräfin -- Abendsonne -- 
  Leiche -- -- fallen Paulin voll Verzweiflung -- Hofft -- besitzen -- 
  Räuber -- wegführen -- Verbindung sprechen -- Gegenwart Einwilligung Vater -- 
  Fordre -- augenblicklich Kloster zurückgeleien lassen -- euer Vater -- schön Paulin -- entgegnet Markgraf -- kennen billigen Wahl -- 
  Überzeugen -- 
  Pergamente anvertrauen -- Priorin nimmermehr ausantworten -- 
  Pauline erblaßen -- 
  -- lassen -- sprechen -- Vater sehen -- 
  beschwör Unglück bereiten -- 
  verderben Tochter -- 
  sehen -- erwidern Markgraf -- Markgräfin -- 
  entschließet -- 
  -- 
  Priester warten -- 
  Mönch treten herein -- 
  vergebens rufen Paulin laut Hülfe -- 
  Sturm Gebraus Räd übertäubten Stimme -- 
  vergebens Rang Markgrafen Flucht -- Kraft wichen -- sinken ermatten Boden -- 
  Augenblick Erschöpfung sprechen Mönch furchtbar Segen entsetzlich Bund -- 
  Markgraf Gemahlin umarmen -- neu -- erhöht Kraft stoßen Paulin -- 
  heilig nehmen Zeuge -- rufen -- aufrichtet -- Bund verfluchen -- 
  Gott Greuel Gewalttätigkeit -- -- Auge erblicken -- Rache fallen -- 
  Blutrot aufgehend Mond werfen Strahl Paulines Angesicht -- furchtbar ernst -- Antlitz Rachgöttin Markgrafen richten -- 
  scheinen erschüttern -- naht bittend Wort -- 
  -- -- 
  rufen Zürnende nochmals -- Vollenden euer Frevel -- 
  Wißt heilig Geheimnis -- hören wagen -- Natur freveln wollet -- berühren -- 
  Geliebte -- verlobt Eur Sohn -- 
  Markgraf erblassen -- 
  glauben Geheimnis Pauline verraten -- 
  -- vernehmen -- erglühen Zorn -- selbstvergessen Übereilung rufen -- 
  -- Unglückliche -- 
  Verbrecherin -- 
  liebst dein Bruder -- 
  Bruder -- wiederholt Pauline -- Blut erstarrt Ahnung finsteren Abgrund Geheimnis -- -- Bruder -- 
  Vater -- 
  Markgraf beben wanken -- 
  Wort sprechen -- 
  zusammensinken Todesblässe Gesicht verraten schaudernd Paulin -- 
  Gerechter Himmel -- -- schrie -- Hand empor ringend -- -- -- Vater -- wissen -- o Gott -- wissen -- 
  Blitzesschnelle fliegen Zimmer Greuel -- braust Rad Mühle mengt Dunkel spritzend Schaum Mondschein abenteuerlich Gestalt -- Weg treten Lauf hemmten -- 
  verfolgend eilt Markgraf rufen wild Stimme Braut -- 
  fassen schmal Brücke Kleid fliehend -- 
  schützen -- heilige -- rufen Verzweifelnd -- Löwenkraft rang Verfolger -- 
  reißen Umflechtung gewaltig Stoß stürzen Taumelnde hinab -- Flut Räderwerk Raub Leben teilen -- 
  herzueilend Müller tragen bewußtlos Pauline Ort Schrecken entfernteres Gebäude -- 
  Ruf hemmen Knechte Räderwerk Mühle -- spät Rettung ziehen zerschmettert Leichnam hervor -- 
  außen lebendig -- 
  Schar Reisige -- Heinrichs Heer stoßen -- ziehen Mühle vorüber -- 
  begehrn Einlaß Lebensmittel -- 
  finden Leichnam feindlich Heerführer -- 
  Jauchzend ziehen Nachricht -- gelten -- Sieg -- Kaiser Heer -- Lohn -- -- lassen zweifelhaft -- -- Botschaft gelten -- 
  Pauline müssen schleunig Flucht denken -- 
  zerschmettert Leichnam liegen blutig Weg -- 
  heiß Träne Schmerze Versöhnung sinken nieder gelobt Kloster stift Büßung schwer Schuld greuelvoll Nacht -- 
  Müller Knecht geleitet Kloster frommen Priorin Klara -- 
  vergebens bieten Werner -- Geliebte sehen -- 
  Priorin erfahren Schrecken Nacht -- unwiderruflich geliebter -- Schwester Mutter trennen -- 
  Verloren Freude Leben -- suchen Ruhe Kloster Hirschau -- Bruder Hieronymus heilig Leben führen -- 
  Paulina beschließen gelobt Münster Denkmal unglücklich Liebe errichten -- 
  sendet Boten Kloster Hirschau lassen kunstreich Bruder Hieronymus bitten -- Kloster Einsicht bauen -- 
  Hieronymus gedingen sogleich Klosterkirche -- Geliebte sehen -- beschließen -- Kirchenbau ausführen -- Geist -- Pauline Bilde Traumes eifrig herstellen wünschen -- 
  allwöchentlich fromm Baumeister -- ordnen treiben Arbeiter -- Werk fördern -- 
  zurückrei Kloster -- liebend Paulin freut Werk brüderlichen geliebter -- betrachten jeder legt Hand gleichsam segnend Stein Säule -- 
  sehen Arbeiter -- falten andächtig Hand -- fromm Paulin Stein Werkstücke heimlich sprechen berühren -- 
  Baumeister -- Arbeit sehen -- zeigen Werkleute Stelle -- fromm Stifterin heilig gestehen -- Stein segnend berühren -- 
  kniet Hieronymus nieder -- Fuß gestehen -- küßen Stein -- worauf Hand geruhen -- Arbeiter knieen nieder -- beten Segen Gelingen Werk -- 
  sehen Hieronymus Paulina niemals -- gedacht schwer Wort -- Paulina wiedersehen stellen -- 
  Münster vollenden -- umh geistlich weltlich Herr herbei kommen -- betrachten -- fehlen Abt -- Klosterbrüder vorstehen -- 
  Paulin -- Oberhaupt berufen -- wählen fromm Baumeister Klosters -- Bruder Hieronymus Hirschau -- 
  Sitt gemäß zureden Bischof -- ziehen -- Erhöhung Feierlichkeit -- Abt ' entgegen -- einzuhol Kloster einführen -- 
  scheut Anblick -- Heiligkeit Handlung scheinen wiedersehen rechtfertigen -- 
  riten einfach geschmückt Zelter -- demütig Gefolg -- 
  hört Ferne Chorgesang Klosterbrüder -- Abt geleiten -- stimmen Paulina's Gefolge Kommenden Benediktus -- Volk -- Ort herbeigeströmen -- sinken Knie -- Segen Herannahende empfangen -- 
  heben Abt segnend Hand -- erblaßt Paulina's Wang -- Auge starrt tief Abhang Felsweg hinab -- 
  schweben himmlisch lächeln Mund -- 
  Vater -- rufen -- Vater -- versöhnen -- 
  Engel heben Schleier Schuld -- 
  kommen -- eil Arm Vater -- 
  Roß scheut -- Seherin Pauline sinken Felsengrund -- 
  heben entseeln -- 
  Glied zerschmettern -- unentstellt -- Frieden Himmel verklären -- lächelen Angesicht Tod -- 
  sterben leiblich Tod Vater -- leis Stimme Priorin Klara -- heilig -- 
  Abt Hieronymus -- Jerung nennen -- führen Leichnam Entschlafen gestiftet Münster -- Begrub Altar heilig Kreuz -- voll still Schmerz finden Seite Ruhe Grabe -- 
  -- kalt Grabesstein heiß Brust voll Liebe ausgeglühen -- vergessen Auge weinen -- finden Trost duldend Gemüt -- 
  Land -- schlummernd Gebein -- schön Lenz Glauben neu entblühen -- wandeln -- Liebe störet -- verbinden -- Angehöret -- 
  11. Gesellschaft sprechen Wort Teilnahme Paulina's Schicksal -- 
  Fremd -- ebenfalls Paulin nennen -- vorzüglich bewegen -- 
  Paulina's Geschichte -- -- wenden -- interessiert ungemein -- 
  Gründen Erzählung geschichtlich Nachricht -- 
  -- erwidern -- widersprechen Geschichte -- 
  Freund -- danken -- schreiben -- fleißig Forschung Geschichte -- 
  leben Verfasser -- -- fragen gesenkt Blick -- fürchten Antwort -- 
  zuletzt Frankreich -- antworten -- tödlich verwunden gefangen -- 
  Besitzt Porträt -- -- fragen schnell heftig -- 
  -- malen müssen Frage bejahen -- 
  O -- Beschwör -- -- fahren fort -- sagen -- wissen -- 
  lieb Freund -- 
  Bild Trost sehnt Beruhigung -- leiden erleichtern -- 
  Zügen Bild erkennen sogleich -- 
  sprechen -- Graf Werner -- 
  Heftigkeit Frage erschrecken -- suchen fassen -- 
  letzter Nachricht -- antworten -- Freund -- erhalten Besancon -- 
  freilich traurig -- 
  Zweifel wissen -- Aufsicht still Wahnsinne leben -- Leben endigen -- 
  O -- Gott -- rufen schmerzlich -- -- 
  kommen Besancon -- 
  vermessen -- Wahrscheinlichkeit finden Tod nah Fluß -- 
  hören -- tote beweinen -- Zustande -- 
  mehrere Umstand lassen hoffen -- erschein günstig wirken -- 
  Eile -- 
  -- spät -- 
  Ankunft aufsehern entschlüpfen -- Tuch -- nah Wasser finden -- bestätigen schrecklich Vermutung -- 
  bleiben Zweifel -- Fremd -- Paulin -- Theodor erzählen -- Person -- 
  berührt Vorsicht Geschichte Liebe -- suchen glaublich -- Werner Gegend umh irr -- Nachforschung Besorgtheit Liebe unternehmen -- ernstlich Hoffnung hegen -- 
  Julius erinnern hierbei behutsam übereilt Wort Trennung -- Bruch Wortes wunderbaren Zusammenhäng Tod -- Wendung Schicksal gefährlich wiedersehen entgehen -- 
  O -- treffen -- -- -- rufen Paulin -- sprechen unbesonnen -- frevelhaft Wort -- 
  suchen Paulin -- neu düster nachdenken verfiel -- trüb Erinnerung entfernen -- wenden Gespräch Ruine -- hoch gestiegen Monde prächtig beleuchten -- 
  Kühle Mitternacht erinnern aufbrechen -- Weg Garten längst Säulenreihe kirchlich Ruine hinführt -- Schatten Säule wechselnd erscheinen verschwinden -- scherzt Gesellschaft vorig gespenstisch Erscheinung Paulina's -- 
  treten Gesellschaft Gartentüre ehemalig hoch Chor Kirche -- erschrocken zweifelhaft zurücktraen -- 
  Mönchgestalt schwarz Benediktinertracht knien unbeweglich betend Stellung Paulina's Grab -- 
  fast ausersehn -- Phantom treffen -- Theodor -- -- 
  Gegend -- Schritt erheben Erscheinung blass Gesicht Verhüllung -- 
  Mönchgespenst -- -- rufen mehrere -- früh Erzählung einfielen -- Theodor Schauderte treten mutlos -- 
  -- -- rufen Paulin -- Garten verweilen -- heraustretend -- 
  -- unzeitig Scherz -- 
  unwillig Gestalt -- Verhüllung abnehmen -- Nähe blaß Totengesicht erblicken -- laut Schreck Aufschrie Boden sinken -- 
  Mönchgestalt stehen starr regungslos -- 
  Trieb helfen überwinden Furcht -- 
  eilen hinzu -- Ohnmächtig aufrichten -- -- Schritt entfernt -- bleich Gestalt bewegunglos stehen -- 
  Paulin -- -- rufen Begleiterin -- Paulin -- wiederholt schwarz Mönch dumpf Stimme -- 
  vorgebeugen leblose anstarrend -- rufen Erscheinung nochmals entsetzlich Mischung Freude Grausen Name Ohnmächtig -- sinken Boden -- 
  Schreck fesseln Augenblick Sinn -- 
  bemüht furchtbar Mönchgestalt Pauline entfernen -- 
  Gesicht Anstrengung Falles enthüllen -- 
  -- fragen -- Traum erwachend -- Theodor erkannt Stimme Zug Freund Werner -- 
  12. Bemühung Pauline Leben zurückrufen -- enthüllt Rätsel unerwartet Erscheinung Grafe Werner -- 
  Schwermut still Wahnsinn übergegang Nachricht fehlgeschlagen Versuch deutsch französisch Herrschaft befreien -- Verbindung unglücklich Liebe -- Gemüt Besinnung fast völlig zerrütten -- 
  Vorstellung -- Sieg Befreiung Vaterlande erfechen -- lebendig erhalten -- 
  -- erzählt -- traumähnlich Zustande -- Bild siegend deutsch Heer erscheinen -- stets aufforderen -- kämpfen -- 
  deutlich wissen -- -- folgen -- 
  Mönchtracht kommen -- Entweichung Besancon Leben erhalten -- Rätsel -- 
  Vergangenheit liegen verworren Fiebertraum -- unterscheiden -- Wirklichkeit angehört -- leer Bild Wahnsinn -- 
  Ruine Paulinzell dunkles -- unbeschreiblich selig Gefühl binden -- kennen Wahnsinn -- bemerken sonderbar Zusammentreffe -- Ruine -- Wahnsinn Erinnerung glücklicher Zeit durchglänzen -- Entwicklung Schicksales herbeiführen -- 
  Paulin atmen bewußtlos Betäubung -- Kunst Arzt Leben erhalten -- 
  Gewalt Überraschung töten -- -- gesprochen Wort wiedersehen bewähren -- 
  Gewalt Unerwartet geliebter Besinnung zurückgegeben -- -- grausam -- zeigen Schicksal Geliebte Augenblick -- entriss -- rückkehrend Besinnung Empfänglichkeit Schmerz Verlustes -- 
  sehen -- -- sprechen -- Freund klagen -- bringen -- Myrtenkranz -- deutsch Siegeskranz Eichenlaub -- 
  eilt preußisch Fahne -- 
  Verlängerung Waffenstillstande -- Gemüt letzter Hoffnungfunke verlöschen -- schlagen nieder -- unglücklich Dresden Mut erschüttern -- 
  siegfroh Bild -- vormals zerrüttet Geist erhellten -- gehen Traum -- hören Wachend -- Ferne -- Siegesgeläut Triumphlied herantönen -- 
  blutig Nachmittag sechzehnt Oktober stürmt tapfer Schar Bülow's Möckern Leipzig -- 
  Sieg Sache entscheiden -- deutsch Herz voll -- liebend Sehnsucht hing -- 
  Feuriger reißen Mut vorwärts -- 
  Feind weichen -- 
  Triumphlied Traum klangen -- Glockengetön -- türmen nah liegend Stadt -- halln -- 
  Sieg -- 
  Sieg -- -- 
  rufen Begeistert -- vorwärts dringend -- 
  werfen feindlich Kugel Ros -- 
  treu Kamerad tragen Baum -- 
  Gerücht Sieg Feind sterbend Glocke -- Nachricht Stadt feiern müssen -- schalln dumpf totenglocken heran -- 
  Freund scheinen Augenblick Mut sinken -- sterbend feuern neu tatenreich vertrauen -- 
  Verzagt -- sprechen -- euer Siegruf kräftig schallen -- 
  Fort Kampf -- 
  lassen -- 
  Glockentöne Grabgeläut -- 
  Abend Feld erkämpfen -- treffen entseeln -- Paulina's Bild Mund drücken -- 
  Taschenbuche finden Zeile -- 
  hören bangen Angstruf Glocke -- 
  hallen mahnend Schlacht Gedröhne -- -- Krieger -- sprechen Ton -- 
  schnell Rettung locken -- 
  -- Bruder -- kämpfen voll Mut -- stürmen unerschrocken -- Tirann Gott verhöhnen -- Kämpfen -- Sieg Lorbeer Palm krön -- Jubel Schall Triumph Frohlocke -- 
  mächtig Schwertkampf schlagen -- Leben Blutstrom quellen tief Wunde -- freudig Geist emporgetragen -- 
  entgegen tönen Gruß geliebt Mund -- golden Morgenrot beginnen -- Sieg -- Freiheit -- Liebe glänzt heilig Bund -- 