1. Höre Mutter -- alt Förster Bertram Lindenhain -- weißen -- tun Liebe -- Gedanke Schlag Kopf -- bestärk Mädchen -- 
  Schlag's -- weinen Träncher ergeben drein -- lang Trödel Hinhalte -- 
  Väterchen -- wenden Försterin vorbittend -- Käthche Amtsschreiber glücklich leben -- Jäger Robert -- 
  Kennst Wilhelm -- brav Mensch -- herzensgut -- 
  Jäger -- fallen Förster -- Försterei lang zweihunderen Vater Sohn vererben -- 
  Hättest Junge bringen -- Mädchen -- ' -- hinterlassen Stelle -- Mädel -- einer kommen -- frei -- -- -- -- 
  Mühe -- Angst Weg -- Herzog Schwiegersohn Probeschuß lassen -- brav Jäger -- Mädel verschleudern -- 
  -- Mutter Anne -- Robert bestehen -- just -- fällen -- Such Mädel flinken Jägerbursche -- Stelle Lebzeiten übergeben -- Ruhe Kind alt verleben -- Federschütz bleiben Hals -- 
  Mutter Anne Wort Amtsschreiber sprechen -- Förster -- Kraft weiblich Überredungskunst kennen -- Entschluß wiederholt Angriff aussetzen -- flint Wand Wald -- 
  Ecke Haus -- stecken Käthche blond Lockenköpfche freundlich Türe herein -- 
  gehen -- Mutterchen -- 
  -- -- rufen -- springen munt Zimmer Hals Försterin -- 
  -- Käthche -- freu -- -- Vater -- herzensgut -- -- Jäger -- -- kennen -- 
  Käthchen weinen sterben Wilhelm lassen -- 
  Mutter trösten schmäln abwechselnd -- weint Tochter -- 
  versprechen Hauptsturm Herz Förster versuchen -- klopfen Türe -- Wilhelm treten Herein -- 
  Wilhelm -- rufen Käthche verweint Auge entgegen -- scheiden -- 
  Suche and Mädchen -- sollst frei -- Vater Robert geben -- Jäger -- Mutter helfen -- 
  -- lassen -- keiner -- bleiben -- treu Tod -- 
  Mutter Anne suchen Amtsschreiber -- wissen -- Käthchen Rede -- besänftigen -- erzählen -- Vater Bertram Person einwenden -- Försterei beständ Jäger Eidam -- 
  -- Wilhelm beruhigen -- drücken weinend Mädchen Brust -- Mut -- lieb Käthche -- 
  Jägerei unkundig -- Ohm -- Oberförster Finsterbusch -- Lehre gestehen -- müssen Pate -- Amtmann Liebe jagdtasch Schreibpulte vertauschen -- 
  helfen versprochen Amtmannsstelle -- Käthche Frau Amtmannin Amtshaus einführen -- 
  hoch hinaus -- Mutter -- Förster Wilhelm leiben -- Amtmann -- tausch -- lustig Jägerlebe -- steif Leben Stadt -- 
  O -- -- golden Wilhelm -- rufen Käthche -- Wolke Stirn verschwinden -- glänzend sonnenreg Freude zittert Auge -- -- sprich Vater -- ehe Robert Wort -- 
  -- Käthche -- Wilhelm -- gehen Wald -- 
  gewiß Hirsch -- Amt liefern -- 
  Gib Flinte Tasche -- Such -- stell Jägergruß -- bieten Dienst Jägerbursch -- 
  Mutter Tochter fallen Hals -- helfen Jäger -- -- aufputzen -- sehen Hoffnung Bangigkeit Wald -- 
  2. wacker Bursch -- Wilhelm -- -- rufen Förster freudig -- Jäger Haus kommen -- Federhelden solch Schütze suchen -- 
  -- sprech Amtmann -- Jammerschade -- edl Jägerei bleiben -- 
  anderer Kuno -- 
  weisen -- Kuno -- 
  Wilhelm verneinen -- erzählen -- fahren Förster fort -- Sieh -- urältervater -- Försterei besessen erbauen -- 
  arm Reitersbub -- dienen Junker Wippach -- leiden -- überall Fehd Turnieren Jagde -- 
  Junker Wippach Jagd -- Herzog halten Ritter Edlen -- 
  jagen Hund Hirsch heran -- sitzen Mensch -- kläglich Hand Rang Jämmerlich schreien -- tirannisch Weise Jagdherr -- arm Mensch -- gering Jagdfrevel Hirsche schmiedeten -- elendiglich zerstoßen zerrissen Hunger durst umkommen müssen -- 
  Herzog ansichtig -- Maß zornig -- stellen Jag -- verheißen Lohn -- getraut Hirsch treffen -- drohen Ungnade Bann -- schütz Mensch verletzen -- lebendig -- wissen -- Verbot grausamen erkühnen -- 
  Edle finden -- Schuß Herr Ungnade Bann wagen -- 
  treten Kuno -- urältervater -- -- Bild malen siehst -- sprechen Herzog -- Gnädigster Herr -- mir_es gestatten -- wagen Gott -- fehl -- -- -- Leben Buße nehmen -- Reichtum Gut -- jammern arm Mensch -- Leben dran setzen -- währ Feind Räuber fallen -- 
  gefallen Herzog -- heißen Kuno Glück versuchen -- wiederholt Verheißung -- Drohung gedenken -- furchtsam -- 
  Kuno Büchse -- spannt Gott Name -- befehlen Kugel heilig Engel gläubig fromm Gebet -- 
  Schoß wohlgemut ziel Wald -- Augenblick fliehen Hirsch heraus -- stürzen enden -- Mensch unverletzen -- Hände Gesicht Gesträuch ritzen -- 
  Herzog halten Wort Kuno Lohn Försterei Nachkomme erblich -- 
  Glück Geschick Neid niemals -- erfahren Kuno -- 
  -- Försterei Vetter linken Seite -- beschwatzt Herzog -- Schuß Zauberei Teufelskünste geschehen -- Kuno gezielt -- Freischuß -- allemal treffen -- Blau hinein tun -- beschließen -- Kuno' Nachkomme Probeschuß -- ehe Försterei bekommen -- freilich Landjägermeister -- Probe abnehmen -- schwer aufgeben -- 
  müssen hölzern Vogel -- Stange geschaukeln -- Ring Schnabel schießen -- 
  -- Meisterschuß fehlen -- Eidam Nachfolger -- brav Jäger -- 
  Wilhelm Förster Freude sichtbar Teilnahme Erzählung zuhören -- 
  fassen lebhaft alt Hand -- versprechen Anleitung Jäger -- Urvater Kuno schämen -- 
  3. voll vierzehn Wilhelm Jägerbursche Försterhause -- Vater Bertram -- gewinnen -- Einwilligung Verbindung Käthche förmlich erteilen -- 
  Verlobung geheim gehalt Probeschusses -- Förster Gegenwart fürstlich Landjägermeister Familienfeste Feierlichkeit geben hoffen -- 
  Bräutigam schwebte Entzück vergessen Welt offen Himmel Liebe -- Vater Bertram mehrmals neckt -- Ziel treffen -- Käthche erzielen -- 
  Wilhelm still Verlobungstag Mißgeschick Jagd -- 
  versagt Gewehr -- treffen Wild Baumstamm -- 
  Haus leeren Jagdtasche -- finden Rebhühner Dohl Krähe -- hasen tote Katze -- 
  Förster ernsthaft Vorwurf Unachtsamkeit -- Käthche fing Probeschuß bange -- 
  Wilhelm verdoppeln Aufmerksamkeit Fleiß -- nah rücken -- Probestück ablegen -- desto verfolgt Unglück -- 
  fast Schuß mißrieen -- fürchten beinahe Gewehr loszudrücken -- Schaden anzustifn -- Kuh Weide anschießen Hirt beinahe verwunden -- 
  bleiben -- -- Rudolf -- Jägerbursch -- Abends -- Wilhelm Weidemann setzen -- natürlich Ding -- lösen -- 
  Rede albern -- versetzt Förster verweisend -- abergläubisch Zeug -- fromm Jäger sprechen -- 
  weißen Weidmann -- Stück -- geschickt Weidemann -- 
  Ho -- ho -- ho -- sagen -- 
  Rudolf räuspert Weidspruch sprechen schnell -- 
  Jo -- ho -- ho -- Weidmann -- sagen -- Wissenschaft -- Gewehr Hund -- Weidmann brauchen Grund -- tüchtig verrichten -- lassen vernichten -- treffen -- 
  -- fallen alt Bertram Wort -- Ding Weidemann lösen -- allemal Faselhan Peter Ungeschick -- 
  Gunst -- Vater Bertram -- entgegnen Wilhelm verdrußlich -- Gewehr -- sehen -- aussetz -- Wissenschaft -- rühmen -- jagdgerecht denken -- Anderer -- gleichwohl ist_es gehen Kugel krumm -- bleisen Wind Lauf weg -- 
  -- -- -- 
  wunderlich -- murmelt Förster -- wissen -- sagen -- 
  Glaube Wilhelm -- wiederholen Rudolf -- -- -- 
  Gehen Freitag Mitternacht Kreuzweg machen Ladestock blutig Deg Kreis -- segnest dreimal -- Priester -- Name Sammiel -- Schweige -- -- unterbrach Förster unwillig -- Weißt -- Name -- 
  Teufel Heerschar -- 
  Gott bewahr Christ -- 
  Wilhelm kreuzen ebenfalls -- hören -- wiewohl Rudolf Meinung bleiben -- 
  putzt Nacht Gewehr -- untersuchen Schraube Feder -- anbrechendem -- Glück neu versuchen -- 
  4. 
  Mühe verlieren -- Wild drängen scheinen fast necken -- 
  Schritt schoß Rehbock -- zweimal versagt Gewehr -- drittemal geraten Schuß -- Wild fliehen unverletzt Büsch -- 
  unmutig werfen unglücklich Jäger Baum -- verwünscht Schicksal -- rauschen Gebüsch -- alt Soldat Stelzfuße hinken heraus -- 
  Holla -- Weidmann -- redet Wilhelm -- verdrußlich -- 
  Liebespein -- fehlen Beutel -- Gewehr besprechen -- 
  Gib Pfeife Tabak -- einer plaudern -- 
  Wilhelm reichen verdrußlich Gebetene -- Stelzfuß werfen Gras -- 
  einig Hin- herreden Gespräch Jägerei -- Wilhelm erzählt Unglück -- 
  Invalid lassen Gewehr zeigen -- 
  verzaubern -- -- Hand nehmen -- rechtschaffen Schuß -- Weidemann Kunst stellen -- Gewehr -- Hand nimmst -- 
  Wilhelm erschrak -- Einwendung Hexenglauben fremde -- erbot Probe -- 
  Kriegsleute -- -- selten -- Abend tief Nacht hinein Wunderdinge erzählen -- 
  Scharfschütze zurecht -- überall hinwagen -- Mann Pulverdampf heraus schießen -- Mensch sehen -- Kunst können zielen losdrücken -- 
  -- Exempel Kugel sicher treffen sollst -- besonderer Tugend Hexenwerk widerstehen -- 
  Versuch -- fehlen -- 
  Wilhelm laden Gewehr Ziel -- 
  Raubvogel schweben Wald -- beweglich Punkt -- 
  Schieß Stöße -- Stelzfuß -- 
  Wilhelm lachen -- Vogel schweben -- Auge -- erreichbar Höhe -- 
  Ei -- schieß -- wiederholen -- verwetten Stelzfuß -- fallen -- 
  Wilhelm schoß -- schwarz Punkt senkt Geier fallen blutend Boden -- 
  wundern -- Invalid Verwunderung sprachlosen Jäger -- Weidmann wärst -- 
  Kugel gießen Hauptstück Kunst bloß Geschick Herzhaftigkeit -- Nacht geschehen -- 
  dir_es umsonst lernen -- -- -- schlagen -- 
  Versuch indessen paar Kugel -- siehst -- halb ungläubig -- 
  wiedersehen -- 
  Stelzfuß Wort Wilhelm Hand voll Kugel hinken -- 
  Voll Verwunderung versuchen Wilhelm Kugeln -- treffen fast unerreichbar Ziel -- gewöhnlich Ladung fehlen leichtest -- 
  Invalide -- Walde finden -- Wilhelm müssen versprochen wiedersehen trösten -- 
  5. 
  Försterhause Freude -- Wilhelm -- -- Vorrat Wildbret ankommen -- Vater Bertram überzeugen -- vorig brav Schütze -- 
  Ursache erzählen -- Unglück wunderbar verfolgen -- tun -- heben -- scheut -- bestimmt Grund bewußt -- unfehlbaren Kugel sprechen -- schieben Schuld Fehler Gewehr -- vorig Nacht Putze entdecken -- 
  Siehst -- Mutter Anne -- Förster lachend -- ich_es -- Weidemann Lauf stecken -- Kobold -- Vater Kuno früh herunter werfen -- stecken verrostet Nagel -- 
  Kobold -- -- fragen Wilhelm -- 
  -- erwidert alt -- Bild fallen -- schlagen -- herunter -- meinen Mutter Anne -- Spukt -- 
  -- -- wiederholen Wilhelm Stelzfuß fallen -- Stunde scheiden -- 
  freilich Spuken -- fahren Förster fort -- klopfen Mutter Ann freundlich backen -- 
  schütteln bedenklich Kopf -- 
  Gott geben -- zugegangen -- bedenklich -- Wilhelm entfärben -- 
  beschließen Kugel Seite legen -- Probeschuß gebrauchen -- Glück Bosheit Feinde verscherzen -- 
  Förster nötigen Jagd -- neu Mißtraun Geschicklichkeit erregen alte erzürnen -- müssen Zauberkugel dran wagen -- 
  6. Wilhelm Glückskugeln gewöhnen -- Gebrauch bedenklich Ahndet -- 
  täglich Wald Hoffnung Stelzfuß begegnen -- Kugelvorrat vermindern -- Probeschuß Sicherheit bestehen -- äußer Sparsamkeit nötig -- 
  schlagen sogar alt Förster Begleitung Jagd -- Landjägermeister erwarten -- -- eigentlich Probeschuß Beweis Geschicklichkeit sehen verlangen -- 
  Abend Jägermeister Bote -- stark Wildbretlieferung Hof bestellen -- Ankunft Herr ansagen -- 
  Wilhelm glaubt Boden sinken -- erschrecken Verdacht erregen -- sein neigen -- getäuscht Hoffnung Bräutigam zuzuschreiben -- 
  müssen Jagd -- Kugel aufopfern -- 
  -- schworen -- sollen trennen -- entscheidend Schuß Verlobungstag -- 
  Vater schmäln -- Wilhelm einzig Hirsch Jagd zurückkommen -- verlangt Lieferung beträchtlich -- 
  zürnt Mittag noch_mehr -- Rudolf reich Beute -- Wilhelm leer Haus -- 
  Abend drohen fortzuschicken -- Einwilligung Verbindung Käthche zurückzunehmen -- folgend wenigster Rehböcke bringen -- 
  Käthche groß Angst -- bitten Liebe -- Fleiß anwenden Jagd denken -- 
  Wilhelm verzweiflungsvoll Wald -- 
  Käthchen Fall verlieren -- bleiben übrig -- traurig Wahl -- Art Glück zerstören -- 
  -- unfähig wählen -- Betrachtung Schicksal verlieren -- zeigen Nähe Rudel Rehe -- 
  Maschinenmäßig greifen letzter Kugel -- lastet zentnerschwer Hand -- 
  zurückfallen lassen -- entschließen Schatz bewahren -- kosten -- wollen -- 
  Ferne Stelzfuß -- freudig lieser Kugel Lauf rollen -- drücken -- Rehböcke sinken Boden -- 
  Wilhelm lieser stürzen eilt Invalide -- müssen Weg einschlagen -- finden -- 
  7. Vater Bertram Wilhelm zufrieden -- still Verzweiflung umh -- Käthchen Liebkosung vermochten aufheitern -- 
  Abend sitzen stumm bemerken -- Förster Rudolf ziemlich lebhaft Gespräch geraten -- Betäubung wecken -- 
  dulden -- Wilhelm -- rufen Träumend -- unser Altvater Kuno Ding nachsagen -- Rudolf -- 
  Engel arm unschuldig Mensch beigestanden -- englisch Schutz alt Testament Exempel lesen -- Gott wunderbar Güte preisen -- Teufelskünst lass Urvater nachsagen -- 
  sterben sanft selig Bette Kind enkeln -- Teufelskünst treiben -- nimmt_es niemals -- ansehen -- Prag Böhmischen lernen -- 
  O -- erzählen -- -- rufen Rudolf -- stimmen -- 
  Schlimm -- fahren Förster fort -- graut -- denken -- 
  Prag jung Mensch -- Georg Schmied heißen -- Verwogener -- wild Bursch -- brav flink -- stark Liebhaber Jagd -- -- -- 
  tüchtig Jäger -- flüchtig schoß weg -- 
  -- aufzogen -- vermaß -- wollen schießen Jäger sollen Wild entgehen -- weder Luft Gebüsch -- 
  halten Wort -- 
  paar drauf pochen früh unbekannt Jäger heraus -- -- -- draußen Straße liegen Mensch halb tot Hülfe -- 
  Bursch hinaus -- liegen Georg überall blutig zerkratzen -- wild Katze -- sprechen -- besinnungslos Lebenszeichen -- 
  tragen Haus -- melden Prag -- abholen -- 
  aussagen -- alt Bergjäger Freikugel gießen -- allezeit treffen -- versehn -- Teufel zugerichten -- er_es Leben bezahlen müssen -- 
  versehn -- fragen Wilhelm bebend -- Teufel Künsten allemal Spiel -- 
  -- -- erwidern Förster -- 
  -- wissen -- schwatz verborgen Naturkräften Einfluß Stern -- -- Glaube nehmen -- bleiben -- Teufelsspiel -- 
  Wilhelm schöpfen frei Atem -- 
  Georg erzählen -- übel zugerichten -- fragt Förster -- 
  freilich -- antworten -- Gericht er_es aussagen -- 
  Mitternacht Bergjäger Kreuzweg gehen -- blutig Deg Kreis -- Totenschädeln Knochen kreuzweise belegen -- 
  drauf Bergjäger Schmiede unterrichten -- -- 
  sollen nämlich Schlag anfangen Kugel gießen -- sechzig -- Zahl -- glock Mitternacht schlügen -- verlieren -- dürfen Arbeit weder Wort sprechen -- Kreis treten -- geschehen -- wollen -- 
  müssen sechzig Kugel unfehlbar treffen -- fehlen -- 
  Schmied Gießen anfangen -- -- -- grausam erschrecklich Erscheinung sehen -- laut aufgeschri Kreis gesprungen -- worauf bewußtlos Boden fallen -- eher besonnen -- Prag Hand Arzt -- Zuspruch geistliche -- Traum erwachen -- 
  Gott bewahr Christ Schling Satans -- Försterin bekreuzen -- 
  Georg ordentlich Pakt Satan -- -- fragen Rudolf -- 
  behaupten -- versetzt Förster -- -- richten -- 
  bleiben schwer Frevel -- Mensch Ding einlassen -- böse -- Leib Seele verderblich -- 
  Feind -- Mensch rufen -- Pakt schließen -- 
  fromm Jäger brauchen -- erproben -- Wilhelm -- Gewehr Wissenschaft -- brauchen Jäger Freikugel -- treffen wohin -- 
  Preis Kugel abschießen -- Feind arg Schalk -- Kugel Ziel führen -- -- 
  8. 
  Förster schlafen lassen Wilhelm peinlichst Unruhe -- werfen vergebens Lager -- Schlaf fliehen Auge -- 
  Stelzfuß -- Georg -- Käthche -- fürstlich Kommissar -- Probeschuß verlangen -- schweben abwechselnd Auge -- fieberhaft Phantasie verwirrt Gestalt furchtbar Gruppe -- 
  droht unglücklich Geisterbeschwörer warnend blutig Schreckbild -- verwandeln drohend Miene Käthchen hinsterbend -- totenbleich Gesicht -- Stelzfuß stehen höllisch Hohngelächter -- 
  stehen -- Probeschuß fertig -- fürstlich Kommissar -- zielen -- Schoß -- fehlen -- 
  Käthchen sinken Ohnmacht -- Vater verstassen -- Stelzfuß bringen Kugel -- spät -- Schuß verstatten -- 
  verstrich Nacht -- 
  frühest Wald -- absichtlos Stelle -- Invalid begegnen -- 
  frisch -- klar Morgenluft düstern Bild Nacht verwehen -- 
  Tor sprechen -- geheimnisvoll begreifst -- feindlich Geheimnis -- 
  unnatürlich -- such -- Geisterhülfe nötig -- 
  Mensch bändigen mächtig Trieb Tieres -- Herr Wille bewegen -- natürlich Kunst Lauf tot Metall lenken -- Bewegung Kraft erhalten -- 
  Natur reich Wirkung -- begreifen -- Glück Vorurteil Wille verscherzen -- 
  Geist rufen -- Natur verborgen Kraft auffordern gebrauchen -- Geheimnis entziffern vermögend -- 
  -- such alt Stelzfuß -- finden -- -- beherzt -- Georg -- stacheln Übermut -- rufen Liebe -- Ehre -- 
  Stelzfuß finden -- angelegentlich Wilhelm suchen -- 
  -- fragen -- Mensch -- beschreiben -- sehen -- 
  folgend verging fruchtlosen Nachforschung -- 
  -- -- beschließen Wilhelm -- zugezählen -- 
  Nacht gehen Kreuzweg Walde -- 
  einsam -- sehen nächtlich Arbeit Kreis verlassen -- Werk vollenden -- 
  9. Abend dämmeren -- Wilhelm Blei -- Kugelform -- Kohl nötig versehen -- Abendessen unvermerkt Haus verlassen -- 
  entfernen wünscht alt Förster ruhig Nacht -- Hand fassen -- 
  Wilhelm -- sprechen -- wissen -- sonderbar Mut -- fühlen beklommen -- Nacht fürchten -- wissen -- bevorstehen -- 
  Gefallen -- bleiben Nacht -- mußt bange lassen -- möglich Fall -- 
  Käthchen erbieten sogleich -- Vater wachen -- Pflege -- Wilhelm anvertrauen -- Vater Bertram weisen -- 
  andermal bleiben -- -- mir_es ruhig -- Wilhelm -- 
  Wilhelm Einwendungen -- Käthche empfehlen Pflege Vater dringend unwiderstehlich Bitte -- bleiben Vorsatz folgend Nacht aufschieben -- 
  Mitternacht Vater Bertram ruhig schlief fest -- Angst lächelen -- 
  Wilhelm Wald -- hoffen unsichtbar geworden unbekannte -- halten Förster scheinbar Besorgnis Gesundheit -- 
  Invalid zeigen Wilhelm beschließen zweitenmal Gang Kreuzweg -- 
  Abend Jagd zurückkommen -- springen Käthche freudig entgegen -- 
  Rat -- Wilhelm -- rufen -- Findest -- 
  Besuch bekommen -- lieb Besuch -- sagen -- Mußt raten -- 
  Wilhelm auflegen rat Besuch sehen -- lieb unwillkommen Störer -- 
  weisen Käthchen's Freude Unmut -- sann Vorwand umzukehren -- öffnet Tür Haus Mond beleuchten ehrwürdig Greis Jägerkleidung -- heraustretend Arm Wilhelm ausbreiten -- 
  -- Wilhelm -- -- rufen bekannt freundlich Stimme -- Wilhelm fühlen arm Oheim umfangen -- 
  Zaubergewalt schön Erinnerung kindlich Liebe -- Freude Dankbarkeit drang mächtig Wilhelm -- vergessen nächtlich Vorhaben -- mitten froh Gespräch Mitternachtsstunde schlagen Wilhelm schauerlich Versäumt erinnern -- 
  Nacht übrig -- denken -- -- -- 
  heftig Bewegung innerer entging Greise -- gutmütig suchen Grund Wilhelm Ermüdung -- entschuldigt lang Gespräch Abreise -- lang früh verschieben können -- 
  Laß stündche reuen -- Auseinandergehn Wilhelm -- schläfst sanft -- 
  Wilhelm Worte tieferen Sinn -- 
  ahnden Dunkel -- Ausführung Vorhaben Ruhe Schlafe scheuchen -- 
  10. Abend -- 
  tun -- müssen geschehen -- Probe ansetzen -- 
  Mutter Anne Käthchen Haus herumgeschäften -- vornehmen Gast anständig empfangen -- 
  Abend gute schmücken -- 
  Mutter Anne umarmen Wilhelm -- Jagd zurückkehren -- begrüßen erstenmal liebevoll Sohnesnama -- 
  Käthchen Auge glüht zart Sehnsucht jung liebeglühend Braut -- 
  Tisch festlich deutungsvoll Blume schmücken -- reich Wilhelm Lieblingsspeisen Mutter -- gespart Flasche Vater besetzen -- 
  fest -- alt Förster -- Bräutigamsschlafrock hereintreten -- traulich herzlich sitzen -- lassen froh -- Leben freuen -- 
  umarmen -- bewegen -- Stimme versagen -- 
  -- Väterchen -- Försterin bedeutendem lächeln -- denken -- jung Leute froh -- -- verstehst -- 
  verstehen -- Mutter -- erwidern Förster -- mögen's Kind verstehen -- voraus freuen -- 
  Kind -- Pfarrer einladen -- Wilhelm schießen -- 
  Geprassel laut Schrei Käthche unterbrechen Förster -- 
  Kuno' Bild fallen Wand Ecke Rahmen verwunden Käthche Stirn -- 
  Nagel scheinen locker Wand stehen -- fallen Kalkbekleidung -- 
  wissen -- Förster verdrußlich -- Bild ordentlich aufhängen -- zweitenmal -- erschreckt -- 
  Schmerz -- Käthche -- 
  unbedeutend -- versetzen freundlich wischt Blut Locken -- erschrocken -- 
  Wilhelm fürchterlich bewegen -- Käthchen totenbleich Gesicht Blut Stirn -- 
  Phantasie entsetzlich Nacht zeigen -- Bild aufgeregt foltert neu -- 
  Vorsatz Nacht zweideutig Werk beginnen -- heftig erschüttern -- Wein -- -- innerer Qual verbergen -- schnell häufig gewöhnlich trank -- erfüllt wild Mut -- beschließen -- kühn Wagstück unternehmen -- Vorhaben schön Kampf Liebe Mut Gefahr -- 
  Glocke schlagen -- 
  Wilhelm pocht Herz gewaltig -- 
  suchen Vorwand entfernen -- vergebens -- Bräutigam Hochzeitvorabend Braut verlassen -- 
  fliegen pfeilschnell vorüber -- litt namenlos Quale arme belohnend Liebe -- 
  vorüber -- entscheidend Augenblick kommen -- 
  Abschied schlich Wilhelm Seite Braut -- Werkzeug Haus -- Mutter -- 
  wohin -- Wilhelm -- fragen ängstlich -- 
  wild anschießen -- Taumel vergessen -- Antwort -- 
  vergebens bitten -- vergebens schmeichelt Käthche -- verstört Eile ahnden -- unerklärlich scheinen -- 
  Wilhelm drängen eilt Wald -- 
  11. Mond Abnehmen steigen dunkelrot Horizont herauf -- 
  grau Wolke fliegen vorüber verdunkelt zuweilen Gegend -- plötzlich Mondstrahl aufhelln -- 
  Birk Aspe stehen Gespenster Wald Silberpappel scheinen Wilhelm weiß Schattengestalt winken -- 
  schaudert wunderähnlich Störung Vorhaben letztvergangenen Nächt -- bedeutend -- wiederholt Falle Bild scheinen letzter Abmahnung weichend Schutzgeist bösen -- 
  schwanken Vorsatz -- 
  umkehren -- -- flüstert Stimme -- Tor -- Zauber brauchen -- scheuest Mühe Erwerb -- -- 
  stehen -- Mond treten glänzend dunkel Wolke beleuchtet friedlich Dach Försterwohnung -- 
  Wilhelm Käthchen Fenster Silberglanz flimmern -- breitet Arm schriten bewußtlos Heimat -- flüstert Stimme neu -- heftig Windstoß bringen Schlag Stundenviertel -- 
  Fort -- -- rufen -- 
  -- wiederholen laut -- Feig kindisch halb Weg umkehren -- töricht aufgeben -- kleiner -- Heil wagen -- 
  vollenden -- 
  Schritt Schritt vorwärts -- Wind jagen zerrissen Wolke Mond -- Wilhelm treten dicht Finsternis Wald -- 
  stehen Kreuzweg -- 
  Zauberkreis ziehen -- Schädel Totenbeine rings umher legen -- 
  Mond hüllt Dichter Gewölk -- lassen düstern Kohl -- abwechselnd Windstöß aufgeblasen -- nächtlich trüb rötlich Schein beleuchten -- 
  Ferne schlagen Turmuhr Stundenviertel -- Wilhelm legen Gießkelle Kohle -- werfen Blei hinein -- nebst Kugel -- treffen -- Gebrauch Freischützen erinnern Lehrzeit gehören -- 
  Walde fing regen -- 
  zuweilen flattert Eul -- Fledermäuse -- anderer lichtscheu Nachtgeflügel Schein blenden -- -- 
  fallen Zweig setzen Zauberkreis -- Dumpf krächzend Totenschädel unverständlich Gespräch halten scheinen -- 
  Zahl vermehren -- huschen neblig Gestalt -- Wolke -- tierähnlich -- menschlich bilden -- 
  Windstoß spielen trüb Dunstkörper -- abendlich Taugewölk -- stehen schattenähnlich -- unverändert unfern Kreis blicken starr wehmütig Wilhelm -- 
  zuweilen heben blass Hand klagend empor -- scheinen seufzen -- 
  Kohle brannen Düstrer -- Hand erheben -- grau Eule schwingen Flügel fachen verlöschenden -- 
  Wilhelm wenden -- Angesicht tot Mutter scheinen düstern Gestalt klagend Wehmut anzublicken -- 
  schlagen Glock -- 
  weiß Gestalt verschwinden seufzend -- 
  eul Nachtrabe flattern krächzend -- Schädel Totenbein rasselten Flügel -- 
  Wilhelm knien Kohlenherd -- goß -- letzter Glockenschlag fallen Kugel Form -- 
  12. Eul Totenbein ruhen -- 
  Weg alt -- gebückt Mütterche Zauberkreis -- 
  ringsum hölzern Löffel -- Rührkell Küchengerät behangen -- fürchterlich Geklapper -- Eul krächzn entgegen streichelt Flügel -- 
  Kreis bückt Knochen Schädel -- Kohle sprühen ziehen dürr Hand -- 
  Kreis halten Wilhelm grinsend Ware entgegen -- 
  Gib Knöchelchen -- gurgelte -- geben Löffelchen -- gib Schädel -- Bettel -- 
  frommen -- Entkomme -- mußt -- hochzeitreihen -- lieb Bräutigam -- 
  Wilhelm schauderen -- bleiben still eilt Arbeit -- 
  alt Weib unbekannt -- 
  wahnsinnig Bettlerin öfter Aufzug Nachbarschaft umhergegang -- Irrenhause Versorgung finden -- 
  wissen -- Wirklichkeit Trugbild -- darstellen -- 
  Weile werfen alte zornig Vorrat -- Wort -- 
  Nimm Polternacht -- Brautbett -- -- Abend graut -- antrauen -- kommen -- fein liebchen -- trippelt langsam Wald -- 
  plötzlich rasselt -- Räd Peitschengeknall -- 
  Wagen Sechsgespann Vorreiter -- 
  Straße -- rufen vorderst -- Platz -- 
  Wilhelm blicken -- Hufschlag Pferd entsprang Funke -- Wagenräder leuchteen phosphorisch Schein -- 
  Wilhelm ahndet Zauberwerk bleiben ruhig -- 
  Hinan -- hinan -- hinüber -- -- tollen Lauf hinan -- hinauf -- rufen Vorreiter -- Augenblick stürmen Schar Kreis -- 
  Wilhelm stürzen Boden -- Pferd Kopf bäumn -- lustig Reiterei sau Wagen Luft -- drehen einigemal Zauberkreis verschwinden Sturm -- Wipfel zerreißen Zweig umher streuen -- 
  verging -- ehe Wilhelm Schreck erholen -- 
  Zwang zitternd Hand fest halten goß ungestört Kugel -- 
  schlagen fernen -- wohlbekannt Turmglock -- 
  Tröstend -- freundlich Stimme schallt Klang Menschenwelt furchtbar abgesondert Kreis herüber -- Glocke schlagen zweimal -- dreimal -- 
  schaudert blitzschnell Verlauf -- Arbeit vollenden -- schlagen viertenmal -- 
  Wilhelm Kraft vernichten -- jeder Glied scheinen gelähmt Gießform entsank bebend Hand -- 
  horchen verzweifelnd Resignation Schlag voll Stunde -- Klang säumen -- zögeren -- bleiben -- 
  Spiel Schall ernst Mitternachtstunde scheinen furchtbar Mächt Tiefe wagen -- 
  Voll froh Ahnung ergreifen Wilhelm -- zeigen Viertel Stunde -- 
  blicken dankbar Himmel -- fromm Empfindung mäßigen Jubel -- Gesetz dunkel Welt lauten Ausruf Luft -- 
  Gefahr stärken Täuschung mutig Werk -- 
  tief Stille rings -- eulen schnarchen stieß Zeit Schädel Totenknoche -- 
  knistert Büsch -- 
  Ton kundig Jäger fremd -- blicken -- -- vermuten -- wild Bach brechen Gebüsch rannt Kreis -- 
  Wilhelm ahndet Täuschung -- springen -- fassen Gewehr drücken schnell wild Tier -- Funke springen Stein -- ziehen Hirschfänger -- borstig Untier fahren -- zuvor Wagen Pferd -- Luft verschwinden -- 
  13. geängstet Wilhelm eilt -- verloren Einzubring -- 
  sechzig Kugel gegossen -- blicken froh empor -- Wolke öffneen Mond werfen hell Strahl Gegend -- 
  rufen ängstlich Stimme Walde -- Wilhelm -- 
  Wilhelm -- Käthchen Stimme -- 
  Wilhelm Gebüsch treten furchtsam umherblicken -- 
  keucht alt Weib strecken dürr Arm spinnenartig fliehend -- flatternd Gewand erhaschen suchen -- 
  Käthchen sammelt letzter ermattend Kraft Flucht -- treten Stelzfuß Weg -- stockt Augenblick Lauf -- fassen alte entfleischt Knochenhände -- 
  Wilhelm halten lang -- werfen Form letzter Kugel Hand -- Zauberkreis überspringen -- schlagen Glock Mitternacht -- Zauberbild verschwinden -- Eul werfen flatternd Knochen Schädel fliegen -- Kohl verloschen -- Wilhelm sinken erschöpfen Boden -- 
  schwarz Roß langsam Reiter heran -- 
  halten zerstören Zauberkreise -- 
  Probe bestehen -- sprechen -- Begehrst -- 
  -- antworten Wilhelm -- brauchen -- bereiten -- 
  Hülfe -- fahren Fremde fort -- gehören -- 
  nichn -- rufen Wilhelm -- weder gedung rufen -- 
  Reiter lächelen höhnisch -- 
  Kühner -- sprechen -- dein gleich Pfleg -- 
  Nimm Kugeln -- bereiten -- 
  Sechzig -- -- treffen -- äffen -- wiedersehen -- du_es verstehen -- 
  Wilhelm wenden -- 
  wiedersehen -- rufen -- Verlaß -- 
  wendest -- -- 
  fragt Fremde furchtbarem lächeln -- Kennst -- 
  -- -- -- schreien Wilhelm schaudernd -- kennen -- wissen -- 
  -- Verlaß -- 
  schwarz Reiter wenden Roß -- 
  aufsteigend Haupthaar -- dumpf Ernst -- gestehen -- kennsen -- 
  -- Schauder Geist sträubend nennst -- 
  Wort verschwinden -- Baum -- halten -- senken verdorrt Äste Boden -- 
  14. Barmherziger Gott -- Wilhelm -- geschehen -- rufen Käthche Mutter Anne -- Wilhelm Mitternacht bleich verstören Haus -- siehst -- Grab steigen -- 
  Nachtluft -- antworten Wilhelm -- Fieberhaft -- 
  Wilhelm -- Förster -- hinzu treten -- Walde begegnen -- 
  Ließest halten -- 
  machst blau Dunst -- 
  Wilhelm Ernst Vaters betreffen -- 
  -- erwidern -- begegnen -- 
  dulden -- 
  -- wissen -- -- Sohn -- -- -- 
  fallen alte -- Gottlob -- -- geheim bleiben -- 
  Laß ruhig -- Mutter -- Stör -- Käthche -- 
  beinahe Unrecht tun -- Wilhelm -- 
  gehen -- erhole -- Nacht -- Sprichwort -- keiner Mensch Freund -- fassen Mut -- Beruf guen -- schaden Nachtspuk -- 
  Wilhelm Verstellungskunst nötig -- verraten -- alt Ahnung Wahrheit übereinkommen -- 
  schonend Liebe Vater -- unerschüttert Vertraun -- schwer Verschuldung deuten -- zerreißen Herz -- 
  eilt Zimmer -- entschließen Zauberwerk vernichten -- 
  Kugel -- brauchen -- rufen weinend gefaltet Hand Himmel -- 
  O Absicht zweideutig entsündigen -- 
  tausend Büßung versöhnen -- sündig -- 
  -- Glück -- Ehre -- Liebe zerstören -- 
  Vorsatz stillt Unruhe Brust -- Sonne ruhig entgegen -- hoffen -- 
  15. fürstlich Kommissarius -- verlangt ernsthaft Probe Jagdpartie jung Förster -- 
  -- -- -- alt Solennität beibehalten -- Kunst Jäger zeigen draußen Wald -- 
  Frisch -- Herr Expektant -- Wald -- 
  Wilhelm erblaßter Entschuldigung vorbringen -- Landjägermeister fruchteen -- bitten -- Probeschuß zuvor -- 
  alt Förster schüttelen bedenklich Kopf -- 
  Wilhelm -- Wilhelm -- -- -- bebend -- tief Stimme -- gestern ahnden -- 
  Vater -- -- rufen -- Verzweiflung erstickt Stimme -- 
  entfernen schnell -- Augenblick Jagd fertig Vater folgen Jägermeister Wald -- 
  alt Förster suchen Ahnung unterdrücken -- bemühen vergebens froh Mien -- 
  Käthche niederschlagen -- -- träumend Haus umher -- 
  fragt Vater -- -- Probe aufschieben -- 
  -- -- umarmen schweigend -- 
  Pfarrer glückwünschend -- erinnern Braut Kranz -- 
  Mutter Anne verschließen -- Eile -- beschädigen aufschließend Schloß -- 
  Kind geschwind Kranzhändlerin schicken -- Kranz Braut holen -- 
  Laß schönsn geben -- rufen Mutter Anne Kind -- griff Unwissenheit glänzend -- mißverstehend Verkäuferin Totenkranz Braut -- myrt Rosmarin Silber durchwanden -- 
  Mutter Braut erkannen Deutungsvolle Zufall -- schaudert -- suchen -- umarmend -- Grau Lächeln Mißgriff Kindes umwandeln -- 
  Schloß versuchen -- öffnet -- Kranz wechseln -- Brautkranz Käthchen Locke winden -- 
  16. Jäger kommen -- 
  Kommissar unerschöpflich Wilhelm Lobe -- 
  dünken fast lächerlich -- sprechen -- Probe Probeschuß verlangen -- 
  -- alt Ehre -- unnötig -- Sache abtun -- 
  Pfeiler sitzen Taube -- schießen herunter -- 
  Gott Wille -- schri Käthche herzueilend -- Wilhelm -- schieß -- 
  träumt Nacht -- weiß Taube -- Mutter behen Ring Hals -- kamsen -- Mutter voll Blut -- 
  Wilhelm ziehen angelegt Gewehr -- Jägermeister lächelen -- 
  Ei -- ei -- -- 
  -- furchtsam -- 
  schicken Jägermädchen -- 
  Mut -- Mut -- Bräutche -- Täubch Favoritche -- 
  -- erwidern -- bingen -- 
  -- rufen Kommissar -- Courage -- Herr Förster -- schießen -- 
  Schuß fallen -- Augenblick stürzen Käthche lauten Schrei Boden -- 
  Wunderliches Mädchen -- -- rufen Landjägermeister -- heben Käthchen -- Strom Blut quellen Gesicht -- Stirn zerschmettern -- Büchsenkugel liegen Wunde -- 
  -- -- rufen Wilhelm -- laut Geschrei ertönen -- 
  Zurückblicke Käthche totenbleich Blut -- 
  stehen Stelzfuß höllisch hohnlachen grinsen -- sechzig treffen -- äffen -- 
  Wilhelm reißen wütend Hirschfänger Scheide -- hieb Verhaßten -- 
  Verfluchter -- schreien verzweifelnd -- täuschen -- 
  sprechen -- sinken besinnungslos blutend Braut Boden -- 
  Kommissar Pfarrer suchen vergebens verwaist Eltern Trost zuzusprechen -- 
  Mutter Anne bräutlich Leiche prophetisch Totenkranz Brust legen -- tief Schmerz letzter Tran ausweinen -- 
  einsam Vater folgen -- 
  Wilhelm beschließen Leben Irrenhause -- 