1. Kind -- Nacht weinen -- schlafen -- alt Gertrud jung Gräfin Viola -- früh Bett treten -- wecken -- 
  -- 
  Sieh -- trüb Auge -- 
  Forttreibst -- welkst -- ehe aufgeblühen -- 
  Ermuntre -- Sieh -- bringen -- schön neu Kleid Ball -- Schwester Hochzeit -- 
  Sieh -- reich -- glänzt -- künstlich Stickerei -- violchen Fräulein Prinzessinn ausstechen -- 
  -- vertreiben Grill -- 
  Komme -- stehen -- sehen -- kleiden -- 
  -- lieb Gertrud -- antworten Viola -- verbergen heißen Auge Brust treu Wärterin -- laß weinen -- 
  Hochzeit sprechen -- froh Tänze -- 
  Nimm prächtig Kleid -- Glücklichere verschenken -- einfach Kleidung Weise Glück suchen -- 
  unerfahren Kind -- fallen Gertrud -- kennst Welt -- Schlos kommen -- nächster Kloster -- 
  Glaube alt Gertrud -- Viola -- jung Mädchen deinen spielen Herz schlimm Streich -- 
  Wärst -- halb Leben setzen -- Liebhaber bekommen -- hernach Hälfte -- 
  O kennsen serin Liebe -- rufen Viola -- Welt Himmel Glück -- 
  Rede -- Gertrud -- wenden -- reichen Bräutigam Schwester arm geliebter Viola kalt -- 
  freilich -- Kleid -- Kostbarkeit Geschmack überbien -- verschenken -- 
  Gertrud bewegen -- tröstet heiter Aussicht gut Zukunft -- jung Serin -- treu Liebe Viola -- Herz gewinnen -- 
  Mensch Schicksal -- zuletzt -- wenden wunderbar -- trübe -- gräm allzusehr -- verdirb schön Jugend beständig Traumgedank -- 
  gewiß Wunsch erfüllen sehen -- erstlich fromm Kind -- -- besonderer Ursache glauben -- 
  mehrmals ähnlich -- Gertrud -- fallen Viola -- laß wissen -- scheinen Tröstliche hören nötig -- -- 
  Gertrud lassen Zeitlang bitten -- erzählen -- 
  tragen Arm -- -- kränklich Kind warst -- hübsch -- -- freilich ändern -- bekümmeren -- schmeichelen Schwester Maria -- Engel aussehen -- 
  warst überlassen -- hättest manchmal Mangel gelitten -- sorgen -- 
  -- spaziergang Haus -- begegnen alt Waldmutter -- Gegend wohnen -- 
  Ferne gewahr -- -- -- -- 
  Gertrud -- schreien entgegen -- tragen Engel -- Kniet nieder -- küssen Händchen Kleidche fertig -- schön Kind loben -- 
  -- -- Waldmutter -- Violchen fromm Kind -- Schönheit anlangen -- sollten Fräulein Maria sehen -- 
  alte lassen stören -- 
  Maria schön -- fahren fort -- Viola schön -- Viola zeigen -- Maria weichen -- 
  Glück Liebe -- schönsen Mann Land -- wünschen -- Bräutigam -- 
  küssen nochmals Händchen -- trippelen Fort -- hören -- 
  siehst -- Violchen -- eintreffen -- Schönheit -- glauben -- denken -- bewähren -- Glück Liebe -- schön Bräutigam -- Hoffnung vorhanden -- -- 
  dir_es eigentlich erzählen -- setzen Gertrud hinzu -- -- Mensch Zukunft sehen -- Herrgott Auge geben -- -- kleinmütig -- Trost sagen -- Mut bekommsen heit -- 
  Viola neubeleben -- 
  dankt alt Gertrud Träne Beruhigung -- 
  -- standhaft bleiben -- rufen -- dunkl hoffnungslos Nacht -- 
  serin nennen -- 
  gestern Laube See schwuren ewig Treue -- -- 
  leises Händeklatsche tönt Fenster -- 
  Viola erkennen Zeichen Nähe geliebter -- eilen Hinab -- Freude funkelt Blick -- serine -- 
  reisefertig rüsten -- -- fragt Viola -- stürmisch Freude Wiedersehen serine genau betrachten -- 
  verlassen -- Viola -- antworten Serine -- Gefolge Graf Nadasti entboten -- 
  -- -- fragt Viola schmeichelnd -- Bleibe Viola -- 
  -- erwidern -- tragen Lehn Nadasti Folge versagen -- 
  Vermählung Glanz feiern -- 
  Nadasti's Vermählung -- rufen Viola erstaunend -- O -- sehen -- -- 
  fahren freundlich fort -- Nadasti heiraten Schwester -- 
  gehen Hochzeit -- wissen -- finden -- 
  serine angenehm überraschen -- 
  Vasallenverhältnis Nadasti fallen Felsen Herz -- zertrümmeren schön Gebäude Hoffnung -- 
  Viola Schwester Glanze reichen -- mächtig Nadasti erblicken -- glänzend Lehnherrn -- arm Serine -- Braut beneidenswern blendend Zukunft Abhängigkeit bieten -- Abhängigkeit Gemahl Schwester -- 
  -- glauben -- Geliebte nachteilig Schatten setzen -- 
  Viola 'n Entging Serini's Bewegung -- 
  kindlich -- Verhältnissen Welt -- ahndet wahr Grund -- 
  Erneuerte Schwüre treu -- ewig Liebe strömt Lippe -- rufen Himmel heilig Zeuge -- umsonst -- serine bleiben verstimmen -- hinterlassen nagend Zweifel Innigkeit Liebe Viola's Busen -- 
  2. alt Waldmutter niemals nachher wiedergesehn -- -- fragt Viola Abends lang schweigen -- eigentlich -- 
  genau sagen -- erwidern Gertrud -- leben -- erinnern -- Walde -- Leute Rat -- 
  niemals -- halt Künst -- 
  treiben Kunst -- -- fragt Viola neugierig -- 
  sagen -- antwortet Gertrud -- prophezeien Hand -- Kristallkugel Erdspiegeln -- zeigen Leute Person -- sehen verlangen -- dergleich Teufelsposse -- 
  Viola neugierig lassen mancherlei Waldmutter magisch Künst erzählen -- 
  bitten -- Gertrud Waldmutter führen -- -- Scherz Künste zeigen lassen -- 
  Scherz -- wiederholen -- bedeuten -- gewiß hübsch anhören -- Zukunft dunkel geheimnisvoll vorgesprochen -- denken Ausleg -- hernach eintreffen -- 
  Viola bitten -- Gertrud bleiben unbeweglich -- 
  -- sprechen ernsthaft -- Ding Scherz treiben -- 
  Geist Scherz böse gefährlich -- 
  Beispiel -- Scherz groß verderben ausschlagen -- Mensch Lebenszeit Glück Frieden bringen -- 
  Viola schweigen Zeitlang -- Wunsch -- Zukunft wissen -- erwachen -- 
  begreifen -- Wissen Zukunft Mensch schädlich -- bitten neu treu Gertrud Besuch Waldmutter -- 
  Geheimnissen Scherz treiben -- -- Wahrsagerin gut Rat geben -- sagen -- Serine lieben -- treu Liebe Hindernis besiegen -- 
  bange -- Widerstand -- Eltern fürchtesen -- mißmutig -- ermüdet abziehen -- o -- glaubst -- stolz -- 
  Laß Waldmutter fragen -- 
  sagen -- künftig Braut Bräutigam zeigen -- 
  -- -- -- 
  Kind -- Gertrud -- quäl Bitte -- 
  machen Freude -- -- 
  weißen -- verlangstn -- 
  Könntest Neugierde Schreck -- Tode wärst -- Leben froh Würdest -- 
  vergessen -- Agnes Rosenberg gehen -- blenden lassen -- Bräutigamsschau gehen -- 
  Viola höchst begierig wissen -- Agnes gehen -- 
  Gertrud weigern anfangs -- Geschichte erzählen -- lassen erbitten -- 
  Exempel erzählen -- warnen -- -- wiewohl ungern Sache denken -- Kopf böse Gaukeleie erfüllen Schlaf rauben -- 
  Höre -- 
  Agnes Rosenberg fromm Kind -- fünfzehntes -- schön -- 
  paar Schwester -- alt -- hübsch -- weit schön Agnes -- 
  -- Mann finden -- beredeten -- Wald -- Andreasgebet beten -- 
  nämlich gottlos Gebrauch -- Dirn heilig Andreas bös Vorhaben anrufen -- bitten -- sollen künftig Bräutigam zeigen -- 
  leichtsinnigen Dirn gehen Abends Mondschein hinaus Wald -- verführen unschuldig Agnes -- mitgeh böse Künsten Anteil nehmen müssen -- 
  abergläubisch Zeremonie beschreiben -- womit mannsüchtig Dirnen Liebhaber Stelle rufen -- wissen -- gewiß Wort hinlegen hinstellen -- woraus sehen -- Liebhaber dirn Lust -- -- 
  setzen Tellerch Essen -- Glas Wein -- Posse -- 
  alt Schwester -- Martha -- Rosenstock hingesetzen -- Lilienstengel -- 
  Agnes verstehen -- Glück -- fromm Vorsatz bleiben -- 
  Mädchen zurücktreten -- alt Spruch -- Baum -- ansehnlich Mann prächtig türkisch Kleidung -- schnell Schritt herzu schwingen Säbel zornig Haupt -- Rosenstock -- sanftmütig griff Blume -- alsbald Gesicht verschwinden -- 
  wiewohl Dirn erschrocken -- fassen wiederum Herz -- Schwester rufen Bräutigam -- Spruch zweimal -- zeigen -- 
  scherzen -- Mann Ehe begehren -- zuletzt unwillig -- verlangen -- Agn Zeichen ausstellen -- Bräutigam wollen Wahl -- stellen Zeichen -- 
  lassen Agnes bereden -- nehmen -- hing Tüchlein Baumast -- 
  Schwester rufen nochmals heilig Andreas -- alsbald schön jung Mann polnisch Kleidung prächtig Pferd geriten -- blicken traurig -- halten ritt langsam Lilie küssen -- worauf -- vorig Verschwand -- 
  Schwester machen mancherlei Auslegung Gesicht -- Ansehn Freier übel zufrieden -- beredeten jung Schwester -- Andreasgebet sagen -- Meinung -- -- vorhin -- alleinig Zeichen Kraft äußern -- lassen überreden -- Schwester Wille -- 
  sündhaft Lust Neubegierde erwachen -- treiben Gewissen frevelhaft Leichtsinn -- 
  -- Spruch -- -- zeigen -- wiederholen -- schwarz Walde -- Trauermänner -- lang Flöt ziehen herein -- tragen Bahr Sarg Leichentuch -- Baum kommen -- Agnes Zeichen aufstellen -- weht Tüchlein herunter -- fallen mitten schwarz Trauerzug -- 
  leichtsinnigen Spaß bitter Ernst -- 
  Agnes grausamen Anblick ohnmächtig hingesunken -- liegen Wochenlang Todkrank danieder -- -- Leben verzieh -- Schwester Sicherer erwarten -- angedeuten kalt Bräutigam jung Braut schmal Hochzeitbett heimführen -- 
  Viola schaudert Erzählung -- 
  -- lieb Gertrud -- rufen -- schmiegen furchtsam -- entsetzlich unnatürlich Ding sehen -- 
  arm Agnes -- 
  töten solch Anblick Stelle -- brächt Sinn -- 
  Bleibe wach Nacht -- eingeschlafen -- lieb Gertrud -- fürchten tot -- 
  Gertrud zufrieden Wirkung Erzählung -- gute -- Fortsetzung hinzufügen -- unglücklich Vorschau traurig Schicksal arm Agn eingewirken -- 
  Viola hören -- 
  Laß froheren Ding sprechen -- -- fürchten ohnedies -- schwarz Trauerzug Agnesen wehend Tüchlein Traume vorkommen -- 
  dienstfertig Gertrud erzählt glänzend Anstalt Nadasti's Hochzeit -- Viola -- einsamen Schloß Gertruds Pflege aufgeblühen -- Eltern Schönheit überraschen -- Mann Eintritt Welt bezaubern -- 
  Viola lassen ausführlich beschreiben -- hören bekommen -- furchtbar Bild -- Erzählung Fantasie erfüllen -- verscheuchen -- 
  3. Wolltest gestern Agnesen Geschichte erzählen -- Viola -- -- -- fürchten -- 
  Trafe Vorbedeutung -- bloß arm Agn -- 
  Sollst hören -- erwidern Gertrud -- Ausgang zeigen -- böse Ding wenden wissen -- gehofft Glück Mensch verderben gereichen -- Unglück Seite -- meinen -- -- zubereiten -- abmüht -- entfliehen -- 
  Agnes liegen krank Schreck -- erholen -- schön vorher -- 
  finden Liebhaber Menge -- -- jung schön Mann -- wissen Gunst gewinnen -- einig -- allgemein Braut Bräutigam ansehen -- 
  Agnes -- jung -- Hochzeit Eltern Schwester abwarten -- kaiserlich Rate verloben -- 
  Anzeichen Walde denken -- Anschein -- Erfüllung denken -- 
  Agnes Verlobter Hochzeit alt Schwester Landgute Bräutigam -- 
  Priester Brautpaar zusammengeben -- entstehen Geschrei -- Feind -- 
  Hülfe -- 
  Feind -- -- Gast besinnen -- Lärm bedeuten -- stürzen Haufen Türke herein Hochzeitsaal -- hauen nieder -- Mien -- widersetzen -- raub -- Plünder schlepp weiber Jungfrauen gefangener -- 
  Anführer Trupps Braut -- -- gefiel -- schön -- rufen Leute -- übergeben -- befehlen Leib Leben -- Frau aufnehmen -- 
  Erscheinung Türke bedeuten -- 
  entsetzlich -- Viola -- raubt Türke arm Agnes -- bewährt Erscheinung Tod -- 
  Höre -- fahren Gertrud fort -- -- 
  böse legen Plan listig -- Mensch Klugheit durchschauen -- 
  Agnes Türke eindringen -- fallen Angst -- Schreck Erfüllung Bräutigamsvorschau -- ohnmächtig arm Geliebten -- 
  streiden Wacker Braut -- reißen Türke Säbel Hand bahnt Weg Feind -- 
  arme halten ohnmächtig Agnes -- Hieb -- verzweifelnd -- -- entkommen glücklich halb tot Mädchen Haus Eltern -- Türke bloß Raub Plünderung ausgehen -- Nachsetze verweilen -- 
  Agnes erholen glauben -- Befreier errett Hand reichen -- Türk -- Schwester wegführen -- erschüttern -- Blendwerk Nacht unfehlbar Prophezeiung halten -- 
  Trennt -- -- fallen Viola -- 
  freilich -- erwidern Gertrud -- Siehst gefährlich Fallstricke Satan -- 
  Agnes heillos Künste treiben helfen -- glücklich Frau -- drängen schwarz Leichenzug Bräutigam Herzen Brust streiden unaufhörlich Liebe Furcht Tod -- glauben sicherlich -- Braut Tod -- -- Türk Schwester Altar geltend -- 
  grämen -- bloß Schatten vorig Schönheit -- 
  Geliebt -- frevelhaft Neugierde Bräutigam bekennen -- werfen bitter Haß -- fast tiefsinnig tapfer Sobieski Dienst Türke -- Wunder Tapferkeit -- Tod finden -- suchen -- 
  Krieg endigen -- polnisch Feldoberster entlassen -- lernen Agnesen Schwester kennen -- gelieben Agnes vergessen -- heiratet -- lieben -- Liebe angehören -- 
  Vorbedeutung erfüllen -- 
  Ehen -- Gatte früh Lieb lieben -- geraten gewöhnlich -- 
  Mensch niemals kindisch Eigensinn durchsetzen -- versagen -- 
  -- 
  Agnesen Schwester leben Mann -- -- Woche entwich Täuschung finden Unterschied eigentlich Agn Frau täglich groß merklich -- 
  weit Reise -- ziehen Feld -- kehren Mißmutiger -- ausgezogen -- 
  Frau härmen -- Gram zehrt Gesundheit Leben weg -- 
  letzter Krankenlager sehnt Schwester Agnes sehen -- 
  schicken Boten Agnes -- 
  spät -- 
  Haus Schwester -- Leichenzug Straße ziehen vorüber -- 
  leidtragend Witwer erkennen Agnes -- Gewalt vorig Liebe ergreifen -- vergessend -- treten Leichenzug umarmt Schwägerin -- Träne wiedersehen Auge fließen -- ergriff Tüchlein -- Agnes Hand halten -- trocknen Wange -- 
  erkennen Agnes spät Deutung Vorschau -- falsch Blendwerk schönst Leben betrügen -- 
  hüten indessen -- Schwager wissen lassen -- 
  -- Sage -- Mann tödlich Haß Frauensperson bringen -- Folge -- Bräutigamsschau zitieren -- Zitation Seele Grausamer Gewalt tödlich Schmerz Körper reißen -- 
  Trauer Agnes Schwager Hand -- leben -- Glück Gedanke stören -- spät anfangen -- genießen -- 
  Siehst Gertrud -- fallen Viola freudig -- vereinigen -- lieben Agnes -- 
  serine nehmen zehnfach Tod drohen -- 
  Auslegung Leichenzuge Walde -- 
  zusehen -- Tuch wegnehmen -- 
  Kind -- Gertrud lächelnd -- gestern Abend Fürchtetest bloß Erzählung -- verlangst arm Agne Mut wirklich Erscheinung -- 
  woher Herzhaftigkeit -- 
  frisch Morgenluft -- stark -- 
  -- Gertrud -- antwortet Viola -- Erzählung heben Schauerlich Anfang -- 
  -- sein Leute necken -- freilich -- lachen -- herzlich bedauern -- grauet Erscheinung -- denken -- hüt -- Geschichte Blendwerk sehen -- Trüglichkeit erkennen -- O -- lieb Viola -- entgegnet Gertrud -- red vermessen -- 
  Liste bös Feind auslernen -- 
  wissen fangen -- 
  fangen -- -- aufnimmen -- verloren betrügen -- ehe gewahr -- Schling -- 
  4. Bote Viola's Vater unterbrechen Gespräch -- 
  Graf Harras senden Tochter Kostbarkeit -- melden -- bereit halten -- Vermählung Schwester Residenz wohnen -- 
  glänzend Zukunft -- Brief Violen eröffnen -- -- düster Stimmung -- versetzen -- 
  Trennung Serine -- Schloß leben -- gering Mittel glänzend Residenz folgen -- scheinen Herz unmöglich -- Befehl Vater widersetzen -- Verhältnissen unausführbar -- 
  Bestürmt Gefühlen fliegen Gertrud -- beschwören Rat Hülfe -- 
  Gertrud erschöpft Überredungskunst -- trösten -- glühend Mädchen besänftigen -- 
  Geschwor -- rufen händeringend -- niemals verlassen -- beteuern -- eher Seligkeit Himmel entsagen -- -- 
  Eid brechen -- glänzend bereiten -- Geliebte trennen -- 
  Gertrud verweisen Vermessenheit Eide -- warnen Übereilung -- Violen zurückhalten -- Boten Brief serine abzuschicken -- worin beschwören -- augenblicklich Rettung zurückzueilen -- 
  verlassen -- sprechen Gertrud -- Liebe unwern -- -- wissen -- Liebe -- 
  Gertrud Mühe -- Violen beruhigen -- 
  besuchen bekannte -- Weg führen Hütte alt Waldmutter vorüber -- 
  Laß Wahrsagerin fragen -- -- Viola hastig Gertrud -- Weg führen umsonst hierher -- 
  Gertrud versuchen -- Violen Einfall auszureden -- vergebens -- 
  weisen Grund Vorstellung innerer Angst -- fühlen -- Ruhe gönnen -- wissen -- Ausweg Labyrinth finden -- 
  zwingst -- nachgeben -- Gertrud -- tun schwer Herzen -- ahnden -- Beruhigung Unruhe holen -- -- glauben -- niemals wahr Ruhe erlangen -- 
  gehen Wohnung Wahrsagerin -- 
  Waldmutter Haus -- fragt Viola Mädchen -- Tür sitzen Zither singen -- 
  -- erwidern -- Dämmerung fort Schädelmoos Alraun -- 
  warten -- 
  -- 
  Wechselreden bitten Viola Kind fortzusingen -- 
  Lied -- greifen Sait Zither -- Sing -- merken -- vorkommen -- Mond scheinen Helle -- tote reien schnell -- Fein liebchen -- fürchten -- O weh -- 
  heulen Klosterturm -- flatteren Wind Sturm -- 
  Kauz rufen Mitternachtstunde -- tote halten Runde -- Fein Liebchen -- fürchten -- O weh -- laß Kauz Totenbein laß sehen Bräutigam -- 
  Bräutigam schauen -- laß tote grauen -- Fein Liebe -- Findest -- 
  Vers -- Mädchen unwillig -- mehrmals Musik singen anfangen -- Text helfen -- -- merken -- 
  Viola Lust hören -- Waldmutter lang erwarten -- 
  Gertrud glauben besonderer Warnungszeichen zufällig Antreffen Kind finden ermahnt Violen ernsthaft -- Waldmutter prophetisch Kunst denken -- 
  5. 
  -- Viola Residenz abreisen -- erscheinen -- Viola ruhig entgegen -- Gertrud heftigbewegt Gemüt erwarten -- 
  treu Erzieherin Liebling Residenz begleiten -- 
  trennen tausend Träne -- versprechen gegenseitig pünktlichst fleißigst Briefwechsel -- 
  Viola bezaubern -- Gertrud voraussagen -- Vater -- Mutter Männerherz -- Kreis schlagen -- 
  Schwester Maria -- Nadasti's Braut -- zart Heiligengestalt -- scheinen strahlend Schönheit Viola's verdunkeln -- 
  alt Graf Harras verdoppelt Pracht Anstalt Vermählung Eltern Tochter -- Hochzeittag viol Welt einführen -- scheinen glänzend -- Liebling -- Wunsch gemäß -- verherrlichen -- 
  Vorbereitung erscheinen Vermählungstag -- 
  Bräutigam Glanz Stand Reichtum zeigen -- verspätet Umständlichkeit Feierlichkeit Ankunft -- 
  Gast indessen zahlreich versammeln -- 
  Glückwünsch umrauscht Braut -- Blick wendeten voll Bewunderung Sehnsucht Viola's blendend Schönheit -- 
  freundlich Ankömmling entgegen blicken -- gelingen -- Blick lang fesseln -- gesellig Wohlstand erfordert -- Eintretende ziehen neu Aufmerksamkeit -- Näherkommen neu gleichgültig -- 
  Braut scheinen Ausbleibe zukünftigen Gemales unruhig -- 
  trösten -- senden Späher hoch Turme Schlosses -- Viola entfernt jung Freundin -- Veranlassung schön -- weit Aussicht hoch gelegen Zimmer Schlosses zeigen -- 
  geraten mancherlei Gespräch -- Lärm Schloß Graf Nadasti Vasall Diener lang prächtig Zug ankommen -- 
  Viola eilen Hinab -- Empfang fehlen -- flüchtig Lauf scheinen Weg Obacht nehmen -- 
  verfehlen -- Gedräng Neugierig -- Ruheplätz weit Treppe versammeln -- Stufe -- fallen Boden Bewußtsein aufheben -- 
  Nadasti Gefolge Nähe -- Geschrei Zusammenlauf Unglück ahnden lassen -- 
  eilt Gedränge erstaunen -- schön Mädchen bewegungslos blaß leich arm Freundin Frau liegen -- 
  fragt Name Veranlassung Zustande -- Graf Harras Maria herbeieilten leblos Viola einsam Zimmer begleiten helfen -- 
  Nadasti folgen -- klagen -- -- wiewohl unschuldig -- Gedräng Einzug -- Veranlassung unglücksfalle geben -- 
  wenden -- vergebens -- 
  Arzt scheinen bedenklich -- obgleich außen bedeutend Verletzung Viola bemerken -- 
  Vater Mutter Verzweiflung Nadasti fühlen -- Ungewißheit Ausgang Vermählungsfeierlichkeit vollziehen können -- 
  Graf Harras dankt aufopfernd Rücksicht Schmerz -- weinend Maria sinken Blick unnennbar Wehmut kalt Busen bleich Schwester -- 
  6. Viola Gertrud -- 
  verbirg fromm Auge gefallen Kind -- Gertrud -- 
  Lies Bekenntnis Schuld -- Viola dein Mitleid wert scheinen -- eil -- helfen Rat Tröstung -- 
  verweisest Unachtsamkeit -- Gefahr Bangigkeit Störung Haus bringen -- 
  O Gertrud -- Verweis verdienen -- 
  Unachtsamkeit -- Schrecken -- Innere Blitzesgewalt zerriß -- werfen besinnungslos Boden -- 
  Sollst wissen -- 
  lobtest letzter unser Zusammenleben Roseck Fassung -- Reise Bestimmung entgegen -- obwohl geliebt Serine trennen -- 
  verdient Lob -- 
  Fassung -- nanntest -- dunkel Stunde unheilig Mächte geben -- 
  Frucht verboten Erkenntnis -- Sehnsucht Grenze Paradieses Kindheit treiben -- 
  -- folgen gelassen vorausgeeilt Wünsch -- 
  Gertrud -- fürchterlich bestrafen -- 
  Ahndest Schuld -- 
  Höre -- 
  Bote -- Angst Herzens Serine schicken -- leeren -- tot -- eiskalt Wort zurückkommen -- geliebter -- schützen -- naht -- herzzerreißend Verzweiflung -- wecken Schatten Abenddämmrung bange -- zaghaft Furcht Brust unglücklich Viola -- 
  sehnt Helfer fremd -- dunkel Welt -- Erde Zuflucht bieten -- Himmel Engel zurückhieln -- 
  entwich leis Obhut -- mütterlich irdisch Bedürfnis sorgtest -- Heil Seele verlieren -- 
  finden Führer unbekannt Weg Wälder Felsengründe -- stehen Hütte -- Kind unheimlich Gesang wegschrecken -- 
  -- warnend Engel hütet furchtbar Pfort -- betört Sinn erkennen Warnung -- 
  bleich abgehärmt Knabe -- alt -- -- liegen Schwelle -- singen sterbend Stimme Liebeslied Walfrida -- wildsehnsüchtigen-Weise -- bloß Tamburin begleiten -- 
  Glücklich -- singen Wahnsinn Blick Ton -- Walfrida -- Santo Liebesglut vergehen -- 
  Walfrida -- Walfrida -- 
  säumst töten -- Liebesflut Blut Abendbad röten -- 
  Entfessle Quelle -- spielen Lust Arm Brust -- heiß Liebeswelle graust Liede furchtbar Begeisterung -- womit Knabe Instrument schwingen -- 
  gleichwohl vermehrt Wahnsinn verlangen -- Waldmutter sehen -- 
  klopfen Türe -- 
  ansehnlich -- schwarzgekleidet Weib treten heraus -- 
  bemerken Knabe -- Lippe Saum Kleid sinken -- 
  Willkommen -- Jungfrau -- redet -- Bequemer -- 
  begehren -- 
  schweigen -- Mund aussprechen -- Herz denken -- Wort -- 
  Redet Scheu -- -- wissen -- eur Liebe treu -- sehen -- eu Buhle -- abwesend -- beginnen -- künftig Bräutigam schauen -- 
  Walfrida zeigen -- Mond Wolke -- Spiegel Kristall -- Rauch leiblich Bild -- begehren -- 
  Zeige künftig Gemahl -- zitternd -- erkennen -- Geliebter -- anderer -- 
  Weib heißen nachfolgen -- 
  Hütte gehen Gemächer -- Fels hauen -- Hütte Eingang bilden -- 
  wunderbar ausgeschmücken -- Walfrida redet Erdspiegeln -- alraun Zauberwese -- zeigen -- Angst lassen merken -- 
  führen weit Gemach heißen Weile warten -- 
  finster Nacht -- getraut Schritt vorwärts rückwärts treten -- wiewohl fürchtet -- Auge fest zuschließen -- sehen -- 
  totenstill -- dünken -- hören Stimme Knabe -- 
  plötzlich fühlen -- Schmerz Brust -- durchbohren glühend Draht -- laut Aufschrie -- 
  Walfrida Geschrei herzutreten -- erzählen -- begegnen -- verlachen fast höhnisch -- entsetzen -- heißen Muts -- setzen hoch brennend Kerze Gemach -- 
  legen pergamenten Streif abenteuerlich Bild Charaktern -- Verbot treten -- vorgehen -- 
  sprechen unverständlich Wort -- singen -- laufen fürchterlich Gebärde Kreis herum -- 
  Weile Knabe Tamburin kniet Zauberin nieder -- ergreifen metallen Spiegel -- umgewenden Wand lehnen -- halten schnell -- darein blicken -- Knabe -- sinken augenblicklich tot Boden -- fast Grau Kreis gesprungen -- Weib halten -- fürchterlich Drohung gezwung Kreis bleiben -- 
  neu Planetenspiegel -- -- kräftigst Konstellation arbeiten -- bringen -- hineinsiehen -- unvermeidlich Tod -- 
  unschädlich sollst -- voll Kraft erfahren -- 
  fing neu beschwören -- Gebot -- schnell Tod Knabe heftig bestürzt -- 
  Spiegel Bild Mann -- Herz umwandelt ziehen -- Auge wenden -- entzünden -- Wahnsinn -- strömn Liebeswut Knabe Spiegel -- Tod bringen -- 
  Bild Spiegel scheinen Welle nah -- Spiegel -- stehen leiblich Gestalt -- wirklich Mensch dicht Zauberkreise -- -- Zug klärlich unterschied -- 
  tragen prächtig ungarisch Kleidung -- vornehm Magnat glänzend Orden zieren -- 
  Hand halten schön Bild golden Fassung feurig Edelsteine -- 
  nah schweben -- Blick -- Mann -- Serine -- Blick matt Schimmer Sonnenglanz scheinen -- 
  sinken Knie strecken Bittend arme -- -- Bild Hand zerbrochen blutig ritzen -- Arm Kleid röten -- 
  vergessen -- aufhören beschauen -- Beifiel -- bestimmt Gemahl -- Wonne Gedanke fast töten -- 
  stören Wahrsagerin Glück -- zufrieden -- scheinen -- besinnen -- entlassen Schattenbild -- 
  träumen -- überzeugen nehmen -- Andenken -- Werft -- geziemt Jungfrau -- Bräutigam rufen -- 
  fürchten -- weigern begehrn -- 
  zornig -- Auge funkelen -- sprechen -- 
  halten Mann -- Jungfrau -- meinen -- eur Liebesbrunst pflegen sollen -- 
  sehen -- sehen wollten -- rühren Hand -- -- Hinnen gehen -- 
  wissen -- ergreifen -- Hand Schattenbilde reichen -- ziehen Schmucknadel Haar -- Schleier anheften -- berührt Hand -- Erscheinung ausstrecken -- worin zerbrochen Bild halten -- 
  Augenblick verschwinden -- finden Wahrsagerin -- geträumen -- -- rufen -- -- überall -- erblicken -- 
  geträumen -- Weib -- sehen eurer Schmucknadel Blut Wunde eur künftig Gemahl -- 
  O -- Gertrud -- -- Weib -- Stein Knopfe Nadel blutig -- 
  Rieb hastig fürchterlich Zeichen -- Blut vertilgen -- 
  eilt bestürzt Schlos -- wunderen wach finden -- glauben -- halb Nacht Weibe -- vermissen -- zeigen -- halb Stunde schauderhaft Begebenheite zubringen -- 
  entkleiden -- blutgefärbt Nadel erfüllt neu Grauen -- versuchen nochmal Spur Blutes vertilgen -- 
  vergebens -- 
  ziehen rötlich Blutstreif rein Diamant -- bangen Arbeit leuchten -- Schein bleich -- Nacht ruhelos furchtbar Angst verwachen -- 
  O -- Gertrud -- einzig bang Nacht -- 
  fruchtbar -- sünd -- 
  Schreckenstunde gebären -- 
  Errätst Zusammenhäng -- 
  Erscheinung heftigst Liebe entflammen -- 
  Gertrud -- schüchternen Auge Viola blickn frei Schar Mann -- suchen schön Urbild unbekannt Schattengesicht -- 
  schön jung Mann drängen -- Schwester Bräutigam erwarten -- 
  Bild Herz ähnlich -- 
  -- Geschrei Schloß erscholl -- Bräutigam -- Stufe hinabeiln -- Schwester Vater entgegen führen -- o heiligen -- 
  stehen -- schön -- Nacht -- 
  bann Seele zweifelnd Auge -- heben -- Verband zeugen Wunde -- 
  -- Gertrud -- Nadasti -- Maria's Verlobter -- 
  Sinn verlassen -- sinken Boden -- 
  bewußtlos liegen -- erfahren spät -- 
  O erwachen -- 
  beginnen -- treu Gertrud -- 
  Rate -- 
  schwach Mädchen ändern -- Schicksal unwiderruflich beschließen -- 
  Nadasti lieben -- sagen Blick -- 
  suchen überall versäumen Schwester -- himmlisch duldend Maria -- 
  Braut -- Gattin -- 
  enden -- 
  7. Nadasti Viola's Anblick entzünden -- 
  wich Bett -- erstenmal Zimmer verlassen -- bieten -- groß Auszeichnung Genesungsfest feiern -- 
  Gegend ring umh Vergnügung allerlei Art einladen -- viol Schritt fröhlich Auftritt überraschen -- 
  sonderbar -- Nadasti -- Gästen Worte Viola's Unfall wechseln -- ziemlich ähnlich Schicksal gewissermaßen natürlich Verwandtschaft Viola anzuzeigen scheinen -- 
  -- zuvor -- -- unerklärlich Zufall -- fest Gesundheit Übereinstimmung bringen verstehen -- 
  teuer Maria Bild erhalten -- Freude Schönheit holden Freundin drückt Gemälde -- Lippe -- plötzlich unbeschreiblich Beklemmung Atem Besinnung rauben -- -- Viola -- bewußtlos Boden liegen -- Hand Diener erholen -- 
  schön Bild -- Heftigkeit Fall zerbroch -- Blut -- Glas Hand unbedeutend verletzen -- Unkenntlichkeit verlöschen -- 
  welch Glück -- Viola gefährlich Verletzung Gefahr entgehen -- 
  Viola Erzählung erblassen -- 
  Nadasti Teilnahme -- 
  freuen -- sprechen steigend Wärme -- Zufall Leben -- scheinbaren Zusammenhäng -- 
  -- -- lieb Viola -- irgendwo sehen -- währ Welt -- 
  nennen immerhin Schwärmer -- bleiben schön Märche -- Band lieb Freundschaft heilig unauslöslich denken -- Welt zart mystisch Vereinigung -- Sympathie nennen -- ehren fortführen -- 
  Lassen Fantasie -- erfreut -- Teil -- Irre -- währ Anblick vormalig Freund erscheinen -- 
  Viola schweben peinlich Bangniß nähern Erklärung -- 
  wendet Gespräch -- Angst vermochen -- 
  Zufall begünstigen -- 
  Maskenaufzug -- ernst komisch Gattung erscheinen -- vereinigt fantastisch Tänze Sälen frei Platz -- 
  Stern zahlreich dunkel -- klar Himmel herabblickten -- tanzt Nadasti scherzend Viola Reihe heraus -- Zeichen wandeln -- Zauber Gegend -- 
  festlich Feuer flammt Berggipfel -- Wald brannen farbig Schmuck -- Boden steigen Sternheer wetteifert Lichter Himmel -- ringsum -- Donner Musik -- halln Viola's Name -- begrüßen feiern -- Wälder Felsenwände -- 
  überraschen blickt hocherrötend Nadasti -- 
  schließen fest Arm -- schnell -- glühend erwidert Kuß lösen letzter -- leicht Hülle gegenseitig Geheimniß -- 
  kühler Nachtluft versammelt Gesellschaft Säle Schlosses -- 
  Tanz gesellig Spiel wechseln -- Maske geben Veranlassung mancherlei Verkleidung romantisch Zusammenstellung -- 
  Viola orientalisch Gewand Nadasti's Bitte anlegen -- Kopfschmuck ordnen bemühen -- reichen Maria Befestigung Schleier Schmucknadel -- 
  plötzlich erbleicht Nadasti -- wehren wild Blick -- 
  -- -- 
  rufen heftig bewegen -- weg -- fort Nadel -- 
  Umstehenden sehen befremdet -- fassen schnell -- 
  Vergebe -- schön Maria -- kurz Besinn -- Nadel erinnern -- Blitzesschnelle Gedächtnis vorübergehen -- entflohen -- Mühe geben -- zurückzurufen -- 
  mehrere -- Begebenheit -- zuweilen Wort -- besinnen -- verwandte Klang Bild Erinnerung anregen -- deutlich Bewußtsein -- 
  Nadel -- reichen -- 
  erschüttert Innerst -- wissen -- fühlen sogar körperlich Schmerz völlig geheilt Wunde -- 
  Maria reichen nochmals Nadel -- 
  Besehn Nadel genau -- sprechen lächelnd -- besinnen -- 
  -- Ball -- -- verloren eintauschten -- 
  Nadasti's fortgesetzt Weigerung -- Nadel annehmen -- scheinen Maria unwillig -- 
  Kind -- -- laß Nadel aufstecken -- Viola -- Graf wunderbar Antipathie -- 
  -- -- -- 
  rufen Viola heftig abwehrend -- 
  zumut Nadel tragen -- 
  Nimmermehr Nadel sehen -- 
  Viola erschrak -- Heftigkeit -- 
  Nadasti Weigerung hervorbrechend Zeichen Liebe -- 
  gütig sinnen -- Maria -- Viola -- Blick Maria verraten -- lieb Augenblick bedeutendst Sieg letzter Hindernis Herzen erkämpfen -- 
  8. Viola entsetzen furchtbar Wirkung Nadel Nadasti sehen -- 
  Wort Gertrud's Erzählung -- 
  sage tödlich Haß wecken -- Mann erfahren -- Frauensperson Vorschau rufen -- fallen lastend Herz -- eilt Zimmer -- unglücklich Schmuck -- Abbild mächtig wirken -- entfernen -- 
  hastig öffnet Etui -- bleich Schreck tief erschüttern fahren -- Stein Fassung Nacht -- Blut entstellen -- 
  werfen schaudernd Gegenstand Schreckens -- -- ehe Lauscher erwachen -- senkt verräterisch Zeuge verborgen Spalt Gebirgsfelsen -- 
  serine indessen Viola's Nadasti Liebe Geheimnis bleiben -- 
  klagen treu Gertrud Wankelsinn geliebter -- weigern -- Verständnis -- bloß nachsichtig Schwäche geliebt Pflegtochter dulden -- Vermittlerin abgeben -- 
  schreiben Treulose -- Viola -- Inhalt erraten -- verschieben Eröffnung unangenehm Brief -- Antwort bleiben -- 
  serine äußerste bringen -- fühlte verlassen -- verachten -- Liebe verwandeln bitterst Haß -- schworen tödlich Rache Viola Nadasti -- 
  unerkannt Fest -- womit Nadasti Viola Genesung feiern -- Liebenden Sehnsucht Zeug einweihend Kuss -- 
  überzeugt Geschick -- 
  Maria scheinen gleich Rache Liebenden -- -- beschließen Beider Verderbe vereinigen -- 
  Ungestüme verrechnen -- 
  Maria Nadasti's Viola Liebe Serine sehen -- 
  -- Vermählung unerwartet stören -- tief -- ahnungsvoll Blick Viola's Herz tun -- 
  lieben Schwester Eintritt väterlich Haus wunderbar Schwärmerei -- 
  Verborgenheit -- Viola -- glauben ihretwegen vernachlässigen -- leben -- zart Gemüt still Vorwurf -- treiben -- aufopfernd Liebe -- -- Viola Schicksal -- Kinderjahre trüben -- versöhnen -- 
  geliebt Schwester nahe Tod Arm liegen -- still Gelübde -- Liebe -- ahndet -- stören -- Schwärmerei -- Kindheit Kloster ziehen -- erwacht erneut -- doppelt Gewalt -- 
  still Vorsatz verran -- beobachtet liebend -- Serini Eifersucht sicherst Beweis bringen -- Viola Nadasti's Liebe glücklich fühlen -- stehen Entschluß fest -- 
  mahnen Serine ernsthaft Entschluß -- Liebenden Rache opfern -- Bitte zureden fruchtlos bleiben -- drohen -- Plan Nadasti entdecken -- 
  serine stellen überreden -- versprechen Rache aufgeben -- Treulose vergessen -- Herz beschließen Vorhaben -- sicher ausführen -- 
  9. Nadasti vergessen Liebe beinahe Maria Braut betrachten -- 
  mancherlei scherz kalt sehnsuchtlose Bräutigam erregt Aufmerksamkeit -- Graf Harras Gespräch gestört Vermählungsfeier vorschlagen -- Maria's eintretenden Geburtstag Hochzeitfest wählen -- helfen Einfall Verlegenheit -- Zusammentreffen häuslich Fest Zahl Freudentage minderen -- Maria's Geburtstag Fest feiern müssen -- 
  serin Rache ausersehn -- 
  Abend zuvor durchstrich Gegend -- 
  Zufall führen Weg -- Nadasti Viola Spaziergang wählen -- 
  blind Wut Eifersucht lassen Plan vergessen -- glücklich Nebenbuhler -- richten Gewehr -- zitternd Leidenschaft fehlt Ziel streifen bloß Viola's Gewand -- 
  Nadasti's Ruf Schuß versammeln Landleute -- erschrocken Viola Haus zurückführen -- verfolgt Täter -- 
  raten vergebens Unternehmer verwegenen -- Serine gefangen einbringen -- 
  Nadasti beschließen Stelle Tod -- sobald zuvor Folter Beweggrund blutig Vorhaben -- 
  Untersuchung Festlichkeit morgend Tag aussetzen bleiben -- 
  Viola ertragen -- tief gekränkt Serine ihretwillen sterben sehen -- 
  öffnen unbemerken -- Zerstreuung festlichen Tag Gefängnis -- serine -- unwissend -- Freiheit danken -- ergriff Flucht -- 
  Nadasti wütet -- folgend gefangener vermissen -- 
  fordern genauest Untersuchung -- leichtesn Schatten Verdacht -- 
  einig Maria mehrere Person serin einsam angelegentlich Gespräch sehen -- mehrere bemerken -- Serini's blutig Absicht entferntest Mutmaßung -- 
  entsetzlichst Verdacht erwachen Maria -- 
  -- scheinen -- Serini's Vorhaben wissen -- Rächer Liebe wählen -- 
  Befreiung scheinen Werk -- gefährlich Zeugnis Mitschuldige verhindern -- 
  Nadasti nötig Trennung Braut wünschen -- Umstand beweisend ansehen -- 
  stellen sogleich Nachforschung -- alt Graf Harras leisen Wahl -- Untersuchung Serini's Entweichung fortsetzen -- Verbindung Maria gefallen Verdacht aufheben wünschen -- 
  Harras erklären letzterer -- Nadasti erbieten -- Vermahlung Viola öffentlich Mißdeutung zuvorzukommen -- Ausgang genau Untersuchung Maria Familie Ehre zweifelhaft scheinen -- 
  Heimlichkeit -- Unterhandlung treiben -- ahnden Viola Verdacht -- Schwester fallen -- 
  Maria geringst Argwohn -- Zeile Nadasti kaltem bitter Tone Notwendigkeit anzeigt -- Vermählung zurückgehn müssen -- 
  Ursache hinlänglich voraussetzen -- 
  Maria faltet Papier schmerzhaft lächeln -- 
  verdient Liebe -- ruhig -- verlassen Schloß Eltern -- Stunde Abschiedsbrief nah Kloster ankommen -- 
  Viola anfangs Maria's Entfernung untröstlich -- Graf Harras tief Stillschweigen Begebenheit beobachten -- auflegen -- ahndet unerfreulich Geheimnis -- 
  fürchtet Hülle durchblicken -- Dunkel Weg längst ersehnten -- wunderbar zubereitet Glück -- 
  10. Maria's Einkleidung vorüber -- Nadasti sucht Vermählung geliebt Viola möglichst beschleunigen -- 
  stellen sogar beträchtlich Festlichkeit -- Vermählungsfeier verherrlichen gesonnen -- begnügt Verbindung bloß Kreis Familie Anzahl nächster nachbarlich Freund vollziehen -- 
  Sehnsucht Liebe -- bestimmt Eile Krankheit Maria's -- bedenklich scheinen -- unwillkommen Verzögerung drohen -- 
  Maria liebend Herz Kränkung leiden ertragen -- letzter häufen -- 
  erliegen Schmerz sehnt geliebt Schwester sehen -- 
  Viola erfahren Wunsch -- Vater Nadasti fürchten verkannten Maria Gefahr Liebling -- täuscht Violen beruhigendster Nachricht Schwester -- 
  erscheinen Vermählungstag -- 
  Viola bringen Nacht zuvor schlaflos -- wild Fantasie -- 
  nah Glück -- fehlt Ruhe -- erfreuen -- 
  Zithertöne Kinde umhallen -- unwillkürlich singen schauerlich Melodie -- Bräutigam schauen -- laß tote grauen -- 
  scheinen blutig Nadel überall begegnen -- vergebens werfen -- -- blutig Hand -- -- Hütte Wahrsagerin -- durchdrang Brust stechend Schmerz -- furchtbar Träum wecken -- furchtbareren überlassen -- 
  -- dämmert -- Erschöpft matt Strahl Trost finden meinen -- zittern weiß Morgenduft Bett -- blasse Nonnengestalt beugen langsam -- 
  Viola erkennen Maria's Angesicht -- heftig Schrei rufen Frau herbei -- entsetzen sehen weiß Schattengestalt Viola's Bett weggleit hereinfallend Morgenstrahle verschwinden -- 
  Nadasti entsetzt Viola's entstelltem Ansehn -- -- Braut Altar führen -- 
  schützt Fieber -- gestern fühlen -- achten -- 
  Maria fragen ängstlich -- Nachricht Kloster -- 
  Viola Fassung nötig -- Platz Altar erreichen -- 
  fürchten letzter Augenblick gewaltsam Störung Bundes -- Enthüllung entsetzlich Täuschung Zutreffen Vorschau -- 
  feierlichbindend Wort sprechen -- frei Atemzug erleichteren bang Brust -- 
  Schrecken Nacht erscheinen wesenlos bedeutungsle Traumbild -- schmiegt Bewußtsein sicher Glück liebend Seite Gemahl -- froh versammelt Gast Gattin vorstellen -- 
  11. bereitet Tafel -- Botschaft Äbtissin Klosters Trauerpost Maria's Verscheiden bringen -- 
  endet heilige -- Laienschwester -- letzter Nacht Nonn kranke gewacht -- Nacht sehnt Schwester -- beten brünstig -- Gott Gnade geben -- Viola sehen -- -- schmerzhafen Träne Bluttropfe fromm Auge fließen -- 
  Schwester Sterbegesang anstimmten -- schließen Auge lächelen freundlich Schlaf Selige Engel -- 
  liegen Viertelstund -- schlagen langsam hell Auge freundlich -- weinen -- glauben Schlaf erquicken -- 
  sprechen leise Himmel gewenden -- 
  nimm -- Viola sehen sterben -- 
  Schwester ausreden -- lächelen sprechen -- 
  wissen -- reden -- Viola -- 
  schließen Auge beten Entschlafen -- 
  -- -- -- rufen Viola -- Geist -- Traum -- O Maria -- sehen -- lieb Ewigkeit gehen -- 
  anwesenden erstaunten -- meinen -- Viola sprechen neu Fieberfantasie -- Frau treten hinzu berichten -- Morgendämmerung Viola's Schlafzimmer sehen -- 
  stimmen Genauest überein -- Morgenrot Maria verschieden -- 
  Freude Tage Trauerbotschaft stören -- 
  Nadasti tief erschüttern -- 
  Maria Liebe Viola wunderähnlich Ereignis bestätiget -- Himmel scheinen Verdacht Entschlafen vernichten -- 
  Wunderbar unbegreiflich -- rufen -- Maria -- Mörder Viola dingen -- voll Liebe verfolgter -- 
  Widerspruch vereinigen -- 
  Maria lästern -- rufen Viola -- abscheulich Heimlichkeit liegen verbergen -- 
  Nadasti schweigen -- 
  Graf Harras Tochter Winke Maria's entdeckt Einverständnis Serine -- 
  Lüge -- abscheulich Verleumdung -- -- entgegnet Viola heftig -- Gott Zeuge -- Maria verabscheuen -- warnen Serine -- 
  O -- verstehen -- Warnung -- unschuldig Heilige -- 
  Nadasti erwähnt Serini's heimlich Befreiung Gefängnis -- Maria Einverständnisses verdächtig -- 
  Viola vernichten -- 
  unselig Verwirrung -- schwach Stimme -- öffnet Gefängnis -- 
  ich_es gestatten -- meinetwegen Mensch töten -- serine sterben lassen -- 
  Maria wissen -- 
  O heilig -- vergeben -- Mörderin -- 
  Nadasti Graf Harras versuchen -- Viola beruhigen -- 
  bekannt traurig Verwirrung schuldig -- Rücksicht Konvenienz -- genau Untersuchung verhindern Enthüllung Wahrheit unmöglich -- 
  Maria's Erscheinung verzweifelnd Trost geben -- einzig Gegenstand Gespräch -- 
  12. befremdend dergleich Vorfall scheinen -- Priester -- Trauung vollziehen -- unser Urteil Täuschung Unmöglichkeite schnell -- 
  Gesetz Natur geschehen -- freilich unmöglich -- Kenntnis Naturgesetz Gesetz verwechseln -- unmöglich halten -- wovon Gesetz einsehn -- 
  körperlich Natur zeigen unerklärlich -- Wirklichkeit bezweifeln -- Bekannt nennen -- Bewegung Wein Gefäß Blüte -- 
  geistig Natur -- Gesetz kennen -- oberflächlich Kenntnis Grenze festsetzen -- 
  lesen hören Beispiel ähnlich Anziehungskraft Geistern Körper -- geistig Naturforscher Gesetz untersuchen -- fertigen faul Vernunft -- sagen Unglaube -- Wort Täuschung Unmöglichkeit -- 
  überreden Wirklichkeit Vampir -- Nachbar beunruhigen -- -- wandt Gast scherzend -- 
  wünsch unbefangen Untersuchung -- antwortet geistliche ruhig -- Rechnung Fazit zuvor einbilden -- laufen Gefahr falsch rechnen -- 
  anderer Vampir -- anderer Geist -- kurz Körper trennen -- Sehnsucht fremd Gewalt zwingen verlassen -- 
  erster Fall selig Maria -- Erzählung Zitation -- stimmen überein -- Zitiert furchtbar Angst totähnlich Zustand versetzen -- bleiben -- Geist Körper zurückkehren -- 
  fast beistimmen -- fallen Nadasti -- erraten -- zitieren -- 
  Woche erfahren ähnlich Zustand -- unnennbar Angst Toter hinsank langsam erholen -- sonderbar -- dunkl -- verworren Erinnerung vorschweben -- fremd unbekannt Ort entrückt Ding sehen -- -- manchmal Erzählung Traume -- Wort finden -- 
  Gemahlin erfahren ähnlich Ohnmacht -- 
  zart -- schön Geist bannen -- 
  Böswicht töten -- Qual -- empfinden -- furchtbar Verdammt Höllenstrasse schreiben -- 
  Viola -- zart Körper Schmerz ertragen -- 
  Viola schaudert -- Bewegung verbergen -- fragt geistliche -- Kenntnis Natur jemals Höhe gelangen können -- ähnlich Wunder Gesetz erklären -- 
  -- erwidern -- bestätigen -- Zweifel setzen -- märchen ansehn verlach verwerfen -- 
  kürzlich Entdeckung -- interessant -- 
  alt Schriftsteller behaupten -- Diamant Blut erweicht können -- neueren hingegen verlach Behauptung Märchen -- 
  neulich finden Juwelier Stein -- Zweifel Diamant -- weich elastisch -- drücken lassen -- 
  Brilliant schliffen -- müssen Erweichung geschehen -- Zustande Schleife -- 
  Überdiese rot Streif wahrscheinlich -- Blut liegen -- sogar eingesogen müssen -- 
  kaufen Liebhaber naturseltenheiten ziemlich hoch Preis -- obgleich Seltenheit weitem teuer -- 
  Einwendung -- Geistliche lassen Diamant bringen -- 
  Fassung -- -- Etui eröffnen -- Juwelier kaufen -- 
  Graf Harras -- Geistlichen sitzen -- greifen schnell Juwel -- 
  -- rufen heftig -- Juwelier Nadel -- 
  -- Tochter Viola kurz Roseck schicken -- 
  erinnern -- erwidert geistliche -- Knabe erkaufen -- Felsspalte finden -- 
  Graf Harras scheinen zweifeln -- 
  Sieh Viola -- sprechen -- Nadel Stück Schmuck -- 
  Viola bedeckt Hand Auge -- wehren furchtbar Nadel -- -- Traume vorig Nacht -- Seite entgegendrängen -- 
  bedeuten -- -- rufen Graf Harras -- erbleichst Nadel -- 
  Besinn -- liebste Viola -- Nadasti besänftigend -- ebenfalls Nadel vorhieln -- 
  Blick unglücklich Kleinod Violen werfen -- plötzlich starr furchtbar Blick aufspringen -- Wunde Hand öffnet -- Blut spritzen umher -- 
  Ha -- Schlange -- rufen wild Zorn Viola -- erstarren blaß Leiche Stuhl liegen -- fürchterlich klar -- 
  verflucht Zauberin -- höllisch Bann Seele ausziehen -- Tod ängsten -- 
  Blut -- Stein röten -- 
  dringen neu Wunde -- höllisch Gauklerin anklagen -- 
  O Maria -- 
  heilig verbündeter Abgrund opfern -- 
  Viola strecken bittend arm Erzürnt -- 
  Nadasti stoßen Bittend ergrimmen -- 
  schadenfroh Dämon leiten Hand -- Spitze Nadel Drang Viola's Brust -- 
  rächen -- Nadasti -- sterbend -- Zauberin -- 
  lieben Serine -- 
  höllisch Kunst zeigen Bildes -- begehrn -- -- 
  Zauber lösen -- 
  Vergib Stunde Angst -- Tod vergeben -- 
  Augenblick treten serin Gertrud herein -- 
  Verdacht Maria gehören -- geeilen Unschuld beweisen -- 
  Viola Blut mäßigen Zorn Mann -- letzter Blick Sterbende fleht Versöhnung -- 
  Viola erblaßt arme treu Gertrud -- 
  serine ziehen Pilgrim heilig Grab -- Nadasti finden Schlacht fallend Feind willkommen Tod -- * * * 