König Königin Taccamahacca -- allerlieb Prinz -- 
  austragen -- formieren allemal Maler Bildhauer Reich Haye -- Flug Amor Engelskopf erlauschen -- Mann -- schön Form Phantasie einzubilden -- 
  Prinzchen klug gelehrig -- Gelehrt bedauert -- Wunderkinder Königssöhne -- jung Roscius -- Apellesse Homere Welt erstaunen setzen -- 
  königlich Eltern einzig Freude lieben Kind -- 
  wünsche wuchernd Unkraut -- geschäftig Erfüllung beschneiden vermögen -- keimt Herz Königs Königin neu Wunsch -- 
  sehnt Prinzessin -- -- Art schlagen -- doppelt Liebesgöttin Gestalt -- vierfach Grazie Liebenswürdigkeit -- zehnfach Muse Wissenschaft Kunst müssen -- 
  Junge wild -- König -- Mädchen behalten zarter einschmeichelnd -- 
  Junge fremd Hof -- erwidern Königin -- Tochter ziehen bedeutend Fremde Hof -- 
  unterredeten Abend -- freut zärtlich Umarmung Einverständnis Herz -- Wunsch Gedanke -- 
  Schicksal taub Bitt König -- 
  Königin fühlt Grund Hoffnung -- schön Frühlingsabend -- Stern glücklichst Konstellatione Schönheit -- -- Reichtum königlich Freude leuchteen -- wiegen schön lebendig Rosenknospchen Schoß -- 
  Prinz kommen Bett Genie herbeigesprungen -- küßten entzückt Liebhaber zart Mädchen Lilienhändchen beinahe weg -- dunkel seiden Ringellock -- tief blau Augenhimmel lächelnd öffnen -- 
  Morgensonne rötet Vorhäng Wiege -- nötig finden -- königlich Kindbetterin Ruhe überlassen -- 
  bleiben -- 
  Rosenblättern Blumenkelchen -- Haselnußschale -- Tautropfe -- Mück -- Schmetterlinge -- Goldkäfer -- Heupferde -- Binse -- Sonnenstrahl -- Laubfröschen -- Seite schwommen -- schweben -- Gefahr -- Gekroche -- getrippeln -- gehüpfen -- geritt -- Zimmer seltsamst Equipag Leibrosse erfüllen -- 
  Fee Königin Bekanntschaft -- jedesmal Festlichkeit einladen bewirtet -- nächster Mal wiederkamen -- 
  müssen Besuch heimlich halten -- König stark Geist glauben weder Feerie Zauberei -- ähnlich Ding -- 
  gesammelt Feenschaft Königin letzen -- neugeboren Prinzeßch geloben küßen -- Fuhrwerk Leibroß empfehlen -- 
  Königin führen nochmals Wieg -- empfehlen Rosamunde neu Schutz -- bitten prophetisch Versammlung -- Kind Abschied Horoskop stellen -- 
  Fee sehen verlegen -- Sprache heraus -- 
  alt -- lieb Freundin -- tun leid -- diesmal eurer Schuld bleiben -- 
  unser letzter Ball Schicksalsbuch verkramen -- -- Gelehrt -- Büch Kunst -- erlassen Nativitätsstellen -- 
  Fee unschuldigst Gesicht Ausrede -- Königin merkt Unrat -- wiewohl hören hoffen -- drang Fee -- angesehenst Versammlung Bescheid erhalten -- 
  Rosamund -- mannbar -- Brüdern Gefahr -- Tod bringen -- 
  Unglücksprophezeihung ziehen Feenkarawane -- 
  Neugier Königin stillen -- Sorge Betrübnis Stadt desto laut -- 
  arm Königin essen -- trinken -- Schauspiel sehen -- Ball besuchen -- putzen -- sprechen -- 
  merken König -- schwer Herz liegen müssen -- Tag aufgehoben Tafel -- Schatz -- fehlen -- sprechen Tafel Viertelstund Kutschgeschirr geheim Oberkanonierer -- Wort -- 
  -- antworten Königin -- Rosenölfläschche zerbrochen -- schmerzen -- 
  -- König -- lassen Rat schaffen -- 
  sogleich lassen Apotheker -- Olitätenkrämer Galanteriehändler Stadt zusammenberufen -- verschafft Königin Rosenöl Stunde -- Rose Welt tausend erlangen -- 
  Königin zerstreuen -- 
  fehlen -- -- fragen König Ball -- Rosenöl unmöglich verbrauchen -- 
  -- Königin -- schön Locke verbrennen -- betrüben -- 
  freilich Schade -- erwidern König -- lassen helfen -- 
  falsch Locke lassen -- stecken -- sehen -- Kopf falsch Perückenmacher tragen Hand -- 
  falsch Löckche kommen -- ächt Locke Hof fallen Schere -- 
  geschehen -- König voraussagen -- Königin bleiben mißmutig zuvor -- 
  König fragen Neuem -- 
  Königin -- gestehen -- Trauring Born fallen lassen bedeuten -- 
  König lang Gesicht -- ew -- Majestät -- sprechen -- geruh Wahrheit entfernen -- Ring -- Born fallen -- wohlaufbehalt Glied Uhrkette sehen -- 
  ziehen heraus -- lassen Gemahlin Trauringe Glied Kette betrachten -- 
  Königin schämen -- wissen Gemahl Wahrhaftigkeit Treue -- 
  Ausflucht ersonnen -- Se -- Majestät schmolln -- 
  -- Umschweifen -- gestehen Kindtaufskonversation Fee bedenklich Prophezeiung -- 
  König moralisiern -- 
  ergriff Gelegenheit -- Gemahlin Strafpredigt verboten Umgang Fee halten -- ereiferen verstandeswidrig Tendenz Zeitalter Mystischen Wunderbar -- 
  fertig -- erinnern Königin -- geschehen Ding ändern sein -- klüg -- denken -- Übel vorbauen -- ehe hereinbrach -- 
  König -- überlegt Nacht -- Königin Resultat finden -- König Staatsrat befragen -- 
  Staatsrat versammeln -- 
  Finanzminister Meinung -- Gefahr bestehen bedeutend Ausleerung Schatze künftig Ausstattung -- sicher offenbar Auflage -- 
  Kriegsminister Gefahr wichtig Brautwerber drohen raten Vergrößerung Armee -- 
  Großalmosenier ahnden frevlerisch Liebe Bruder Schwester -- König Gewissenssache -- Prinzessin Kloster bestimmen -- 
  debattiert Versammlung Abend Journal Erfindung -- Theorie Widersprüchen -- vorläufig Punkt einig -- wichtig Sache reiflich Überlegung ziehen besonderer Kommission niedersetzen müssen -- 
  Kommission sitzen -- Königin gesamt Hofstaat fleißig Sache Rate -- 
  Tag hört alt Amme -- Walde -- unfern Residenz -- alt Eremitin leben -- breit Rat fragen -- Not helfen -- 
  Königin entschließen sogleich Wallfahrt -- 
  nächster setzt Leibroß -- 
  wissen Schnee Hufen rein Dukatengolde beschlagen -- 
  paar Kavalier -- begleitet -- Rock Westentaschen voll Ring Juwele -- Mantelsäcke voll Schleier Schawls neu Geschmack alt Sibylle Wald -- 
  Königin Kavalier müssen suchen -- ehe Wohnung Wahrsagerin finden -- wohnen einsamen Bruder Schwester Hütte Grotte -- hohl Eichbaume -- bemerken -- Wipfel Tummelplatz respektabl Pfauenassemblee -- Reiz Putz Gesanges entfalten -- 
  Königin vermuten Gegend Wohnung Waldeinsiedlerin -- lassen Geschenk ausbreiten -- Baume nähern -- 
  müssen klopfen -- ehe inwendig Stimme antworten -- bog Baumrinde abwärts -- drängen Konvolut Leinwand Wollenzeug hervor -- Nasenspitze Kinn freundschaftlich gegenseitig Küsse begrüßen -- 
  Sibyll nämlich steckt Kopf heraus -- sehen -- Haushaltungsgeschäft stören -- 
  schön Sache Erde Büschen ausbreiten Königin golden Krone Haupt erkennen -- bog Eile Rinde Baum rückwärts -- abbrach -- Baumbewohnerin Türe sowohl Haus fallen -- Haus -- 
  Königin laufen schnell hinzu -- aufheben -- Kavalier Respekt Königin zurückbleiben -- zart Weiblichkeit Einsiedlerin protestieren gellend Entweihung Reinheit männlich Hand -- glauben bloß Versuch beleidigen -- vornehm Gast aromatisch Gegende verwünschen -- Pfeffer wachsen -- 
  Königin Hand voll -- schmollenden Dryade Bein helfen -- Figur bedecken ansehnlich Stück Land lang -- bunt -- faltigen Talar -- früh -- glücklicher Fußteppich dienen -- 
  gelingen Königin -- erwarten Riesin -- stellen -- Alter gebückt Mütterche Fuß -- Knie Kopfe reichen -- Tagereis nötig -- Schleppe Talar entfalten -- 
  Schreck erholen -- bringen Königin Wort -- 
  bitten bedeutend Blick mitgebracht Geschenk gut Rat -- versprechen zehnmal bringen -- ablaufen -- 
  alte schmunzelt klatscht Freude Hand schön Sache -- 
  rufen laut -- Pfauche -- Pfauche -- Augenblick flattert Pfau -- fangen gräßlich Geschrei -- Königin Ohren fest zuhielt -- 
  tief musikalisch Studium alte finden Konzert äußerst harmonisch -- ärgert Geschmacklosigkeit galant Auditorium -- 
  Lärm aufhören -- treten alt Königin sprechen -- 
  getrost -- Königsweib -- 
  Baue stählern Turm Tochter -- verschließ -- sehen -- König Haus Dienerinne -- 
  entgehst Gefahr -- 
  Turm -- zart Frucht Liebe Manne geben -- Sohn Übel befreien -- bedrohen -- 
  -- Prinzessin Aussicht Stahlturm verlassen -- -- denken Königin -- Orakel Waldsibylle erbauen -- 
  alte trippelen Baum Hand voll Feder niedlich Hündch -- 
  billig -- -- lieben künftig Schwiegertöchterch Geschenk machen -- wert -- 
  paar Feder Brautbett -- schlafen -- hündchen spielen -- Prinz Prinzessinn gewohnen -- beißen -- vexier necken -- 
  Pfauenorchester fing mächtig Sinfonie -- Königin Pferd Sporen Galopp Walde hinaus sprengen -- 
  hündchen gefiel -- 
  allerliebst Tierchen selten Art -- existieren -- Exemplar Fee bekommen -- 
  Farbe schön Himmelblau -- Kopf -- Hals Brust weiß Löckche -- leicht Wölkche zart umflossen -- blaßrot Öhrch -- Rosenblatterchen hervorspitzn -- Rücken Samt -- Schweif voll -- reich beweglich -- schön Federbusch jung Feuerköpfchum -- 
  Feder vergessen Königin allerliebster Hündch -- Glück -- denken -- wegzuwerfen -- bringen leicht Geschenk unwillkürlich Schloß -- 
  schallt Wehklage entgegen -- Prinzeßch früh geschrien beruhigen -- 
  Königin lassen Hündch Feder fallen -- fliegen Wiege -- herumstaubend Feder Kind berühren -- augenblicklich ruhig -- lächelen Schlief -- 
  Königin ahndet Schatz -- sammeln schnell Feder -- füllen Bett Prinzessin -- 
  Kind jemals gesund Bett liegen -- Prinzessin Rosamunde -- 
  Wunder Feder versöhnen König Wunderglauben Gemahlin -- 
  entlassen Kommission -- vorläufig Kommunikation Universität Königreich benachbart Staat beschließen -- berufen Stelle Architekt Land -- 
  tragen -- stählern Turm Prinzessin bauen -- Todesstrafe schnell -- Wache einweihen -- 
  Baumeister versprach Eilfertigkeit -- indessen tummelt Möglichkeit -- arbeiten Nacht geschwind Bau fertig -- Geist Aladdin's Wunderlampe -- 
  Turm Attrape Großem -- 
  außen freilich einladend -- inwendig desto schön Prinzessin einrichten -- 
  Wände Spiegelgla -- schwerfaltig seiden Tapete behängen -- Treppe alabast -- Tür Zedernholz -- Meuble Schildkröte Elfenbein -- Fußböde Edelsteinmosaik Decke hingen golden Kette Schalen Kristall -- Rubin -- Smaragd -- Saffir -- Opal kostbar Stein herab -- beständig wohlriechend Spiritus flammen -- Beleuchtung Turms -- -- Prinzessin abzusondern -- Fenster -- 
  Zimmer pädagogisch akustisch Prinzip bauen -- jeder Wort -- Prinzessin hören taugen -- Schall -- 
  entstehen Pause Unterricht Konversation Prinzessin -- König verstummen zuweilen Minute -- Turm fest bauen -- lassen ändern -- 
  Turme wachsen Prinzessin -- 
  Langeweile -- König schicken Spielsache -- Prinz kommen täglich -- spielen -- 
  erzählt Tageslicht draußen -- Wälder Garten Sonne -- Mond Stern -- 
  machen Lust Welt sehen -- sprechen Anfing -- schicken König Kleid Bonbon -- Spielsache -- Welt vergessen -- 
  indessen Prinz herangewachsen Prinzessin -- 
  König Hofe Partien fremd Königstöchter erzählen -- fragen Prinz -- 
  Papa -- Schwester Partie -- 
  Königin Hochzeit fahren -- fragen Prinz -- Mama -- Rosamunde Hochzeit -- 
  Edukationsrat ritterlich Tat erzählen -- faßn Prinz Heldenentschluß -- Rosamund Turme befreien -- 
  Künste nötig -- zufrieden stellen -- 
  Prinzessin Turme fallen -- 
  Bonbon schmeckt -- Spielsache langweilig -- Hofstaat abschmacken -- Kleid zeigen -- -- Bestimmung vierzehnjährig Mädchen Turme suchen -- 
  König Königin ruhig Stunde -- 
  Turme klagen Prinzessin -- Schlos plagt Prinz -- auswärts fragt Menge Kaiser könig Prinzessin abgesandter -- 
  Ruf Rosamunden Schönheit geschwiegen -- vergrößern -- größ Phantasie Frau Fama -- 
  hoch Königspaar verzweifelt Möglichkeit Ausweg Labyrinth finden -- finden ungesucht natürlichsen -- legen sterben -- 
  Hof Land schwarz -- 
  Glöckner Arbeit Verdienst -- Organist Verdienst Arbeit -- 
  Kanzel Rednerstühle beweisen -- Krone würdig Haupt verlieren -- 
  Poet sagen Vers Maler Allegorie -- 
  unterdessen königlich Leiche bestatten -- Reichsständ versammelt -- geben Prinz scharlachenen goldgestickt Mantel -- Hermelin füttern -- -- setzen diamanten Krone Haupt -- golden Thron -- 
  schreien Volk dreimal Kraft -- 
  leben König -- 
  geistlich weltlich Redner beweisen -- Krone niemals würdig Haupt bedeckt -- Poet singen -- Maler allegorisierten -- 
  Welt froh -- dachen Fest Ehre Königs -- Freude Gast Ruhm Wirt -- 
  König Thron steigen -- Prinz -- Bruder -- Herr Land -- Ding Schwester Turm erlösen -- arm Kind erbärmlich Langeweile -- 
  Besuch hübsch Mädchen sehen -- 
  -- tun -- 
  springen Garten -- König drehen Eile Bart Schlüssel -- Prinz heben Tür angeln -- verlieren -- 
  Prinzessin Rosamunde füttern himmelblauesr hündchen Bonbon -- Bruder -- stehen -- fassen alt Hand -- -- 
  Schöne gut -- Majestät -- 
  König -- gehorsam Dienerin -- 
  nimm abscheulich Turm -- sterb Langeweile -- 
  fing bitterlich weinen -- 
  König umarmen -- -- Wein -- lieb Kindchen -- gib zufrieden -- sollst Langeweile -- kommen -- Turm Palast holen -- Menge Ritter Hofleute Kurzweile -- 
  Prinzessin fort weinen -- zeigen Prinz neust Modekupfer -- Komme -- fort häßlich Turm -- such schön Brautstaat -- König hübsch Mann geben -- 
  Prinzessin zufrieden springen fröhlich Turm -- 
  Turm Winkel königlich Garten -- 
  Rosamunde bleiben bezaubert stehen -- 
  staud Pflanze Porzellanvase stehen Riesengewächse hoch Baum -- zart Blüte -- Hauch vorsichtig schonen -- schwimmen glänzend -- duftender Gewühl Frühlingsluft -- 
  Blume -- schön bunt -- Hand sorgsam Pflege aufzog -- blüht Fuß -- einzeln Vogel golden Käfig -- tönt Chöre Nachtigalle Colibris Büschen belaubt Wipfel entgegen -- golden Glanz Sonnenlichtes einladend freundlich anwehten -- 
  Rosamunde fliegen -- küßen Blume -- drücken Vögel Brust -- umarmen schlank Zeder -- nennen Palmenbaum Bräutigam -- 
  treten nah Lustwald prächtiger Pfau -- breitet Vielaugch Irisbog Glorie -- 
  -- rufen Prinzessin -- lassen Palmenbaum Zeder -- schön Vogel umarmen -- scheu Luft erheben -- Wald zurückflog -- 
  Bruder herbeigelaufen -- erzählt -- Pfau -- dergleichen speisen -- 
  Prinzessin -- 
  -- rufen entrüsten -- Fürst Vögel erkühnen töten -- 
  gewiß Schwester -- heirat Pfauenkönig -- Pfauenkönigin -- sehen -- Pfau unschön Wort sagen -- 
  König verblüffen seltsam Allianz -- besann -- Prinzessin sagen -- 
  Gedanke ungekünstelt heraus -- -- Ei Rosamunde -- Vogel heiraten -- 
  Vogel -- -- antwortet Prinzessin ärgerlich -- Pfauenkönig heiraten -- König Pfauen and Ding Untertan -- 
  -- wenden König -- wissen -- Pfauen König -- 
  Prinzessin Ernst böse -- 
  Hör -- -- Flaus -- 
  Papa Mama -- König -- See Untertan -- 
  Pfau sehen schön schön -- folglich König -- mächtig König -- sagen -- Pfauenkönig heiraten -- 
  Grund lassen König freilich einwenden -- 
  führen Prinzessin Schloß -- lassen schönst Pfau fangen -- Prinzessin Zimmer Hofstaat bekommen -- 
  schön Rosamunde Pfau Gegenstand Bewunderung Hofe -- 
  Herr Galanterie erklärt Sonette Xenien Juno -- bat Erlaubnis Pfau -- Stellvertreter vorläufig Wohlklang Vers legitimieren -- 
  Range begnügt Günstling Tafel Toilette aufwarten -- 
  Rosamunde lachter wunderlich Leute -- fragen Bruder täglich -- Pfauenkönig finden -- 
  König Prinz sehen -- Prinzessin Einfall ablassen stille grämen -- 
  traurig beratschlagt -- -- 
  schicken überall herum -- lassen Anfrage Anzeiger Intelligenzblätter einrücken -- holt Universität Fakultät Response -- setzen Preis -- vergebens -- 
  tages sprechen König Prinz -- Weißt -- Bruder -- selber Mann -- 
  bekommen Frage gelehrt Abhandlung Vaterland Pfauen -- Wanderung Jo -- Galanterien Jupiter Gott wissen -- verwandt Gegenstand -- Nachricht unser gut Bruder -- Pfaukönig -- 
  Laß auszieh aufsuchen -- ohnedies -- Langeweile leiben -- 
  Prinz -- umarmen König -- 
  gehen Prinzessin -- sagen -- vorhatt -- 
  Rosamunde küssen tausendmal Freude -- versprechen Reise regieren -- 
  helfen Prinz Mantelsäcke packen -- legen hübsch Souvenir -- empfehlen -- Pfaukönig mitbringen -- 
  König Prinz unterwegs -- 
  reisen Inkognito -- Gefolge -- 
  Grenze Reich kommen -- fragen Gasthof Pfauenkönig -- Wirt Gast lachen -- meinen -- Pfauenmajestät residier Märchenheim Fabelhausen -- Land -- Geschichte Tage bedeutend Rolle spielen -- 
  königlich Wanderer ziehen finden seltsam Sitte Volk -- 
  rechtlich Entscheidung zweimal Woche verlost -- bemerken -- Urtel öfter Gesetz übereinstimmt benachbart Land -- Reich bevölkert -- 
  Staatsämter tote übertragen -- Klasse alt kranke bekommen -- 
  jung Leute höchstens Nachtwächterstelle bekleid -- gesund -- besonderer Rekommendation gelangen -- 
  Sonderbarkeit steigen Hoffnung reisend -- Pfauenreich erscheinen -- 
  Land Volk sehen -- Held Odyssee -- glauben nächstens Weltbretterverschlag gelangen -- hübsch Städtchen ziehen -- 
  Markt Teppich ausbreiten -- kommen hübsch gekleidet Leute -- machen Teppich Purzelbaum -- gehen vergnügen Weg -- 
  König wunderen -- Polizei gestatten -- vorübergehenden befragen -- Polizeidiener -- kündigen -- täglich siebzig Mal Frau küssen Prinz desgleichen -- siebenzigtausend golden Federsteuer entrichten -- 
  Wanderer lachen laut -- fragen -- Kuß genau kontrolliere -- 
  Bote versetzen ernsthaft -- Ort lachen -- Berechnung einwenden -- stehen frei -- täglich Summe Küs bestimmen -- unfehlbar Purzelbäum bekräftigen -- 
  helfen -- König Prinz Reisende legitimieren -- weder Frau -- führen -- folglich weder siebzig Mal Tag küssen können -- Federsteuer bezahlen -- müssen Kopf Kopf unten -- 
  gymnastisch Probestück ablegen -- wissen wünschen -- Kuß verzollen -- woher geheim Kuß-Ausschuß boudoirstatistischen Notiz nehmen -- 
  dienen -- hübsch Mann -- stehen -- 
  ungefähr zwanzigtausend Land bös Krieg verwickeln -- Stadt leiden -- 
  müssen Kriegskanzleie Schreibfeder -- Tafel Gast Gans überlassen -- hiesig Gegend vorzüglich gedieh -- Stadt Sitz Akademie -- Feder brauchen -- 
  Verlust Menschenalter ersetzen -- gleichwohl zweifeln Mensch -- Feder Federkraft Staat liegen -- Buch -- folglich Schreibfeder -- Staat bestehen -- Stadt wenigsen -- Akademie -- 
  Not schließen Allianz benachbart Reiche -- jährlich zwanzigtausend Million Bund Pfauenfeder -- Bund hundert Stück -- Akademie liefern -- Land nötig Bedürfnis versorgen -- 
  Kosten aufzubringen -- legen Steuer Küs -- entbehren -- -- 
  -- ältlich Herr -- nehmen sogar übel -- gering anschlägen -- geben freiwillig verlangen -- 
  Erzähler schwatzen -- reisend ansehnlich Quantität Pfauenfeder hören -- wisperten Ohr -- geben -- 
  unterbrechen König Erzählung Frage -- 
  Pfauenkönig Nähe residier Lieferant Akademie -- 
  -- Antwort -- Reich grenzen unmittelbar unsrig -- Gesandtschaft -- Federallianzgeschäft dirigieren -- 
  froh -- Rosamunden Brüder -- Pfauenkönig finden -- 
  umarmt Pfauenfedersteuereinnehmer -- versah Empfehlungsschreibe gesandter Pfauenhofe eilen Kurierpferde -- 
  Mädchen -- Rosamund -- errat -- Pfauenkönig -- König unterwegs wissen Himmel -- erwidern Prinz -- Sinn kommen -- 
  manchmal Somnambul -- 
  Grenze Pfauenreiches flogen laufen überall Pfau entgegen -- weiß -- blau -- grün bunen -- nirgends Welt finden -- 
  machen Lärm -- meilenweit hören -- 
  König bedenklich Gesicht -- Prinz -- Bruder -- Pfaukönig Pfau -- fatal Lage -- 
  Pfau Schwester unmöglich heiraten -- sauber Descendenz geben -- 
  freilich -- Prinz -- 
  wissen gar_nicht -- Mädchen manchmal wunderlich Zeug Kopf -- 
  Beruhigung sehen Ferne Stadt hoch türm fest Mauer -- Vogelschnäbeln erbaut scheinen -- 
  Mensch Pfauenreich -- König -- -- 
  Gasse Stadt wimmelen Mann Frau -- Anzug -- Putz meister Gerätschaft Pfauenfeder -- 
  reisend verwundern umsahen -- öffneen paar bronzen Flügeltür prächtig Palast -- König fahren heraus schön Karoß -- wovon Gestell Gold -- Räd Diamant Sitz Rubin -- 
  König sitzen -- Firmament Stern Sonne -- zwölf majestätisch Pfau bilden Gespann -- 
  Pfaukönig jung -- Ankömmling -- schön -- Ansehn -- 
  Krone Pfaufeder Federmantel Pfauenähnlich -- niedlich stutzbärtch Nase -- jung Stutzer anderer Land metaphorisch Flaum -- natürlich zart Feder wachsen -- 
  vermuten fremde Anblick paar interessant Mann -- Länder- Völkerkund lieben -- halten Pfauengespann -- lassen König Prinz rufen -- unterhalten -- 
  kommen -- Höflichkeitsbezeigung Prinz -- fern landen hergekommen -- ew -- Majestät schön Porträt zeigen -- 
  Wort ziehen Miniaturgemälde Prinzessin rosamund Brieftasch -- zeigen Pfauenkönig -- 
  Entzück Wort finden -- tief Seufzer -- -- Welt Schönheit -- -- 
  O -- rufen Prinz -- Original tausendmal schön -- 
  Schwester -- Prinzessin Rosamunde -- stehen Bruder -- König Land -- Ew -- Majestät Ihrig -- 
  König Prinz -- 
  ew -- Majestät Lust -- schön Original Bilde heiraten -- Einwilligung fehlen -- 
  Schwester tugendhaft schön -- klug Tugendhaft -- bekommen Scheffel Dukat hundert Scheffel Silbergeld Mitgabe -- 
  Treue -- Pfaukönig -- machen besonderer Vergnügen -- heiraten -- schön Porträt -- schön -- halten Mensch -- 
  -- sagen -- Herr -- schön -- aufhängen -- laß aufhängen -- 
  fremde lachen -- versprach -- Bedingung Vergnügen hängen lassen -- 
  -- wissen -- Porträt ähnlich müssen -- verpflichtet Hofmaler -- Direktion geheim Oberphysiognomierat malen -- Naturkontrolleur vidimiern -- 
  vorläufig müssen -- Sicherheit -- Befehl Königs öffentlich Gefängnis begeben -- 
  finden Bequemlichkeit -- Pfauenreich herrschen exemplarisch Humanität -- Verbrecher -- besuchen Pfauenkönig gefangener täglich -- rechnen Stunde -- Prinzessin Rosamunde ankommen -- 
  sitzen Einladungsschreiben Braut -- Freude künftig Freude Feder Gedanke fallen lassen -- verloren schreiben -- 
  Rosamunden Hofe Taccamahacca Freude klein -- Briefträger Brief ankommen -- 
  Prinzessin laufen Schlos herum -- begegnen -- klatscht Hand erzählen -- Pfaukönig finden -- heiraten -- 
  Stadt Reich freut Tod -- 
  Nächte Stadt Erde Turmspitz illuminieren -- anzünd Lampen -- lassen brennen -- 
  Kanon abfeuern -- glüht -- verpufft Surrogat Knallpulver -- Kehlen schrien Pfaukönig Vivat -- heis -- stoßen Glas -- Festlichkeite wechseln unaufhörlich Bälle -- Schauspiel -- Maskenaufzüge Konzert -- Soiree Thees -- 
  Schlaf denken -- Tagesanbruch Souper -- Schauspiel Abends -- warten Diener -- 
  Öl -- brennen Ölsurrogat -- helfen Wein Bedürfnissen Freude -- 
  Lust ausgehen -- Surrogat finden -- Gegenteil finden anständig Betrübnis schicklich -- Prinzessin Reich Pfauenreiche vertausch -- 
  schreiben allgemein Stille -- verbieten Lustbarkeit hoch Strafe -- 
  Edikt pünktlich befolgen -- Prinzessin reisen -- 
  schlagen nächster Weg Schiff -- nehmen -- Amm -- Milchschwester -- Himmelblau hündchen -- Azur nennen -- 
  übrig Raum schiff Gepäck angefüllen -- Mädchen mancherlei Reise brauchen absonderlich Bräut -- 
  Unterwegs lachen singen -- 
  Rosamunde fragt Abend Schiffer -- Siehst Land -- siehst Land -- Pfauenstrand -- 
  antworten -- -- -- liegen hunderttausend Meile -- 
  fragen -- Schiffer -- sagen -- -- Schiffer -- sagen -- -- Pfauenreich nahen -- 
  Schiffer -- Frage Wind -- frag Wind -- blasen -- fahren geschwind -- 
  Sonne Meer senken -- fragen nochmals -- Schiffer -- nah -- 
  Schiffer -- nah -- 
  -- Schiffer -- -- 
  Schiffer -- schwenkt Mütze rufen -- Frisch -- -- 
  Hafen Lauf -- 
  Amme hören -- setzen Hinterteil Schiffes Fährmann -- loben Fahrt munteres frisch ansehen -- alt Steuermann herzlich schmunzelen -- 
  drückt Hand sprechen -- wolltest -- könntest steinreich Mann -- 
  -- -- entgegnet Schiffer -- reich sein -- 
  -- wiederholen Amme -- Haufen Gold könntest verdienen -- schwer Steuerrud -- wolltest -- 
  tun -- Schiffer ärgerlich -- liegen eu Haufen Gold -- sagen wissen -- hätten Speisepfort verschließen bleiben lassen -- 
  Amme Seite -- 
  mußt -- Ohr -- Prinzessin Nacht -- schläft -- Meer werfen -- 
  ziehen Tochter -- schön Popanzin -- Brautkleid -- lassen Pfauenkönigin -- heiraen vollauf -- 
  Schiffer Kreuz -- meinen -- Schade Prinzessin -- jung schön -- Prinzessin -- obendrein Braut -- 
  Amme Bouteille Wein lassen trinken -- Ertrinke hoch Glück halten versprechen -- Amm verlangen -- 
  Nacht indessen stark hereingebrochen -- 
  Prinzessin liegen Bett Gedanke geliebt Pfauenkönig -- 
  schmachtend dunkelblau Himmel -- Liebesphantasie Million Stern tausendäugig Pfauenschweif gut Welt vorkommen -- 
  füßen liegen gewöhnlich niedlich Azur -- Amme Tochter sitzen Bett sangen -- 
  Rosamund -- süßesen Schlaf -- rufen abscheulich Amme Schiffer -- 
  heben Prinzessin -- aufzuweck -- Bett -- Matratz Deck -- lassen sanft Meer fallen -- gewahr -- 
  Glück -- Unterbett Feder befinden -- alt Sibylle Walde Königin Rosamund schenken -- Phönixfeder -- mehrere rühmlich Eigenschaft -- Wasser niemals untersinken -- 
  Prinzessin schwamm Bett sicher -- Nachen -- indessen drang Wasser Feder Matratz Decke -- Prinzessin erwachen -- fürchten ausgeschmälte bekommen -- 
  Azur wacht Bewegung -- exemplarisch fein Nase -- witteren Lampret -- Auster Schildkröt Nähe -- 
  fing laut kläff -- Feschheit Schildkrötenschaft regen -- 
  Fisch böse stieß Kopf schwimmend Bett -- Welle drehen -- Kreisel -- 
  Prinzessin verwundern -- schelten Schiffer -- glauben -- führen ungeschickt -- 
  Azur bellt Bellen gebärden besessen -- 
  Amme hören Lärm Ferne -- spottet -- Schiffer -- 
  Horch -- Äffchen Trinkt Prinzessin Gesundheit lustig -- 
  indessen steuern rasch Pfauenland -- Popanzin erwarten -- Schiff Hafen einlufen -- 
  Empfangsanstalt fehlen lassen -- 
  Meer duften Meile Rose -- Lilie -- Jasmin -- Zimt Ambra -- 
  gut Essenz Öl unaufhörlich hineingegossen -- Land gut Geruch Königin bringen -- 
  hundert Fahrzeug kreuzn umher -- 
  Schildkrot -- Mast Riesenpfaufeder -- Segel Blatt Wunderrose -- Land wachsen -- 
  Hafen wimmelen Mensch Tier Fuß Wagen -- 
  Löwe -- Esel -- Bären -- Hirsch -- Wölfe -- Tiger -- Ochsen -- Elefant Karosse -- Polizei Land -- -- stand Range angemessen Gespann -- Wagen -- 
  Prinzessin stehen Zug schneeweiß Gazelle bereit -- 
  Geschirr Purpurrotem samt golden Platte -- 
  Zweihundert schön jung Mädchen halten abwechselnd Zügel -- ablösen -- bilden unaufhörlich schön Gruppe Gemälde -- Farbe kleiden -- gleichsam lebendig Musivstift -- reizendst Tänze schön Gemälde schönerer verwandeln -- 
  Amm indessen möglichstes tun -- Tochter Prinzessin Braut verwandeln -- 
  Popanzinne Unrecht -- sagen -- Natur Stück vergessen -- Schönheitrequisitenzettel eigensinnigst Kenner enthalten -- 
  -- freigebig Natur Anordnung Gabe vergriffen -- 
  glühend Rose Wang Haar verirren -- weiß Elfenbein Zähne Lippe bleiben -- Purpur Auge flüchten -- dunkl Braun Zähn überlassen -- 
  schön Wölbung Brust Rücken sehen -- beweglich Grübche -- süß Lächel bezeichnen -- fest Stereotyp bitter Verdruß -- Bein beschreiben schön Bogen -- Augenbraun bewundern -- 
  prächtig Schmuck -- Amme sparn -- Anzulege -- Armbänder fallen zart Schlankheit arm Handwurzel herab -- Halsband voll Rundung Halses verlängern -- 
  schuh Kleid klein finden -- 
  kosmetisch Werk ziemlich langsam staten -- vollenden -- trösten Schmückerin Geschmückt Spruche -- 
  währen -- -- 
  Pfauenreich scheinen Satz allgemein Gültigkeit -- 
  Volke -- Vivat rufen -- bleiben -- Popanzinne Anblick -- letzter Hälfte Ausruf Mund -- 
  Kammerherr -- Braut bewillkommen -- Doppelattack ästhetisch moralisch Gewissen widerstehn -- Anfang zierlich Rede -- 
  erfreulich -- verwandelt Ausruf -- 
  abscheulich -- 
  Menagerie Karossen scheu -- sanft Gazelle wild suchen Freie -- 
  Mosaiktänzerinn jagen -- verworren Gedränge bilden endlos Fülle Karikaturen -- Ähnlichkeit Popanzinn -- 
  müssen Eile Zug Pavian Wagen Braut legen -- brüsten Möglichkeit -- 
  Pfau -- Bürgerwache Hafen Palast Doppelreihe formieren Schweif präsentieren -- glauben -- Leibaff Prinzessin eröffnen Zug -- treiben unziemlich Späße Neckereien -- 
  Schiffer -- Aufnahme allzu Mute -- stoßen Amme leise -- 
  -- Mamsell hübsch -- 
  Amme fahren -- -- Beifall Menge Beweis -- wahr Schönheit -- 
  Gemein Natur verstehen -- 
  bringen indessen froh Nachricht Ankunft Braut König -- 
  -- -- Bruder -- schön Bild -- 
  Direktor königlich Vergnügung Antwort verlegen -- 
  Glück gehören Frage König vielumfassend Klasse Frage -- Antwort Anspruch -- König fahren fort -- 
  -- sehen -- 
  steigen Pfauenwage fahren Braut entgegen -- 
  Wagen tragen Reichsbarone feierlich Rosamunden Bildnis -- 
  folgen Reichsämter gesandter fremd Hof -- Hofstaat -- langsam König Pfauenwage -- umgeben Reichsvasall Pfauen -- 
  erwarten geliebt Rosamunde sehen -- springen Wagen -- umarmen -- 
  -- Popanzinn -- fahren -- Zitterroche berühren -- 
  Mensch König jemals zornig sehen -- 
  werfen Diadem Erde -- zerreißen königlich Kleid -- werfen sprechend Blick umh -- königlich Nähe verweilen -- 
  Stadium Zorn vorüber -- Entzündung Gemüt stillen -- befehlen -- Braut Amme Schiffer Ruine tief Turm werfen -- inhuman Justiz erhalten -- 
  Exempel statuieren -- Zukunft Lust bekommen -- König grob Art hintergehen -- 
  Rosamunden Brüder wissen -- Schwester ankommen müssen -- 
  auf gut herausputzen -- König memoriert Empfangsrede -- Prinz aufsetzen -- 
  Tür öffnen -- höflich Deputation Ehrenwache -- Hochzeitsfest rufen -- grob Kerkermeister sicherheitswache paar Dutzend Polizeidiener -- 
  führen häßlich Keller -- Tagereise tief Erde -- 
  Glück -- stockfinster Nacht unten -- arm gefangener umsehn -- sein Schreck Abscheu Umgebung Augenblick sterben -- 
  erschöpft Hypothese zureichend Grund unbegreiflich Veränderung -- wahr erraten -- 
  indessen Vorteil teleologisch Studie -- ziemlich geschwind verging -- 
  hört Stimme Pfauköniges -- 
  stehen Luftgitter Keller schimpfen vollständig Sortiment bedeutend Redensart hinunter -- 
  Könige Prinz -- sprechen zuletzt -- Kartenkönige Bettelprinz -- 
  Luft unten wert -- gut -- Strick gesponnen -- henken -- 
  Pfauenkönig -- -- 
  rufen König unten König -- hüten -- schnell Sache -- könnten bereuen -- 
  König -- Krone aufzusetzen verschenken -- 
  schwatzen Strick -- 
  fast lächerlich sprechen hören -- 
  König Theater spräch -- sagen -- höchst unnatürlich albern -- 
  gefangen König Taccamahacca rufen absprechend Tone herauf -- Pfauenkönig groß Angst Verlegenheit -- 
  übel Wille -- gefangener laufen lassen -- leid antun können -- 
  vertraute raten -- ernstlich Rache nehmen -- Welt moquiren Titular Vasallenkönig halten -- 
  wirken -- 
  König schworen streng Gerechtigkeit üben schnellstmöglich Justiz handhaben -- 
  Maler -- Pfauenreichswappe Feder auslassen -- Hochverrat Verhaft -- 
  verurteilen -- Popanzinn malen -- Gemälde stellen Gerichtspräsidente Gerichtetisch -- Gerichtsbeisitzer Kopie -- 
  Tortur jemals wirksam -- Gesichtsfolter -- 
  Ehe Richter setzen -- Sitzung aufheben -- urteilen einmütig -- gefangener hängen müssen -- gelog -- häßlich Zigeunerin schön Prinzessin ausgeben -- 
  Pfauenkönig -- Hofstaat gesamt Reichsständ versammelt Thronsaal -- 
  gefangener feierlich Prozession vorführen -- Urteil eröffnen -- 
  Gelegenheit erfuhr Verbrechen -- 
  protestieren helfen -- Pfauenkönig entrüsteter jemals -- 
  Totenglock läuten -- Schüler singen -- Stadtpfeifer bliesen -- Zug bewegen langsam vorwärts offen Operationspavillon Justiz -- Professor Kriminal-Chirurgie Ammanuense versammeln -- 
  Zustand schön Rosamund indessen glücklich -- 
  schwamm Nacht unbequemst Lage -- früh dämmert -- mitten weit Meer Schiff Hülfe Azur -- 
  erschraken -- Rosamunde weinen kläglich -- Fisch Mitleid fühlen -- 
  -- schluchzen -- gewiß Pfaukönig besonnen -- heiraten -- Wasser werfen lassen -- Manier -- 
  wunderlich Mensch -- -- leiben -- hübsch -- regieren verstehen -- 
  gewiß passen -- 
  Schwamm Meer -- durchnassen -- fast Tod erstarren -- 
  Azur Herz wärmen -- währ hundert Mal sterben -- 
  Abend machen Fisch bange -- Unglücksgefährt -- Azurche -- bell -- walfisch Meerungeheuer Nacht fressen -- 
  Azur bellt Nacht -- bellt alt Fischer Ufer -- glücklich Weise Wind Nacht Bett Land treiben -- 
  Prinzessin strecken flehend Hand entgegen -- bitten -- aufnehmen -- Wasser umkommen müssen -- 
  alt Natur mitleidig Gemüt -- Prinzessin schön -- Löwe Tiger Wasser laufen herausholen -- 
  Versuch gelingen Werk -- 
  Azur springen an Land bellt unendlich Gratia -- 
  Rosamunde wickelt Decke lispelt Befreier melodischen -- verjüngen -- 
  ziehen Phönixbett Wasser -- trocknen Sonne -- 
  Prinzessin führen Hütte -- 
  Feuer -- schließen Koffer -- Sonntagsstaat Frau heraus -- 
  Kleidet -- schön Dame -- -- Pudelnaß -- Bauerkleider warm trocken -- allemal -- Staatskleider frieren -- 
  entfernen lassen Prinzessin Toilette Bäuerin -- 
  fertig -- Anzug neumodisch -- Rosamunde schön -- schön Mädchen schlechtesen Anzug schön -- golden Morgensonne graue Wolke vergolden -- 
  alte merken goldbrokaten Decke atlassen Matratze -- vornehm Gast beherbergen -- 
  gering Verlegenheit -- 
  fangen -- -- merk Miene -- Vornehme -- 
  arm Fischersmann -- geben -- Blut Leben -- -- Eurem gering Diener geben -- eur Hundchen -- 
  Bissen gewöhnen -- finden schwarz Brot und Rettich Mittagsmahl -- Kaffee Trunk Wasser -- quellen -- 
  behagen -- 
  Rat folgen -- lassen Stadt Pfauenkönig -- erwarten Braut -- Hofdame Stelle geben -- 
  arm Rosamunde hören -- pfauenreich -- fing neu Bitterlich weinen -- 
  erzählt Fischer Unglück -- Liebe -- Pfaukönig Meer werfen lassen -- 
  alte stutzen -- kopfschüttelnd -- 
  hören -- schön Dame -- König Bord werfen -- einleuchn -- -- tun -- wissen -- wozu -- 
  helfen Mann -- Pfaukönig -- verzaubern -- nächt schnöde Pfau -- 
  -- wundern -- glauben -- -- 
  neidisch Fee antun -- -- schön -- 
  Pfau Hofstaat -- Mutter -- Feerie verstehen -- böse Fee überlisten -- Mensch Feder verlieren -- Zwickelbart -- 
  Königin alt häßlich Weib -- König entzaubern -- 
  entzaubern -- fragt Rosamunde neugierig -- schmeichelt alte -- o geschwind -- -- 
  Ei -- erwidern Fischer -- möchten Verdienst -- ln -- 
  lassen vergehen -- 
  gehören and Gesicht -- -- nämlich abscheulich häßlich -- 
  König eins Braut kriegen -- helfen -- 
  -- Schade -- Rosamunde -- Pfau bleiben -- Braut nehmen -- 
  gering -- fahren Fischer fort -- Angesicht Hofes Braut Ort holen -- nennen -- 
  O nennen -- Rosamunde -- -- -- bewahr Himmel -- fallen Fischer -- wissen -- Ort -- eur Erlaubnis -- steinern Kleiderschrank -- Kleid samt Mensch aufhängt -- 
  Braut Kette Bande -- 
  merken -- Gelichter müssen -- 
  freilich gottlos Fee verklausulieren -- arm König Nimmermehrstag loskommen -- 
  erfahren -- Zauber -- Zutun bloß ungefähr schicken -- 
  Rosamunde schauderen bitten Wirt -- sollen verraten -- 
  Sorge -- unser Tisch -- setzen hinzu -- helfen -- 
  Binden Hund Körbchen Hals -- vielseitig Erziehung nossen -- müssen Ding zugehn -- mitbrächen -- 
  -- tun -- 
  alte bringen Körbchen -- 
  Rosamunde behen Hundchen -- -- Azur -- gut Gericht -- Stadt Findest -- bringst -- machen hübsch -- hungern -- 
  Azur springen fort -- glauben -- königlich Küche gut -- laufen hinein -- sorgen zuförderst Appetit -- packen Rest Rosamund -- 
  Vorrat Hütte absetzen -- laufen königlich Küche -- packen Konfekt -- eingemacht -- Muskatensekt französisch Brötchen -- 
  räumen Küche Speisegewölbe -- Mäuse Palast Fasttag halten müssen -- 
  Pfaukönig erstaunt -- Tafel Mittag unbesetzt bleiben -- 
  fragen -- ungeduldig -- brechen Zorn -- 
  überdies Morgenunterredung gefangener ziemlich echauffiert -- folglich reizbar -- 
  zuletzt müssen zufrieden geben -- tröstet Appetit Aussicht Abendessen -- 
  -- Abendtafel Königs servieren -- -- niedlich Truchsess Prinzessin leern Küche neu -- 
  Prüfung hart königlich Geduld -- 
  indessen schaffen heftigste Zorn Essen herbei -- Gegenteil fastenden König hungriger -- 
  schlimm -- Dejeuner -- Diener Souper Königs -- 
  fehlen -- König Hungers sterben -- 
  hauptsach Betrachtung dachen Mensch kleinlich Einzelheit -- König Küche einstweilen versorgen -- 
  Favorit -- König Leben Tafel -- Glückseligkeit liegen -- 
  beweisen -- König Freund -- 
  versteckt Küche Herd -- verwenden Auge Bratspieß Kochtopf -- 
  währen -- Azur -- schnuppert Topf -- Tiegel Pfanne -- kosten gute -- packen gewöhnlich Körbchen voll -- 
  vertraute schlich himmelblau Hündch Stadt hinaus Feld Wald Korn Dorn Fischerhütte -- hündchen freundlich wedelen kläffend Einlaß begehrn -- 
  Atem vertraute König laufen -- erzählt Abenteuer Emigration königlich Mahlzeit Fischerhütt -- 
  König Stelle Befehl -- himmelblau Hund samt Komplice Verhaft nehmen Sache untersuchen -- 
  dienstfertig vertraute führen Gerichtediener Hütte Meer -- Fischer Prinzessin Azur königlich Küchenspende lassen -- 
  Hali -- heißen vertraute -- befehlen sogleich vorgefunden Personal -- Himmelblauen ausschließen -- Kette Bande legen -- Stadt Gefängnis bringen -- 
  bitt Widersetzlichkeiten vergeblich -- Hali hungrig streng Übermacht Seite -- 
  kommen Nähe Stadt -- König Zug herauskommen -- Platz Handhabung Gerechtigkeit einnehmen -- 
  Fischer fassen vertrauen Unschuld Herz -- werfen Könige Füßen -- fing ausführlich erzählen -- schwimmend Bett -- letzter Gericht königlich Küche -- hart Gericht verursachen -- bilden -- Anstalt -- -- sein bloß seinetwegen -- 
  Majestät hungrig Mahlzeit -- durstig Rache vermeint Betrüger -- Laune Audienz -- Glück stehen schön Rosamunde Fischer -- König lang Apologie Inhaftat betrachten möglichst verlieben -- 
  Zorn Schwermut auflösen -- Schönheit Fischermädchen -- Tochter mächtigst Grenznachbar -- 
  Fischer beweisen -- -- Mitgefangener -- ächt aufrichtig Rosamunde -- -- Rosamund nennen lassen -- können falsch Wechselbalg -- König -- matt Faste -- Luft Freudensprüng -- fallen schön Rosamunde Hals -- lösen königlich Hand Bande -- 
  tausend Artigkeiten überzeugt Galanterie Liebkosung -- Ding -- Meer werfen -- 
  unterdessen Gerichtszug geschritt Todeskandidate kommen Ort Bestimmung nah -- 
  gefangen König Prinz tröstet Bemerkung Vergänglichkeit menschlich Ding -- repetiert schön poetisch prosaisch Stelle -- ehemals Gegenstand auswendig lernen lassen -- 
  Popanzin Mutter -- Amme -- Schiffer -- 
  Rosamunde Brüder gewahr -- reißen König fallen Hals -- 
  Pfaukönig merken Mißgriff -- gering Verlegenheit -- stark Verstoß -- 
  Augenblick -- gefangen König nähern -- Entschuldigung vorbringen -- fallen -- Zauberschlag -- Kette Hand Fuß gefangener -- purpurrot Wolke senken herab -- schweben schön Fee -- jemals Rosenwolko schweben -- 
  Zauber lösen -- Sohn -- -- Pfaukönig wenden -- Verbannung -- Verwandlung -- 
  Nimm schön Braut leben glücklich Schutz -- 
  Wort schwingen Fee Zauberstab verschwinden -- 
  Gegend umgestalten -- 
  streng Stil umliegend Werk Kriminal-Architektur verschwand gefälliger Platz -- Ehrenpfort -- Freudenboge Blumengewinden -- Altären Obeliske Auge entzücken -- 
  Reichspfaue dehnt Flügel Schweif verwandeln schöngekleidet Pag -- König niedlich Federbärtchen allerliebst Stutzbärtchen verwandeln -- Rosamunden Auge liebenswürdig Hübscher -- 
  Versöhnung Rosamunden Brüdern schließen -- 
  sehen -- Verlauf Ding hoch Hand ordnen -- Rollen Zauberschicksalsdrama -- glänzend -- notwendig -- Entwicklung herbei führen -- 
  schließen allgemein Amnestie -- 
  Popanzin Konsorte fürchten -- Spiel Freiheit -- Notwendigkeit entdecken -- entfernt Freude -- 
  Hochzeit allgemein Freudenfest Land -- 
  alt Fischer ziehen Königin Palast -- 
  Azur erwerben gesamt Hundhit gewiß Jahrszeite Medaille tragen -- Andenken Begebenheit tragen elegant pfauenreich Stutzbärtchen -- Landessprach Stutzer nennen -- -- * * * 