Neujahrsnacht -- 
  schlagen -- 
  lassen scheidend Glas bringen -- rufen Wirt -- Andenken froh Stunde -- bringen -- 
  Glas klirrten munt -- Auge glänzt Widerschein genossen Freude -- 
  wunderlich -- heit ernst Sache Augenblick Jahreswechsel -- Hermann -- Grund Augenblick Anfang Endpunkt Jahr -- -- Jahrhundert Jahrtausend -- bloß Konvenienz Mitternachtsstunde letzter Dezember Januar feierlich -- 
  -- entgegnen Falk -- Übereinstimmung Nation -- überdies religiös Beziehung gründen -- Feierlich -- -- 
  Jubelepochen Leben Mensch -- Einzeln -- nah angehen -- helfen Lust Fröhlichkeit feiern -- 
  geben -- Feier Familienfest -- Freude Ernst übergehn -- süßlich Sentimentalität ausarten -- 
  -- schön Name Fest klingen -- froh glücklich Ereignis -- Erinnerung feiern -- 
  Glück -- häuslich Leben erheiteren -- wert fühlend Mensch -- hoch Ernst Feierlichkeit -- 
  -- freuen -- gemeinschaftlich Lust zusammensitzen -- -- alt Jahrgreis Sterbestunde anlächeln -- Böses vorwerfen -- -- Stunde feierlich -- Fröhlichkeit -- Höher -- 
  Übereinstimmung vieler Mensch gestalten -- 
  Kirche Allerheiligen Allerseelenfest -- Jahrsmitternacht Allerfreuden- Leidenfeier Menschheit -- -- egoistisch -- Familienfest -- feiern Nachbar Feier andächtig -- 
  alt gestalten ernstlächelnd -- hinscheidend Mutter -- frohlächelnd Kind -- Sarg Wieg wandeln Ahnung -- Mund Mensch bedeutungvoll Wunsch -- 
  lassen wünsche ruhn Mitternacht -- fallen Wirt Sprecher -- möchten annehmen -- Neujahrswünsch ausgesprochen Ahnung -- 
  gewiß Herz wünschen -- Mühe wert glauben -- Wunsch Ahnung Erfüllung bewähren -- 
  werfen Erfahrung Theorie -- -- 
  Leute vorsichtig Erfahrung sprächen -- entgegnen Falk -- bekümmerten -- eigentlich erfahren -- 
  betrinkt schläft -- Erfahrung -- Wein Abends bekommen -- 
  belehren wahrscheinlich Mann -- Wirtin -- Frau möchten Magie Neujahrswünsch glauben -- 
  Belehr -- hübsch faßlich Frau Mädchen -- bleiben Wunsch unerfüllen -- 
  wahrscheinlich -- entgegnen Herrmann neckend -- Falk Ahndung Wunschtheorie Präludium wünschen -- intonieren -- 
  Thema gemein -- Freund Falk Wahrscheinlichkeit neu Interesse geben -- Erzähler Anekdote Zusatz -- wahr Geschichte -- 
  Falk hören Neckerei -- wendeen Wirtin -- 
  -- sprechen -- Erwidern -- Mehrzahl Neujahrswünsche unnütz leer Zeremoniell -- Erfüllung erwarten -- 
  hinzusetzen -- magisch Kraft Wünschus beilegen -- eigentlich Neujahrsstunde sprechen -- Zahl unerfüllt Wunsch beträchtlich verringern -- tun -- tren Hermann Seite geben -- präludieren -- 
  Vorbereitungswunsch -- Wunsch ausgesprochen Ahnungen -- Erlaubnis unser Wirt vorbereitungsstunder vorläufig aussprechen -- 
  Ernst -- versetzt Wirtin -- möchten Wort -- 
  Publikum genügen Mitteilung Ansicht -- empfinden Art Scheu Meinung -- 
  wählen -- Verdacht aussetzen -- 
  Zweifel letzn -- erwidern Falk -- Wahrheit ziemlich nah kommen -- 
  Stunde Eintritt Neuenjahres scheinen unschicklich Meinung hervorzutreten -- Wunsch zweideutig Licht zeigen -- 
  Behauptung Einfall Augenblick -- Lauf Sprung Gespräches erzeugen -- 
  eher vermuten -- fallen Wirtin -- Ahnungen Ursprung danken -- -- sagen -- Wiege Sarg wandeln -- bloß wünschen -- Meinung -- Urteil mehrere Form aussprechen -- 
  sehen -- jung Brautpaar aufhorchen -- leben Blütezeit Glückwünsch -- 
  bitt Professor -- schön Braut -- Magie Wunsch enthüllen -- 
  Braut abschlagen -- 
  Elisa stimmt Wirtin -- Falk mehrere Seite auffordern -- 
  -- Verschulde -- Erwartung gespannt - Falk -- unbefriedigen bleiben -- 
  fallen Gespräch alt Glaube Bedeutsamkeit -- unwillkürlich gewiß Zeit ausgesprochen Wort beobachtet Zeichen -- 
  Altertum hing bekanntlich fest Glaube -- Spur erhalten -- 
  -- Glückauf -- Bergleute deuten -- Gewohnheit -- Dorf -- vorzüglich gebirgig gegenden finden -- 
  Mensch hüt groß Vorsicht Wort böse Bedeutung -- -- vorzüglich doppelsinnigen -- Meinung aussprechen -- feindlich Schicksalsdämon entgegengesetzt Sinn aufgefassen -- verderblich Erfüllung bringen können -- 
  denken -- Wunsch -- 
  erfüllen -- -- Macbeth Weissagung -- Buchstabe -- töten -- 
  Wünschende längst vergessen -- glauben mithin -- Wunsch vereiteln -- 
  Ernst -- fragen mehrere Stimme sehen Professor zweifelhaft lächeln -- 
  seltsam Erscheinung Art -- Anselm -- Professor sogleich Ernst Scherz entscheiden -- schweigend Antwort entgegen sehen -- 
  -- rufen Hermann lachend -- lassen wortkarg Repertorium Wundergeschicht vernehmen -- 
  glauben -- Wundersag Volksglaube -- Stande wärst Beispiel Erläuterung nachweisen -- 
  geschwind Beleg magisch Kraft Wort -- 
  interessant Histörchen Art erfinden -- erwidern Anselm -- schwer Aufgabe -- 
  -- -- experimentierend Famulus Professor Vorlesung -- 
  müßen bloß sehen -- Beleg beweisen -- Prachtstück brillant ausnehmen -- 
  geben -- erleben ansehen -- 
  mehrere Karlsbad Bekanntschaft geheimräter Amalie Kulm -- 
  Monat Witwe besuchen Bad fünfjährig Tochter -- bejahrn Oheim Gesellschaft leisten -- stehen schön Blüte Gesundheit Jugend -- 
  Oheim bekommen indessen Bad Wunsch -- 
  Brunnenarzt betreiben Abreise -- Badezeit ablaufen -- Wunsch geheimräter -- abzureisen -- unbedeutend Umweg Oheim -- 
  fürchten -- gestehen -- unterwegs tödlich Zufall Oheim -- Hauswirtin -- Art Leichenseherin gelten -- einigemal bedenklich äußern -- Herrschaft unterwegs Leiche bekommen -- 
  Schwachheit alte gestatten -- Reise ununterbrochen fortsetzen -- 
  beschließen Dorfe Rasttag halten -- freundlich Ansehn bequem Unterkommen versprechen scheinen -- 
  Ursache zufrieden -- 
  Wirtin lauter Sorgfalt alt Herr -- gut Abwartung Unterhaltung munter lebhaft Gespräch finden -- bitten folgend Nicht -- Spaziergang Begleitung -- einstweilen Sorge jung Frau überlassen -- 
  gehen anmutig Weg Garten Dorf -- 
  ruhig Nacht Oheim Geheimrät aufgeheiteren erzählt -- Laune -- gewohnen -- Szene Leben bekannte -- 
  hören voll Glockengeläut Dorfe -- 
  gewiß Leiche -- Geheimrät -- 
  -- Land begraben sehen -- 
  Kindheit Preis Leichenbegängnis versäumen -- 
  Minna weinen bitten -- Mutter Gottesacker tote -- schaltn Tochter Furchtsamkeit -- treten Kirchhof -- 
  Sarg -- Dorf gewöhnlich -- Grab setzen öffnen -- 
  schön jugendlich Leiche sichtbar -- 
  treten alt Landmann Mädchen -- Trauer kleiden -- hinzu -- legen tote Frucht Kinn -- Mädchen Totenblum gefalteten Hand -- 
  Schlaf sanft -- alt -- 
  hoffen -- Solltest letzter Dienst erweisen -- -- -- 
  treten Pastor hinzu -- bejahrt -- kräftig Mann -- halten Leichenrede voll Trost -- 
  Geheimrät wenden Auge -- enden -- 
  entzücken Rede -- äußern Wohlgefalle einigemal abgebrochen Wort -- 
  Schluß erscheinen Oheim -- Wirtin nah Kirchhof führen lassen -- 
  O -- herrlich Rede gehören -- rufen Geheimräte -- geistliche herzutreten -- geendigt kirchlich Akt fremd Zuhörer Achtung bezeigen -- rufen entgegen -- 
  Herr Pastor -- wünschen Leichenredner -- nehmen herzlichen -- 
  Minna -- Tochter -- fassen Wort ängstlich Hand -- Mutter -- halb weinend -- Mutter -- sprich -- -- 
  Wunsch liegen näher -- lieb Nicht -- Oheim -- rufen Minna ängstlicher -- Großonkel -- Auslegung -- 
  geistliche betreffen -- Geheimrät lächelnd Wort -- 
  Ort -- -- gestatten Erläuterung übereilt Rede -- schenken Mittag Gesellschaft Gasthofe -- 
  geistliche -- klären -- Geheimrät vakanen einträglich Predigerstelle zugedenken -- 
  Pastor erbat Bedenkzeit -- -- ungeachtet gering Einkommen -- Gemeine leiben -- einig -- Sache Brief abzutun -- 
  Brief wechseln -- 
  Pferd einspannen -- Geheimrät heftig Kopfweh klagen -- Aufschub wünschen -- 
  Schmerz bedeutend -- kurz zeigen gefährlich Krankheit -- Kunst Arzt -- Gegend -- wachsen -- 
  Ausgang tödlich -- Leichenbegängnis halten Pastor Trauerrede Sarge geheimräter -- 
  Erschütternd wirken -- alt Oheim Minna geöffnet Sarge -- treu Wiederholung Begräbnisses sehen -- gleichsam Vorbild -- 
  Oheim leben Vorfall -- seltsam Erfüllung Wunsche Nicht erinnern -- 
  seltsam -- Hermann -- Tod Zufall erfolgen -- 
  Krankheit lassen natürlich Erklärung -- 
  erschrak Geheimrät schnell Wort -- breit Bemerkung Oheim -- 
  erregen Schreck wahrscheinlich Krankheit hernach Tod -- 
  Nehmt übel -- fallen Professor -- allemal lachen -- natürlich Erklärung Rede -- 
  Natur unnatürlich zugehn -- 
  geschehen allemal -- geschehen -- 
  Treibt Spitze -- erwidern Hermann -- unnatürlich nennen -- begreifen -- wofür Erklärungsgrund auffinden lassen -- 
  Professor Philosophie -- Falk lachend -- fragen -- eurer Ansicht bleiben -- 
  Doktor kurieren kranke unnatürlich -- 
  Frage -- Gewissen -- begreifen -- wie_es zugeht -- Medizin gesund -- 
  wenigster begreifen -- unnatürlichsn zugegangen müssen -- -- Natur gute tun -- 
  bitte -- Herr -- rufen Wirtin -- lassen eur Wortstreite ruhn -- 
  unnatürlich -- einsehen -- Frage -- 
  Anselm's Erzählung scheinen passen -- zweifelhaft lassen -- Krankheit Wort -- vielmehr Aufmerke Wort -- entstehen -- 
  eigentlich keins -- erwidern Anselm -- -- dünken -- Unbemerkt lassen -- Amalie Wort exaltiert Stimmung -- 
  ungemessen Beifall -- -- brav -- ungemein vortrefflich Rede schenken -- zeugen ungewöhnlich Spannung -- 
  Wort Erzeugnis Krankheit -- erhalten Schein proffetischen sonderbar Zusammentreffe Umstand -- 
  gestehen -- versetzt Wirtin -- Wunderbar Unnatürliches Stadt finden -- 
  Unnatürliches gewiß -- antworten Anselm -- Falk Meinung -- überall Natur -- geschehen -- wahrnehmen -- unnatürliches geben -- 
  wunderbar bleiben Sache -- 
  scheinen Wortstreit hinauszulaufen -- Wirtin -- erfahren Sache Bestimmtere -- 
  vorhin ersuchen -- setzen Elis hinzu -- sagen -- sogenannter Unnatürlich Bewandtnis -- 
  Erscheinung geben -- unnatürlich nennen müssen -- gleichsam Natur verkehren unwillig -- Machtsprüch fremd Gewalt -- Werk setzen -- 
  üben -- Meinung deutlich aussprechen -- versteh verworren Wort Sinn finden -- 
  sprechen klar -- Falk -- Ding -- -- -- Natur zwingen sprechen -- 
  Nenne indessen Erscheinung -- sprechen Sicherheit -- 
  kommen Gespenstergeschicht -- versetzt Elis lächelnd -- 
  tun -- -- Hermann -- hören -- 
  sehen -- Anselm aufhorchen zurechtsetzen -- 
  drang Elis -- Wunderbegebenheit erzählen -- Sinn -- 
  entschuldigt behaupten -- Geschichte erzählen hören -- fühlen gewiß Scheu Selbsterzähle -- 
  Verlobter lächelen -- -- können vermuten -- Vorfall Braut -- 
  bloß Selbsterzähle scheu -- erbötig Erzählung übernehmen -- 
  elise gestatten -- bitten -- Name verändern -- 
  verstehen -- erwidern Baron -- beginnen -- 
  nah verwandte elise Schwärmerin -- nennen indessen Karolin -- Gutsnachbarin Angelika innigst Freundschaftsbund schließen -- 
  Mädchen unzertrennlich -- Eltern freuen -- gewöhnlich wohnen sogar Freundinn abwechselnd -- vorzüglich Winter Fall -- Nacht übel Weg täglich Besuch beschwerlich machen -- 
  Angelika's Vater früh Zeit bekannt Cagliostro Verbindung -- -- Aufschlüsse Wundertäter ungeachtet -- Anhänglichkeit Mystik Wunderglaube beibehalten -- 
  Büchersammlung enthalten -- Werk Literatur -- Anzahl Wundergeschicht -- Legende alt Chronik -- Angelika Kindheit lesen -- 
  sitzen Mädchen spät Nacht -- erhitzen Fantasie Geister Erscheinungsgeschicht -- 
  Exaltation geben heilig Versprechen -- Welt gehend sollen überlebend erscheinen -- 
  Beispiel gegeben Wort lesen -- fest bind -- gelobt -- Erlassung Versprechen Verbindlichkeit lösen -- 
  feierlich Hand zusammenschließen halten -- schlagen glock Mitternacht -- 
  Sterbestunde schlagen -- rufen Angelika begeistert -- Stunde Gelübde erfüllen -- 
  Karolin fahren -- Rede erschrocken -- heftig Schrei -- 
  erschricksen -- Angelika sammelnd -- ruhig -- versprechen -- Geburtsstunde -- sagen -- schlagen -- 
  sechzehn Mitternacht gebären -- 
  Doppelt heilig gegeben Wort -- wahrscheinlich bestimmt lösen -- 
  Mädchen verlieren Schwärmereie abgebrannt Licht Bett verweisen -- 
  voreilig Gelübde -- Karolin krank -- 
  Angelika Bett -- erklären Arzt Krankheit bösartig -- ansteckend Fieber -- Angelika -- Krankheit überstehen -- Eltern nötigen -- Karolinen Haus meiden -- 
  Gefahr Leben befürchten -- gehorchen Angelika -- 
  Nachricht bedenklich klingen -- halten -- krank Freundin eilen -- 
  Versprechen üben furchtbar Gewalt -- Nächte eilt Angelika Karolin -- entschlossen Tod Krankheit holen -- Angst lang dulden -- 
  beschwören krank Zurücknahme Gelübde -- -- ohnehin binden glauben -- Angelika feierlich -- -- Angst Freundin gewahr -- 
  Szene -- anwesend groß Gefahr kranke befürchten -- indessen günstig Folge -- 
  Anstrengung wohltätig wirken -- Karolin gena schnell -- Verwunderung Arzt -- 
  Angelika Retterin -- gleichwohl beteuert Mädchen öfters -- Wunsch Frage unbekannt Welt wagen -- Hang Mysteriösen -- Glaube -- scheinen Gemüt verdrängen -- 
  Krankheit Gelübde -- vergessen -- Herz Freundinne finden Seite anziehen -- 
  Angelika Tage Eltern Ball benachbart Stadt fahren -- 
  karolin häuslich Abhaltung Freundin begleiten -- vornehmlich Lustbarkeit ausschlagen -- Angelika Festlichkeit überraschen -- morgend Geburtstage veranstalten -- 
  sitzen spät Nacht Mädchen Arbeit -- Hand legen -- Mitternacht schlagen -- 
  wehen sonderbar Zugluft -- Tisch zerstreut Nähterei bewegen umherkräuseln -- Aufblicken sehen Karolin Schattenbild Angelika's drehen zusammensinkend verschwinden -- 
  Geschrei laufen Mädchen herzu -- Karoline Schreck ohnmächtig Arm fallen -- 
  Mädchen bemerken -- Bewegung Luft Umherflattern Nähterei -- 
  Angelika Nacht Glockenschlag zwölf Tanze tot hingesunken -- 
  gräßlich -- Wirtin -- 
  Grauenhafteste -- setzen Falk hinzu -- ebenfalls dunkle -- Ahndungsvolle Wort -- sterbestund -- 
  Angelika sprechen unwillkürlich wissen Todesprofezeihung -- 
  erklären -- -- fragt Elis -- 
  Bringen Ruf Alleserklärer -- erwidern Falk -- Erklär sonderbaren Vorfall -- 
  geschehen -- gewiß Ordnung Gesetz Natur gemäß geschehen -- Gesetz kennen -- 
  wissen anmaßender Schluß -- 
  begreifen -- folglich -- 
  gleichwohl egoistisch Satz Basis Kritik ähnlich Vorfall -- 
  Jurist Höpfner Jahrzehenden Erfindung Luftschiff Unmöglichkeit müssen spät Ausgabe Buch widerrufen -- 
  urteilt Steinrege ähnlich Ding -- Ureltern Wunder nennen glauben -- Eltern Märche schalten verlachn -- weder Wunder Märche -- anerkannt -- wahr Naturerscheinung -- 
  Volksglaub sogenannter Aberglaub voll Fundgrube Naturforscher -- 
  freilich liegen Wahrheit gediegen -- Verständiger -- Grube bloß taub Gestein -- Erz Kunst gewinnen -- 
  trefflich Ritter entdecken -- finden günstiger Geschick -- 
  erinn Versuch Schlüssel -- Wirt -- Anselm nachgemacht -- auffallend Richtigkeit befinden -- 
  bemerken -- unterbrechen Baron -- Wille gelingen Einfluß -- 
  Einwendung Resultate -- 
  Geist Kritik gemäß -- -- fallen Anselm -- ärg Wort Verfall Literatur lesen -- 
  Verfallen -- Schuld -- Kritik -- böse Blatter Körper Literatur -- 
  Persiflage Wesen -- sobald parteilos erscheinen -- 
  Kritiker gewöhnlich wissen -- vortrefflich -- -- Fall Ratsamste persiflieren -- 
  Meßkatalog dick -- Dicke schlecht Witz -- dünn -- Dünne -- 
  versündigen Ritter -- Märche angeblich Bekehrung Todbette ausnehmen -- 
  sicher Wille Einfluß gelingen Mißling Versuch -- Versuch psychisch Phänomen -- Richtung Wille -- physisch Phänomen nachweisen -- 
  unterscheid Wille -- absichtlich Körper mitteilen -- Bewegung Voraus erwartet Erfolg gemäß leiten -- Wille -- absichtlich -- innerer Naturgesetz Körper wirken -- 
  ähnlich erbleichen Schreck -- Zittern Furcht -- Erglüh heftig Affekt -- 
  Mensch -- willkürlich Erröt abzwingen -- jeder Erröt Akt Willkür -- 
  experimentieren -- freilich Kind -- Spiel gewinnen lassen -- 
  unwillkürlich unabsichtlich -- unbewußt Einwirkung Wille Körper sogar fremd Wesen -- Hauptpunkt -- Versuch nachweisen anschaulich -- Aufschluß -- Magie nennen -- 
  Unfähigkeit Mensch Wirkung äußern aufnehmen -- Sache besonderer Schein übernatürlichen -- 
  -- wenden Hermann -- Sache Natur gründen währ -- müssen Mensch Fähigkeit angeboren -- 
  bitte Bruder -- Falk Wort -- Rede verkehren -- 
  Behauptetest vorhin -- singen -- intonieren beinahe Viertelton Stimmung Konzert -- 
  streiten -- bewiesesen deinen Satz Stimmgabel -- 
  hexerei bewirken -- gleich Übung fein hören -- Gehör Märchen -- Leute fein -- 
  Madonna malen -- Rafaelsche Kind -- Raffael Hexenmeister -- -- 
  Leute -- 
  Ding -- gewiß Respekt schicklich annehmen -- statuiern Bedenken besonderer Fähigkeit nennen Talent Genie -- 
  Ding hingegen -- Weltleuten Mode -- achten gering -- meinet -- müssen Natur Geschick -- 
  Seite gestehen Tier unbedenklich Kraft -- magisch -- z. B. Vorgefühl Regen -- Kälte -- Überschwemmung -- Mensch erklären ähnlich unmöglich -- 
  Instinkt -- -- Hermann lachen -- 
  -- fahren Falk fort -- Wort -- lachen mußt -- 
  Bewirkt Instinkt magisch Kraft -- -- Magie -- 
  angenomme -- Instinkt Mensch abgehen -- ausgebildeter Tiergattung schwäch -- Verlust Folge hoch Ausbildung -- -- -- groß Selbstständigkeit -- 
  selbstständig Wesen -- Natur affizieren -- 
  gelten Physische -- Moralisch -- 
  Egoist fühlen Mitleid kennen Sympathie -- 
  wirken ahndend Kraft Mensch -- begabt Individuum -- hauptsächlich Moment -- physisch moralisch Egoismus schweigen -- Mensch gleichsam allgemein verlieren -- 
  Greis -- Sterbende -- Kind -- Frau schreiben Volksglaube Ahndungsvermögen -- rüstig Mann -- 
  Abend still Nächte glauben ahndend Kraft tätigst -- Augenblick Exaltation -- Egoismus verstummen -- 
  rechtfertigen Ansicht Natur Volksglaube nebenbei Meinung Magie Wunsch bedeutend Stunde -- 
  -- Braut lächelnd -- Magie nahend Stunde kräftig -- 
  wünschen Louis gewiß -- 
  O Geduld -- rufen Hermann -- Falk bringen gewiß solenn Neujahrwunsch -- 
  Nachmittag dichten komponiert -- 
  sündlich -- fallen Wirtin -- Gesang schließen -- 
  geben heraus Falk -- gewiß -- 
  -- entgegnet -- Gespräch ausgehen -- 
  Gib heraus -- wiederholt Wirt -- wissen mitbringen -- 
  gehören -- antworten -- 
  Aha -- gewiß Glückwunsch -- Hermann -- rufen Elise Glas -- 
  magisch Kraft ausgesprochen Ahnung -- 
  Stoße -- 
  stimmen stieß Braut -- 
  rein Glas klingen -- Pokal -- Wirt alt -- weitduftend Wein spenden -- summen Feiergeläut Klang -- 
  Horch -- 
  Glockenklang -- 
  -- Hermann leise -- 
  still -- -- rufen Wirt öffnet Fenster -- 
  Stadtturm tönt Schlag letzter Viertel -- 
  Tief stark schließen Klang mitternächtig Stundenglocke -- 
  Gesellschaft sitzen lautlos horchter still Ernst -- letzter Ton scheidend Jahr verhallten -- 
  voll -- tief Schauerlicher wiederholt Glocke hoch Kirchturme Abschiedsklang -- 
  elise neigt sanft verlobten -- 
  Blick sprechen Himmel voll Ahnung -- Hoffnung Wunsch -- 
  sehen froh Rührung schön Braut Verklärung reinsten Liebe -- 
  Wirtin beugen küßte weiß umlockt Stirn -- sprechen Wort -- Feier laut unterbrechen -- 
  kräftig tönt Glockenkoloß Kirchturme mitternächtig Stundenruf -- 
  Falk entfalten geräuschlos Papier beginnen gedämpft Stimme -- Horch -- totenglocken -- 
  elise schauderen sichtbar -- 
  durchdringend Schrei durchschnitt wunderbar Zimmer -- 
  elise blicken -- Augenblick sinken Ausruf entsetzen -- 
  Baron Wirtin halten Ohnmächtige blaß -- tote arme -- 
  -- -- 
  schallt Seite -- 
  schreienden Laut gehören -- Elisen Stimme halten -- Zusammenschauder vorher bemerken -- behaupten -- Ferne kommen -- Elise Ausruf Schrecken hören lassen -- 
  besprach -- Elise Beistand Arzt Gesellschaft erholen -- 
  behaupten -- Schrei -- gehören -- erschrecken -- Schreck wahrscheinlich Ursache -- Aufblicken Phantom sehen meinen -- 
  nämlich vorkommen -- blick Marienbild blassen -- entstellt Totengesicht -- Anblick eigentlich Ohnmacht bewirken -- 
  Phantom -- Wirt -- beruhigen -- 
  Maria hängen Tageslicht gewiß vorteilhaftest Stelle -- Abendbeleuchtung Zimmer bekommen -- Standpunkt -- widerlich Ansehn -- Vorhang bedecken -- 
  überzeugen -- 
  führen erschöpft Braut vorig Sitz erscheinen Bild verändern -- 
  Mutter fast farblos -- Kontrast Kind -- vorteilhafter Beleuchtung kräftig hervortreten -- beinahe schattenähnlich -- 
  Totengesicht erkennen elis Zugabe aufgeregt Fantasie -- 
  Schrei untersuchen -- Wirtin rufen Domestiken -- 
  Bedeutung -- berichten Kindermädche -- befragen -- 
  Nachtlicht löschen -- anzünd -- wacht Emil schreien -- Finster fürchten -- 
  schläft ruhig -- 
  Gottlob -- -- 
  Falk heimlich Anselm -- bange -- Anfing lesen -- fallen Beziehung Anfang unser Gespräch zentnerschwer Herz -- 
  scheinen entgegen -- 
  netten Neujahrwünsch -- Veranstaltung Wirt herumgegeben -- erheitert Gesellschaft vollkommen -- 
  bekommen anmutig neckend Anspielung Verhältnis Lieblingsneigung -- 
  Baron bekommen alt Ritterburg -- Tempel Hymens verwandeln -- Anselm Weinglas -- niedlich Heb -- Falk Tanz berauscht Zecher Weinfaß -- Licht besehn Helikon Musenchor -- 
  Braut Rosenknospe -- Amor -- verschieden Spielwerk Kind umgeben -- Platz -- 
  singen scherzt Zelt -- Falk lesen Störung unterbrochen Neujahrsgedicht -- -- laden Baron Gesellschaft nächster Jahrswechsel -- 
  versprach leert Gläser froh wiedersehen -- 
  halten Wort -- rufen Elise Scheiden -- nächster Neujahrsnacht fehlen -- 
  Versprechen dulden Entschuldigung -- unausbleiblich halten -- 
  Neujahrsnacht -- 
  Weihnachtsfest mancherlei froh Zerstreuung vorübergegangen -- Geschenk -- anwesend gegenseitig erfreuen -- vergessen Scherz abwesend Baron vorbereiten -- Neujahrsabend Schloß überraschen -- jung Gemahlin glücklichsten verleben -- 
  Wiederholte Einladung Zusage mehrmals wechseln -- freuen gegenseitig gesellig Genuß Wintertage Land -- 
  letzter Dezember begünstigt Vorhaben Freund Frost heiteren Himmel -- 
  übereingekommen -- letzter Jahr Baron Schlos einzutreffen -- Feier Jahresschlusse Reihe fröhlich Anzufang -- verleben hoffen -- 
  Schloß Hartenstein liegen unbedeutend Fels -- schön -- romantisch Umgebung -- 
  Bauart zeigen -- Nachricht verbürgn -- Ursprung alt Zeit Faustrecht fallen -- 
  Öftern Befehdung Gebäude -- sofern tief Keller Gänge verarbeiten Fels rechnen -- mehrmals teilweise zerstören -- unterscheiden deutlich -- sowohl Form -- Anordnung Raume Verteidigung Bewohnung Anforderung verschieden Jahrhundert -- 
  neu Zeit Besitzer möglichst Schonung alt äußern innere bequem einrichten suchen -- sonderbar Kontrast sichtbar vormalig Bestimmung Platze jetzig Gebrauch entstehen -- fremde auffallend zuweilen unerfreulich -- 
  leugnen -- Ersparni Raum Kosten Grund bequem aufführen -- söhnt zerstückelt -- schwer übersehend Einrichtung -- angenehm Überraschung Einzeln -- bloß Besucher täglich unbekannt gleichsam neu entdeckend Partien weitläuftig Schloß Darbot -- 
  Besitzer gegenden fremd bleiben Generation besuchen -- 
  fest Schneebahn Fahrt beschleunigen -- Gesellschaft Laune hellem Schloß -- 
  fast Fremdlinge -- Ungewohnt Umgebung ziehen Auge abwechselnd Gegenstand -- Baron weitläuftig Gang Säle warm freundlich Zimmer führen -- 
  Frau Haus -- -- fragt Falk wiederholt Begrüßunge -- gewiß zeitig -- Bahn bringen schnell Ziel -- erwarten -- 
  Strohwitwer -- antworten Baron -- Dame Nachsicht bitten -- Bewirtung Sorge Hausfrau vermissen -- 
  indessen -- hoffen -- gewiß Frau Versäumt nachholen suchen -- 
  besuchen Weihnachtsfest Schwiegermutter -- gut alt Freude verderben -- mußt einwillig Tochter paar lang lassen -- 
  -- rufen mehrere Gast -- 
  freilich -- versetzen Baron -- indessen wissen -- schwer halten -- loszumachen -- 
  Mutter Tochter fortlassen -- ohnedies entfernt Entbindung besorgt -- 
  Arzt lachen Bangigkeit entferntest Gefahr wissen -- indessen fühlen gewiß -- Grund billig Wunsch besorgt Mutter ausrichten -- 
  Zweifel -- 
  Mann Baron Abend Jagdpartie veranstalten -- 
  bloß Falk bleiben Frau Teetisch -- Cäcilie -- nah verwandte Elisen Abwesenheit Hausfrau Stelle Wirtin vertreten -- 
  hoffen zuversichtlichst Rückkehr Baronin -- Geräusch -- Schloßhof hören lassen -- springen Fenster -- 
  Ungeduld -- Gesellschaft einigemal necken -- 
  necken -- -- Elis vorig Genugtuung schuldig -- wenigster gleichgültig -- ausbleiben -- 
  fragen -- Genugtuung Falk -- erinnern Anfang Neujahrsgedicht -- damalig Verhältnis elise schreckhaft wirken -- wiewohl schonend -- Grund Schrecken verschweigen -- 
  Cäcilie lassen Nähere erzählen -- 
  Ursache -- -- vernehmen -- arm Elis Bangigkeit vergün -- Abend verursachen -- 
  scheinen -- wissen -- Anfang Gedicht Erschütternd Elis wirken müssen -- 
  sehen Cäcilie voll gespannt Erwartung -- bat nähern Aufschluß -- 
  -- erzählen -- versetzt Cäcilie -- schwerlich Geschichte Erscheinung Angelika's -- elise scheut erzählen -- 
  Vorfall erzählen -- Überzeugung denken -- sein aufmerksam Gedicht Elisen Gegenwart lesen -- 
  höchst unruhig -- Falk -- gewiß äußerst begierig -- Elis verschweigen -- 
  Sache Geheimnis -- erwidern Cäcilie -- vermut -- Baron unterrichten -- 
  bitte -- -- anvertrau -- vorsichtig umgehen -- 
  Familie Freundin alt Sage -- indessen -- mehrere dergleich Sage -- mündlich Überlieferung ziemlich verändern entstellen -- 
  Folge sterben jeder Glied Familie Glockenschall -- letzen sogar Sterbeglock läuten -- 
  Grund sonderbaren Auszeichnung niemals erfahren -- indessen gewiß -- Kirchenbüchern Familie anmerken -- Geläutes sterben -- 
  erzählen sogar alt Nachricht -- Todesangst liegen -- befohlen -- Sterbeglöcklein ziehen -- Schall entschlafen -- 
  Wahrheit Fabel Nachricht enthalten -- entscheiden -- erzählen bloß sonderbar Zutreffen Sage Tod Elisen Vater -- 
  Major -- wissen -- letzter Familie -- Umstand wecken Andenken erwähnt Sage -- letzter Zeit fast vergessen -- 
  abergläubisch -- scheinen Major Scheu Berührung Glocke -- gestehen -- hören ungern Sage sprechen -- 
  indessen lassen -- wiewohl Vorwand -- mäßig Glock -- Hofgesinde Zeichen Mittagstisch geben -- abnehmen -- Handklingel -- Zimmer bedienen -- klein -- unmöglich Glocke denken -- 
  letzter Krankheit befiel -- geben Arzt Hoffnung -- retten -- Bauer Dorfe hingegen geben Glaube -- behaupten -- Herr Glöckner -- Leben Not -- 
  Zufall -- Glocke kranke Nähe entfernen scheinen -- vermehrt Hoffnung -- 
  Festläute nämlich Glock Kirchturms beschädigen -- Geläut verschönern -- beschließen -- alt Glocke ebenfalls besseres Verhältnis umgießen lassen -- 
  abnehmen zerschlagen -- Major Gesundheit täglich gut scheinen -- 
  machen ängstlich Vorstellung -- festsetzt Selbstvergessenheit beunruhigt -- Ärzt bange -- 
  setzen Gedanke Furcht -- Feuer entstehen -- Mangel Sturmglock Hülfe fehlen -- 
  Furcht grundlos -- finden ratsam -- einstweilen alt Mittagsglock aufzuhängen -- 
  Major scheinen beruhigen -- folgend Nacht bekommen heftig Anfall Krankheit -- Wächter übermannen -- 
  rufen Feuer -- 
  Feuer -- Schloß -- Schicksal führen vorher aufgehängt Glock -- 
  fassen Seil stürmt Aufhör Schlaf herbei -- lassen abhalten -- leblos Boden sinken -- 
  geben -- fahren Cäcilie Erzählung fort -- eliser vielmehr Vorfall denken -- Angelika's Erscheinung -- begreifen -- Erwähnung Totenglocko erschüttern müssen -- 
  vollkommen -- Falk -- wünschen doppelt -- Gefühl folgen -- Gedicht unser Gespräch lesen -- 
  Mühe -- böse Erinnerung ausgleichen -- 
  -- stehen -- versetzt Cäcilie -- Zufall Absicht vereiteln -- 
  O -- dasmal nehmen -- erwidern Falk -- 
  lernen Ding -- Cäcilie -- gewiß erwartet Wirkung -- 
  Erfahrung Vorsichtiger -- antworten -- 
  -- -- Cäcilie -- beruf Meinung -- Erzählung vorig Neujahrsnacht fassen -- 
  setzen -- bös Verhängnis währ Mitternacht verbergen -- -- gut Absicht -- überlegt Wort dunkel Zweideutigkeit annehmen -- möchten Gefahr aussprechen -- 
  -- Falk betreffen -- vorig Sache Sprache bringen -- 
  -- denken -- Anfangs ernstlich meinen -- sonderbar Zufall Elisen leichthingesprochen Wort schwer Gehalt -- Druck fühlen -- 
  lassen ähnlich Gegenstand schweigen -- 
  aufwecken -- Dichter -- Reich Geist -- liegend harrend dünn Decke -- -- leise hörend -- stürmen herauf -- 
  prosaisch jung Erstlingsmutter -- wünschen -- kernfest Junge Stammhalter -- übrig Schicksal fügen -- 
  gute -- erwidern Cäcilie -- wünschen -- wetten -- verlangen -- Elisa -- 
  verweten -- entgegnen Falk -- -- kenn Elis -- wissen -- gewissenhaft Wort halten -- 
  Cäcilie lenken Gespräch -- verstimmen abbrechend -- Jäger -- wahrscheinlich zurückkommen -- entfernt -- Fortepiano öffnet -- Gesellschaft bitten -- einstweil Musik unterhalten -- 
  geben Achtung -- Falk -- Überraschung absehen -- 
  Hoffnung Elis aufgeben -- -- wenigster erwarten -- zeigen -- 
  Merk -- Scherz verderben -- merken lassen -- 
  Gesang Musik unterhalten -- spät -- Jäger kommen Beute Wald -- 
  Baron führen Gesellschaft Speisezimmer -- Cäcilie Abendtisch bereiten lassen -- 
  Säße -- -- Hermann -- Frau Haus fehlen -- häßlich Übelstand -- 
  rund Tisch sehen schön Gesicht -- Auge fehlen -- 
  -- 
  lassen ewig Frage -- lieben Freund -- erwidern Baron -- glauben -- vermiss Frau -- Verhältnis groß Pünktlichkeit bestehen -- 
  Aha -- -- rufen Falk -- Pantöffelchen beugen -- 
  symbolisch Platz -- 
  lassen -- 
  Kloster schön Gewohnheit -- Abt auswärts speisen -- stehen Sitz Speise schön Blumenstrauß -- 
  -- 
  sprechen schnell Stuhl Tisch tragen -- Rose -- Fruchtkorb schmückt -- Glas leer Tisch stellen -- 
  Baron verlegen -- 
  lassen froh -- sprechen -- bedauern -- ändern -- 
  Frau danken wahrhaftig -- erzählen -- Abwesenheit Freude stören -- 
  lassen trinken -- 
  Wein Sonnenschein Regen Freude -- 
  sprossen blühn -- 
  munter Laune Gesellschaft erwachen -- Mann Mahnung freigebig Wirt nachgaben -- 
  Frau teilen allgemein Stimmung -- Baron Cäcilie werfen zuweilen bedeutend Blick -- stehen wechselsweise -- 
  selten eins Fenster -- erwarten -- 
  Falk flüstert neugierig Nachbar Vermutung -- Elise Gesellschaft Ankunft überraschen -- hindert wiederholt Nachfrage -- Baron einigemal ablehnen versuchen -- 
  schlagen -- Schloßthor Reiter öffnen -- schnell Abstieg Gesellschaftszimmer treten -- 
  bringen Baron Nachricht Wohlbefinden Gemahlin -- Bitte -- Gast Freude stören lassen -- 
  frühesten Hoffe vergnügen -- 
  eigenhändig Billet Baronin Neujahrswünschen begleiten -- bestätigt Nachricht Boten -- 
  herzlich froh -- Baron -- Bote entlassen -- 
  ich_es gestehen -- peinlich Angst abendstunden zubringen -- 
  Grund erzählen -- Nachsicht schenken -- Pflicht Wirtes Gast aufheitern erfüllen -- 
  Drang Baron -- nah erklären -- 
  -- einig Weiger -- wiewohl sonderbar Gegenstand -- vorig Neujahrsnacht unterhalten -- 
  Vision -- -- fragen Falk -- 
  Unmöglich -- 
  ähnlich -- erwidern Baron -- wiewohl -- Frau -- 
  lebhaft Fantasie führen zuweilen nah Schwärmerei -- Anfangs Sache -- -- bedenklich heranrücken -- peinigt Gedanke Vorfall -- fürchtet Kind -- 
  erinnern Gespräch vorjährigen Sylvesternacht -- 
  kommen zuletzt dunkel interessant Thema ahnung Vorbedeutung -- damalig Braut erschrecken -- Glück unbedeutend -- Ohnmacht -- 
  Erinnre -- Adolf -- falsch Beleuchtung Marinbilde hatten Phantom täuschen -- 
  -- fahren Baron fort -- besuchen Braut früh Bräutigam erlauben -- 
  völlig erholen -- heit -- verlieren Lieblingsgespräch jung Verlobter möglichst Beschleunigung Wunsch -- 
  scheinen nachdenkend -- 
  stimmen -- Plan Reise Vergnügung nächster Sommer erzählen -- Befremdung äußern -- erwidern bedeutungsvoll -- 
  freuen -- wahrscheinlich vereinigen -- 
  brav alt -- rufen Hermann -- Profzeihung zunichte -- 
  ängstigen -- Baron -- 
  -- unterbrechen Hermann nochmals -- vermählt -- Winter Frühling miteinander streiten -- 
  Beistimm -- fahren Baron fort -- gehören -- 
  Elis entdecken -- worauf rätselhaft Wort gründen -- 
  kommen Vergessenheit -- -- Wunsch Schwiegermutter -- meinig Beschleunigung Verbindung vereinigten -- 
  Schatten Hindernisses treten Weg -- Frühling führen Elis Behausung -- 
  sitzen erstenmal Abenddämmrungestunde -- mancherlei Gespräch erwähnen scherzend bewährt Profzeihung -- 
  erblaßen höchst ernst -- 
  O abgewarten -- sprechen tief bewegen -- 
  Traum bewähren -- traurig -- 
  elise feierlich -- Bitten Überredungsgrund aufbieten -- Entdeckung Geheimnisses bewegen -- 
  gelingen vieler Mühe -- 
  Neujahrsnacht elis Traum künftig Neujahrsnacht -- heutig -- sehen -- 
  Verabredung -- feiern -- Zweifel Traum veranlassen -- erscheinen Schauplatz Fantasie Hartenstein -- 
  befinden bekannt Gesellschaft -- Braut -- Gemahlin -- 
  Schwärmerin Deutung -- nächster Jahreswechsel Braut -- -- Auslegung Jahr -- Braut -- Frau -- finden furchtbar Vorbedeutung Traum -- Nacht -- tote -- 
  verstehen -- unterbrechen Falk -- Elise -- 
  -- fahren Baron fort -- sucht Vorstellung auszureden -- natürlich Zusammenhäng Traum unser Gespräch aufmerksam -- 
  gelingen beruhigen -- Sommer Traum Furcht vergessen -- 
  freuen sogar Scherz Jahreswechsel wiederholt Einladung -- 
  letzter Monat behauptet Fantasie alt Verstand -- gestehen -- bitten Elis -- zweideutig Nacht Mutter zuzubringen -- Erfüllung Traumes unmöglich -- 
  ruhig -- Nachricht Wohlsein fest Entschluß bekommen -- zurückkehren -- 
  bleiben -- dürfen ausbleiben -- hauptsächlich Freund laden -- 
  glauben -- Falk -- treues -- wahrhaft Gemüt -- 
  halten Wort Grab -- 
  -- wiederholen Baron -- 
  Schwärmerei bingen -- 
  verlieren -- fallen Hermann -- Jugend Schwärmerei Kaltes Tot -- 
  laugen -- fahren Baron fort -- sagen -- zuweilen bange -- 
  dergleicher Natur lassen einwirken -- 
  geistig berühren -- Gedanke Empfindung wirken -- erschüttern Wurzel Leben -- 
  Traum verursacht Frau Woche Übelbefind -- Zerstreuung unser Reise heben -- 
  Traum Deutung -- Hermann -- Traum furchtbar -- konventionell Vorurteil -- Traum Gegenteil bedeuten -- erzwungen Unheimlich -- 
  bloß konventionell -- fallen Falk -- lieb Tod -- Brautfeier Totenfeier verwenden Frühling Herbst -- Abend -- 
  symbolisch Vorstellung Traum Wirklichkeit Leben deuten -- Morgenrot Sturm -- Abendrot Heitere deuten -- 
  Traum unheimliche -- schwärmerischen Geist -- überall Symbol -- Unruhe erwecken -- 
  Seltsamst verschweigen -- setzen Baron hinzu -- indessen dienen -- seltsam Wirkung Schwärmerei hervorbringen -- 
  Frau -- Herrin einführn -- Hartenstein -- wissen -- niemals genau Beschreibung Lokal -- einrichten lassen -- überraschen -- 
  alt Zeit Schloß Familie gehören -- -- Wunsch -- gleichsam alt Eigentum zurückkehren -- 
  gleichwohl Traum genau Zustande zeigen -- einzuge finden -- 
  zeigen sogar Seltsamkeit Schlosses -- -- Vorfahre unbekannt -- 
  Versammlung Baron fragend -- 
  glauben -- Falk -- schweigen beharren -- alt Felsennest Seltsamkeit Vorwelt beherbergen -- lang unterirdisch Gänge erzählen lassen -- Mönch -- verborgen Schätz wachen -- 
  Laß hören -- 
  stimmen -- 
  -- fahren Baron fort -- allemal Neujahrsnacht Thema Geister Wundergeschicht -- 
  indessen -- 
  tun -- alt Sage -- nachfrag Nachsuchen alt Papier archives -- aufgefund -- erzählen -- 
  Ahn alt Ritterzeit öfters wild Rohheit auszeichnen -- menschlich Empfindung -- ziemlich allgemein -- 
  Sinnesart Ritter Wolf -- mehrere hundert Hartenstei hausen -- 
  reich -- tapf Nachbar fürchten -- 
  meinen -- erlauben -- kennen Zorn Grenze -- gering erlauben -- 
  paar jung Leute benachbart Stadt Ritter Forst Wild erlegen -- 
  Knappe auffangen -- Ritter Wolf lassen damalig Gewohnheit Burgverlie werfen -- befehlen -- Pfeilschüsse töten -- 
  Vater gefangener -- unbemittelt Mann -- bieten vergebens Lösegeld -- Ritter bleiben unerbittlich höhnt alte obendrein -- 
  regen beleidigt Menschheit Unglücklichen -- vergessen -- Seite Ritters -- verging Scheltworter -- 
  Ritter kennen Wut -- 
  befehlen -- Greis tiefste Gefängnis werfen -- Sann ausschweifendster Bestrafung -- 
  gelingen Bürgerschaft alt jung Leute Kunst Tod loszukaufen -- nämlich Glockengießer breit berühmt -- 
  Ritter frevelhaft Übermut grausam Bedingung -- alt Vater Lösegeld eigenhändig Glock gießen -- erstenmal Sohn Tod läuten -- 
  bestimmt äußerst kurz Frist -- Vater geschäftig Eilfertigkeit Arbeit Todeswerkzeug Sohnes anhalten -- 
  Sohn retten -- alte nötigen -- gräßlich Bedingung willig Totenglocke Sohnes gießen -- 
  Knecht Untertan Ritter Anblicke Greises erschüttern -- zitternd beugen Last Kummer Arbeitsgerät umherwanken -- 
  tröstet helfen Arbeit -- 
  bringen sogar -- Metall besitzen -- einzuschmelzen -- gegeben Frist -- Meister nötig Metall gewöhnlich Handelsleut herbeibringen -- 
  manch metallen Heiligenbild bringen arm verwandte Stadt entziehen Andacht -- Guß Trauerglocke ablieferten -- 
  Träne Wehklage gewiß Verwünschung traurig Werk vollbringen verderblich Glocke gegossen -- 
  Mitbürger alte fast Untertan Ritter versuchen nochmals Vorbitt -- 
  glauben Ritter Wolf Angst -- unglücklich Vater Arbeit ausstanden -- genügen lassen -- gräßlich Vollziehung Urteil fordern -- 
  vorbitte bleiben fruchtlos -- 
  glock Gefängnisturm aufhängen -- Klöppel Seil versehen -- Ritter Gebot -- Tod gefangener läuten -- 
  verließ alt Vater Sinn -- 
  rannt Turm -- fassen Seil ziehen verhängnisvoll Glock -- 
  hören wild schrecklich Geläut schreien -- 
  beschwören heilige -- Bild unselig Guß verschmolzen -- Rache -- verflucht Glocke -- Schlag Unglück Haus Ritters läuten -- Totenruf verstummen -- Name Geschlecht nennen -- 
  Verwünschung bewährt Stelle -- 
  sohn Blut fließen -- Turm stürmen alt Vater wahnsinnig fort -- 
  Sturmwind braust Geläut treiben Donnerwolke heran -- 
  Blitz zünden Burg -- ansehnlich Gebäude Raub Flamme -- löschen -- wahnsinnig Glöckner entseeln Boden sinken -- Geläut verstummen -- 
  Läut Blitz heranziehen -- Hermann -- bleiben Zusammentreffen Unglück Schuld Verwünschung höchst sonderbar -- 
  Fluch alte bewähren kräftig -- fahren Baron fort -- -- wahrscheinlich Vorfall vergessen -- feiern Ritter Hochzeitfest Tochter -- 
  einziehend Bräutigam festlichst Prunk empfangen -- Glockenschall verherrlichen -- 
  Fräulein stehen bräutlich Schmuck Balkon -- prächtig Zug verlobter -- 
  ertönt Trauerglocke -- Fräulein herwinkend geliebter zuneigen -- schaudern -- sinken Gitter Balkon Tiefe hinab -- 
  Sturmwind rauschen erschrocken Brautbegleiter -- finden Fräulein unbeschädigt leblos Büschen Fuß Bergfelsen -- 
  unglücksfälle ähnlich Art machen Burgbesitzer aufmerksam -- 
  Glock zerschlagen -- Verwünschung Schein -- bind Dauer Geschlechtes Glocke -- 
  begnügt Klöppel abnehmen -- Überfluß Öffnung Turme vermauern -- 
  Fluch wahnsinnig Vater heben -- 
  Unglück Besitzern Burg drohen -- regen einsam Glocke Turme -- dumpf proffetisch Ton dringen furchtverbreitend Mitternacht -- 
  stet Bangigkeit metallen Käuzlein -- nennen alt Schrift -- bewegen Besitzer Stammburg veräußern -- Jahrhundert -- besitzen Familie Schloß -- Glocke hören lassen -- 
  Andenken sogar lang Zeitraum erloschen -- erinneren -- jemals Sage gehören -- 
  alt vermauert Turm gelten alt Gefängnis -- ' verschlossen Luft ziemlich Baufälligkeit untersuch Lust -- 
  Traum Frau Nachforschung veranlassen -- 
  Schloß erkennen -- Traume sehen -- Glocke Klöppel erinnerlich -- nirgends finden -- 
  fragen vergebens alt Leute -- Hoffnung -- Archiv Spur finden -- Zusammenhäng entdecken -- 
  Gemahlin -- wünschen -- hören -- 
  Schwärmerei nachteilig Nahrung erhalten -- 
  Höchst sonderbar -- -- rufen -- 
  Hu -- 
  Trauerglock -- falk schaudernd -- Cäcilie bedeutungsvoll -- 
  Komme Proffetisch Neujahrslied -- unterbrechen Hermann -- Freudenglock schlagen -- neugeboren Jahreskindlein begrüßen -- 
  läuten Mutter Kindlein Grabe -- Falk ernst -- 
  -- grauset Geschichte düster -- 
  sehen wahnsinnig Glöckner Turm -- Sturmwind grau Profetenbart durchwehen -- Vaterschmerz Fluch gräßlich Glockenschall kräftig Zauber zusammenwirkt -- Geläut Sohn Tod Licht rufen -- 
  Nähe metallen Käuzlein -- 
  lassen vergraben -- hing freundlich Sühnungsglocke Kirchturm -- 
  sprichst Vorsatz -- Falk -- Baron -- Sobald Frost hindern -- letzter Spur Untat vertilgen -- 
  lassen Glocke Fluß versenken -- alt Turm freundlich Pavillon Platz -- fertigst Inschrift Sühnung Freudenglock -- froh Fest taufen einweihen -- 
  -- erwidern Falk -- Gott wissen -- Unglück Trauerglocke Haus brächte -- 
  eurer Meinung -- entgegnen Anselm -- klug vorig Besitzer -- ehe Burg Glocke verkaufen -- 
  fürchtet dunkel Verbindung Unglücksprofetin Dauer Geschlechtes -- 
  zerschlagen -- unterbrechen Baron -- fortdauern -- Ort -- kling Einwohner Schlosses schrecken -- 
  -- genau nehmen -- Verwünschung auswirken -- 
  Name grausamen Ritter vorhanden -- 
  Schwiegervater letzter Stamme -- Frau führen Glück Name -- 
  Anselm Meinung -- Cäcilie -- Ding führen Vorsicht Übel herbei -- abwenden -- 
  lassen Glocke düstre Gespräch ruhen -- rufen Hermann -- alt Jahrsmutter Viertelstund leben -- Abschiedslied Kind Vigilien singen -- 
  Still -- vierstimmig -- Chor Schlußworte wiederholen -- 
  horchten -- Herrmann -- Falk -- Adolf Julie fangen vierstimmig Gesang -- 
  Liebe freundlich Mutter -- Fährst -- scheidend Freund verlassen -- blicken treuem Sinn -- sehen ungern erblassen -- Freude -- Liebe behüen Engel Muttergrab -- 
  begleitet Chor Wiederholung letzter Zeile -- 
  fahren Stimme fort -- 
  jeglich sehnen stillen -- jeglich Auge trocken -- schenksen scheidend Ebenbild -- grüßen feiernd Glocke -- Tod verklären Muttergesicht -- lächelnd Kind treten tröstend an Licht -- 
  Chor Wiederholung enden -- gewaltig Schall Haus beinahe erschüttern -- 
  fahren erschrocken Sitz -- 
  Baron öffnet Fenster -- außen scheinen wunderbar Schall kommen -- 
  Ursache seltsam vorfalls umsehen -- wiederholen Schall gewaltig laut Geschwirre zitteren -- 
  klingen Glockenton -- Baron bebend -- 
  Gesellschaft scheinen Schall Ähnlichkeit Krache einstürzend Mauerwerk -- 
  Hofgesinde laufen Häusern -- furchtbar Getöse aufschrecken -- 
  Baron fragen -- wissen -- woher Getöse entstehen -- Schall gehören -- ungewöhnlich Gewalt Glocke schlagen -- 
  Klang tönt gellend fort -- folgen dumpf Krachen -- mehrere Stimme Hof rufen ängstlich -- alt Turm stürzen -- 
  vermauert Glockenturm -- setzen Baron schaudernd hinzu -- 
  schlagen Mitternacht -- 
  furchtbar Schall lassen vernehmen -- Gesellschaft Fenster wenden -- erblickten Stuhle -- Falk Scherz Baronin setzen -- Schattengestalt Abwesend -- 
  Verschwand letzter Glockenschlag -- ehe Bestürzt -- Ausruf Schrecken vernehmen lassen -- 
  Hofe bringen indessen Nachricht -- Dach alt Turme beinahe eingestürzen -- sehen Schutt Stück Glocke -- wahrscheinlich Fall zerschlag Getöse verursachen -- 
  treffen furchtbar -- Baron bang Ahnung -- 
  glocke zerspringen Augenblick -- Frau Schatten zeigen -- 
  Traum Mitternacht -- -- 
  Verlust zweifeln -- 
  reitend Bote sogleich abgeschicken Befehl -- eiligst Nachricht Baronin zurückkehren -- 
  untergelegt Pferd Rückkehr beschleunigen -- 
  -- Sonne heraufstiegn -- Bote -- 
  Miene verkündigt Trauerbotschaft -- 
  unzeitig Wehen Baronin überfallen -- Mitternacht gesund Kind Welt bringen -- zwölft Stunde -- Bemühung Arzt ungeachtet -- verschieden -- 
  bekommen Bedeutung -- rufen Baron bitterst Schmerz -- Schrei proffetisch Erblasse Marinbild vorig Neujahrsnacht -- 
  versuchen eitlem Trost Schmerz Baron entweihen -- 
  verschließen -- sprachlos lebt tief Trauer -- 
  folgend Elisen Sohn bringen -- 
  wärterin erzählen -- Seliger Augenblick Todes freundlich lächeln -- Scheidekuß Neugeboren Stirn entschlafen -- 
  trauernd Vater Kind arme -- leise sprechen -- 
  Tod verklären Muttergesicht -- lächelnd Kind treten tröstend an Licht -- küßte Kind Stirn -- tröstend Zusprach Freund Herz sprechen -- 