Deutsches volksmärchen -- 
  etlicher hundert Thüringerland ziehen -- wählen -- Liebesgram anderer Herzweh Einsamkeit treiben -- Weg Fest Aarburg vorüber -- 
  Türmer stehen Nacht Warte -- lugen umh Ritter -- Pilgrim reisend -- erspähen -- bleisen munter Willkommen -- knarrt Tor -- zugbrücken rasselten -- Rosse stampfen -- Knappe riten fremde entgegen lud Imbiß Nachtherberge -- 
  Ritter sprechen Fremde freundlich Wort -- Standesgebühr führen Gastzimmer -- befehlen Knecht Pflege -- Gast gedingen -- 
  letzter Ritter -- Herr Thimo Aarburg bleiben -- -- Alter berühmt Gastfreundlichkeit Aarburger Vorfahr -- 
  Bruder -- Vettern Oehme beerben -- kennen Sorge -- Gast fremd Haufen einzogen -- 
  geschehen zuweilen -- ausziehen reisend nötigt Hereinzukommen -- 
  zeigen alsdann Herrlichkeit Schatz -- freut -- Stück gefiel -- klüglich Verstand loben -- verehren Geschenk -- 
  Maulredner -- loben -- loben -- verkehrt Liebedienerei Hausherrn Fuchsschwanz streicheln -- rühmen unbehilflich unnütz Stück kostbar Kleinod -- Fuchsschwänzer einstimmen -- flugs lose Geschenk Hals -- mußt Höflichkeitsweg behalten Weg nehmen -- 
  groß Schatz Aarburg Ritter einzig Tochter -- deutsch Land Name schön Bertha -- 
  Ritter Fürst ziehen breit herbei -- Franken -- Brite Welsche bewarben Minne -- -- fad -- dreist Spleen -- Epidemie Fremdsucht Thüringerland verbreiten -- Wort Mann finden gut Eingang -- fremd Zunge sprechen -- 
  Braut heimführen -- allgemein Stimme -- Glückskind Welt -- 
  hold Schönheit -- Natur -- unermeßlich Reichtum -- Vater Glück beschenken -- Rede unschätzbaren Schmuck -- alt Eigentum Aarburger Haus -- Bertha letzter Zweig Stamme Brautschmuck erhalten -- 
  Bogenschüs Aarburg stehen schlecht -- verfallen Fest -- alt Ritter Heerwart Sohn Balduin einzig Erbe hinterlassen -- 
  Ehe Kaiser Maximilian Wucherpflanze Römischen deutsch Boden einheimisch -- Ritter Flausenmacher -- gelüsten -- Schwert Lanze Finger klopfen -- Ritter Heerwart wohlhabend Ritter letzter -- wissen Tapfer darein schlagen -- Gewinn beut Lösegelder -- -- Ritterschwert Schreiberfeder beugen -- Kaiser Landfrieden Kleinhandel fremd Eigentum hart verpönen -- vorwärts -- 
  verfallen Burg mußt jährlich mehrere Kammer Türme Kauze Eul abtreten -- Handwerk frei Hausherr legen -- müssen Thorflügel Brücke Bedachung benutzen -- Winterpalast Ritter Schnee Frost sicheren -- Sommerhau Dorn Holundergebüsch alt Gemäuer wölben -- 
  Ritter Balduin besehen wehmütig Blick natürlich Ruine väterlich Burg -- 
  Raum fahrenden nötig -- Anschein -- Burg weniger warm eilend Sommer gewähren -- keineswegs Frost Schnee nächster Winter Schutz versprechen -- 
  halten geheim Rat -- Umstand -- Gedanke schweiften Thema -- Verstand Pensum bearbeiten geben -- ergötzten Fantasie Bild wünschen -- -- Not -- vertragen -- 
  Ritter Balduin's Herz nämlich Bruch nah Burg -- Alter Feindesgrimm Zustand geraten -- vielmehr Jugend Schönheit -- 
  Aarburger Tochter -- schön Bertha sehen -- Turnier schön Fräulein einmütig berufen -- Sieger reichen -- Preis Tapferkeit erhöhen -- Mut Ritter entflammen -- 
  Balduin stärken Anblick Schönheit -- Engelerscheinung -- heben Ritter Sattel -- sein Strohmann -- führen Schwert Streiche -- regieren Luftgeister -- Stichling Mallocher's regsam Schneidermeister -- Geisterkönig -- scher Nadeln [ * ] -- schön Fräulein Bertha kurzsichtig schön Schwester ähnlich Fall -- 
  merken -- Auge Sonnenstrahl -- süß Wort Frühlingshauch -- jung Ritter Pflanze Mute kräftig hervorkeimen lassen -- lohnen Kampfrichter freundlichst Lächel -- einstimmig Held Preis zuerkannen -- reichen jung Ritter holdem Erröt -- Morgenröte Glück Wang heitersen verkündigen -- währ Seligkeit Augenblick übergroß -- vergessen Zukunft deuten -- 
  indessen versäumt Balduin -- Aarburger Burg fleißig heimsuchen -- -- munter Gesell -- Burgherrn Schwank aussinn Ausführ helfen -- täglich Gast Aarburg -- finden allezeit Platz Tafel -- Kämmerlein Bett -- gelüstet Nacht Nebel Haus reiten -- 
  Fräulein Bertha schlankem munter Ritter freundlich Blick -- fordern zuweilen Tanze -- ungeschickt Gast Schleifer Saraband drohen -- fragt Rat -- neu Stück Putz Kleidung zulegen -- 
  hierdurch verliebt Balduin kühn Hoffnung schön Sommerabend -- Fräulein Bertha Sternenlicht Laube Schloßgarten sitzen -- Flötenstimm Lispeln Harfe singen -- Nachtigall Säusel Abendluft -- warm mächtig Herz -- übermannen -- springen -- vertauscht Sitz Rasenbank Platz Bertha's Füßen -- schwor -- Ton Gesang -- Hauch leben -- bitten süß Minne -- 
  Fräulein überraschen -- Ritter Liebesglut -- verborgen Flämmlein längst heimlich Freude sehen -- schnell heftig Ausbruch -- 
  Bestürzung Entsank Harfe weiß arme -- -- vorbeugen -- Saitenspiel ergreifen -- begegnen Lippe Balduin's Munde -- Arm -- Harfe ausstreckten -- verschlang Ritter arme -- Liebende Kuß Umarmung gefangen -- ehe wissen -- Dämon Zufall Gott Amor Hand arbeiten -- 
  weniger Augenblick -- Wirklichkeit düstern Erdschatt Mondlicht Liebesfantasie werfen -- Liebenden bange -- Vater Thimo -- reich Ritter Aarburg -- heimlich Minnespiel Tochter arm Ritter aufnehmen -- 
  beratschlagt mancherlei -- sitzen Stunde -- einig -- -- 
  Balduin müssen fest Aarburger Gunst setzen suchen -- gelegentlich Gesinnung Plan Bertha ausforschen -- 
  Gelegenheit zeigen -- 
  Unerachtet aufwande Pracht Aarburg füllen Vater Thimo's Geldkast täglich -- Raum gebrach -- reich Ritter nötigen -- Fest anderer Stück Land kaufen -- voll Sack leeren -- 
  Gelegenheit Ankauf fehlen niemals -- -- gefordert Kaufpreis abzudingen pflegen -- Käufer Hohen Nieder willkommen Verwalter vögt Herrschaft Pleisner Meißnerland Thüringen -- 
  schön Herrschaft bringen -- -- Tischgenoß voll Pokal Glück wünschen -- setzen unmutig Becher -- 
  helfen -- sprechen -- Erbe -- Hab verlassen -- 
  Ei -- versetzt Gast -- hold minniglich Tochter -- Eidam geben -- eu Herz wünschen -- 
  -- -- 
  entgegnet Aarburger -- Sohn -- 
  Eidam führen Weib Burg heim -- alt Vater sitzen verlassen leer Haus -- 
  Sohn -- Balduin -- suchen wack Hausfrau -- setzen Herrschaft -- lassen hausen Aarburg -- Raum Geschlecht -- 
  Wort wachsen Ritter Balduin Mut -- zuvor Wein angefeuern -- 
  Besann fahren Rede heraus -- 
  Vater Thimo -- -- wehren -- eur Sohne -- 
  Gebt eure Tochter -- minniglich Bertha Hausfrau -- lassen eurer Schlöss wohnen -- -- fällen -- Aarburg -- 
  sollen eur Freude sehen -- Kind enkeln -- 
  anstatt freundlich Zusage ziehen Aarburger Gesicht Rede gewaltig Länge -- 
  meint -- Ritter Heerwart -- -- gezogen Tone -- wenden gleichgültig Frage Nachbar -- 
  Balduin Zeichen merken -- Liebesgestirn günstigst Konstellation stehen -- 
  gleichwohl schwellen Zornader Kälte -- Aarburger warm Herz Werbung aufnehmen -- 
  stehen Eifer -- wiederholen Wort erklären feurigst Beredsamkeit Liebe schön Bertha -- 
  Thimo lassen gelassen aussprechen -- 
  erwidern Ernst -- Ritter -- woran erkennen -- Tochter redlich Minne lieben -- zeitlich Wille -- 
  lassen ausreden -- 
  berufen Ritterwort -- genügen Ritter Ehrensache -- Bertha Stolz Haus -- Herzblatt -- 
  Grille -- reich Leute -- abwendig -- 
  Bertha werben -- Burgen Länderei vollauf -- -- -- Hausfrau Meister Sparbrot's Rechentafel wirtschaften -- leben -- Jungfrau wohnen -- 
  Liebe Ehestand Paradiesvogel -- Wolkenrevier einzig Himmelsluft leben -- tot -- Erde fallen -- hold Blume -- Erdbod Nahrung saugen -- kräftig schön blühen -- mitten Sonnenglanz Westgesäusel hinwelken verdorren -- 
  Eidam -- -- Geld Gut vollauf -- -- zeitlich besitz -- verwend Ausstattung Tochter Brautschmuck -- köstlich -- königlich Prinzessin -- 
  Ritter Balduin Rede fast kindisch bedünken -- 
  belächelt Unwissenheit Aarburger Kurszettel wahr Minne -- Staat Luxus-Mandate gülden Kette -- demanten Ring sammetn Kleid -- natürlich Kurant seiden Haarflecht -- feurig Auge sammetn Wang Zeit Liebe verlieren Staatspapiere Banknot Kriegszeit klingend Gold Silber -- 
  Vater Thimo -- heben -- sollen -- dergleich Eitelkeit lüsten -- wissen sicher -- hold Bertha verlangen tragen -- 
  Schönheit herrlich Kleinod .... 
  Spart eure Wort -- fallen Aarburger lachend -- kenn Redensart Jugendzeit -- unleiben -- Sprächet -- Liebet Tochter wollten Haarringlein hoch -- gülden Gnadenkett Kaiser König -- 
  vergessen -- -- Grille -- Tochter königlich Brautschmuck tragen -- Grille Beweis Grund vergeblich auskramt -- 
  bleiben -- -- Freund -- -- geben fest Ritter eu Wort -- Bertha heimlich Minnespiel treiben -- weder -- Aarburg -- weder Trutz List Wille werben -- 
  Balduin Einwendung -- Aarburger bleiben Satze -- verliebt Ritter müssen Ritterwort Handschlag geben -- Weigerung Gefahr laufen -- Anblick Bertha verlustig -- 
  Ritter -- Zeuge Versprechen -- mehrere Sage Brautschmuck Aarburg gehören -- fragen scherzweise -- Ritter Thimo insgeheim Töchterlein Erbschmuck ausstatten -- 
  Hausherr ernsthaft -- 
  geziemt mitnichten Sache euren Scherz treiben -- 
  wissen -- Schatz köstlich Brautschmuck vormals Erbteil Aarburger -- verschwinden weiß wohin -- -- wissen -- beschließen -- alt Familiengut erneuern -- Tochter unveräußerlich Erbteil mitzugeben -- Stück -- alt Pergament beschreiben verzeichnen -- 
  überköstlich Werk müssen -- möget urteilen -- Stammburg Ankauf Kleinodien übrig bleiben -- 
  -- Schmuck Bertha Manne vertrauen -- gut Grund -- erraten -- 
  rund Erklärung meinen Aarburger Frage Zechbrüder abweisen -- alt Welt Wunderbare begierig -- Zeitgenosse neunzehnten Jahrhundert -- 
  Ritter setzen gefüllt Becher Mund -- Zunge mächtig lassen Zechwirt dringen -- Geheimnis Berg halten -- entdecken sollen -- wann Aarburger Brautschmuck kommen wohin fahren -- schwuren -- herbeizubringen -- Türke Gewalt geraten -- 
  Ritter Thimo Wein gesprächig -- beginnen -- 
  wohin Schatz fahren -- vermögen berichten -- sintemal Vater vermissen -- Spur finden -- abhande kommen -- 
  Aarburgerin -- Namens Uda -- zuletzt tragen -- finden Nachricht -- wissen -- Haus verheiraten -- Schmuck entführen -- Bewandtnis -- 
  fast scheinen -- absichtlich Sache Dunkel lassen -- 
  Schmuck Aarburg kommen -- alt Burgpfaff wunderlich histörchen erzählen -- verhalten -- stehen -- glauben wollet -- 
  ureltermutter -- Namens Ursula -- Geschlecht Ranzau -- hochbetagen -- Mutter Kind -- 
  -- Kindlein Johannisnacht ruhen -- Name rufen -- Schlaf erwachen -- 
  meinen -- Dienerinne -- fragen -- ungewohnt Ruhe störn -- 
  Auge Auftat -- unbekannt Weib zwerghaft Ansehn Bett stehen -- entsetzt Hülfe rufen -- 
  Weib heißen still nachfolgen -- Frau Kindesnöt Hülfe begehren -- 
  Frau Ursula Einwendung -- fragen woher wohin -- Weib bitten beweglich klagen -- Kindbetterin -- fürnehm Geschlecht -- all vertrauen Frau Ursula setzen -- Rittersfrau entschließen folgen -- 
  fremd Zofe führen Burg -- Wachen ungestören Wäll zugbrücken -- Pförtchen Tor -- Feld Gewässer -- hoch Berg kommen -- 
  pocht Weib Steinplatte -- alsbald öffnet hoch Portal Berg -- Frau Ursula Begleiterin vorhall unterirdisch Palast eingehen -- 
  Inneren kommen Schar Männlein entgegen -- Ellen -- neigen demütig -- führen Reihe kostbar Säle Gemächer -- Edelgestein Perle herrlichst Gold Silbererz glänzten -- 
  anderer zwergisch Weiblein Frau Ursula -- sitzen Bergkönigin sehnsüchtig harren -- 
  tun paar golden Flügeltür -- Männlein treten ehrerbietig -- Zofen führen Frau Ursula Wochenstube unterirdisch Königin -- 
  Wand fein -- zart geädert Marmor wölbt Kuppel sanftgrün Smaragd -- 
  Seite stehen Bett gediegen Gold -- liegen Frauenbild -- schön holdselig -- welschen Maler Mutter Gott malen -- sprechen -- Frau Ursula nähern -- edl Frau -- fürchten -- treten getrost nah -- beizustehn Stunde Angst -- überfällen Johannisnacht -- Erdgeister Kraft binden -- Hahnenruf -- 
  Rede treten Frau Ursula hinzu -- sprechen Kreisenden Mut -- segnen heilig Kreuz -- bös Blendwerk Satana fürchten -- 
  bemerken -- unverändert bleiben -- zuvor -- schön Königin Segen holdselig anblicken -- freudig an Werk -- 
  erheben Arbeit wunderbar Getön -- flüstern Wind Sait -- spielen hell Glöcklein -- fern nah wunderlieblich anhören -- 
  währen -- reichen Frau Ursula jung Mutter zart Knäblein Augenblick klingen tief Glockenton Posaunenschall -- golden Pfort öffneen neu -- König treten herein -- stillschweigend Kind -- küssen -- zeigen Schar Männlein -- Pfort stehen niederknieten -- König Kind aufnehmen -- 
  Frau Ursula Verwunderung -- berufen Königin Bett -- sprechen -- Nehmet -- edl Frau -- euren Beistand Andenken Saffira -- Bergkönigin -- 
  Bewahret Schmuck Kästlein -- eur Haus bleiben -- grüne blühen -- Zweig deutsch Reich überschatten -- verlöschen eu Name -- Schmuck -- 
  möget Stück geliebt Tochter mitgeben -- erhalten edlen Stein Herz Geist frisch -- angenehm fröhlich -- sodann bedacht -- alsbald ähnlich Stück gleich Wert schaffen -- Schmuck vollständig bleiben Braut Aarburg Ehrentage schmücken -- 
  Wort deuten Königin ansehnlich zierlich gearbeitet Kästlein -- Zofen halten -- wozu Saffira Frau Ursula Schlüssel überreichen -- 
  Zwergweib geleitet reichbeschenkt Wehmutter unterirdisch Königspalast Burg -- bedient Auskleide -- stellen Sodann Schmuckkästlein Nachttisch beurlauben zuletzt höflich Verneigung Burgfrau -- 
  ureltermutter spät erwachen -- dünken Traum -- merken Kästlein -- wozu golden Schlüssel Hand halten -- seltsam wunderbar Nacht begegnen -- 
  zeigen Eheherrn -- staunen überköstlich Schmuck Kästlein -- Demanten Sankt Lambertus-Nüsse Perle groß Weinbeer -- schier römisch Papst kostbaren Krone -- königlich Gratial nennen -- 
  beweisen Wunderseg -- Bergkönigin verheißen -- Geschlecht Aarburger mehren breitet Reich vollauf -- Schmuck Aarburg -- verschwinden -- sterben Aarburger kinderlos -- letzter -- Name Aarburger Grab tragen -- 
  Bertha Schmuck entgehen -- verschenkt Stück Erbgangsrecht zugefallen -- -- falls Wort Bergkönigin trauen -- Stück -- fertigen -- Tugend mitteilen -- 
  Ritter kannegießerten Berggeisterspend -- 
  Starkgeist -- meinen -- Altermutter lebhafen Fantasie Traum -- Schmuck hinzugedichten -- legend Evangelium -- heimgefallen Stück bess Beweis -- Sproß Erzvater Jacob Himmelsleiter englisch Zimmerwerk -- 
  hingegen wissen ähnlich Begebnis geistig Schenkung Rekompense anzuführen -- güldisch Sandkörner -- Zwerglein Schloß Rosenberg Grafe Hermann Valet darbieten -- ingleich Ring -- edl Frau alvensleben Kalbe Milda gespenstisch Weiblein ähnlich Liebesdienst erhalten -- beweisen geisterkundig Jung Gewißheit Geschichte Möglichkeit Aarburgischen Wunderhistorie Geisterspuks -- 
  schütteln bedenklich Haupt -- meinen -- Spende verdächtig nehmen gewöhnlich -- Harfner Palästina Liedlein gehören -- schön Fräulein -- Schatz besessen -- 
  Hochzeitstage schmücken Bräutigam harren -- anstatt Hochzeiter schwarz Höllenritter kommen Braut eitlen Schmuck heimholen -- wodurch Kleinodien vermutlich finst Schacht Abgrund anheimgefallen sein -- 
  Ritter Balduin sitzen mißmutig -- gering Anteil kontrovers verwünscht Brautschmuck -- Braut rauben -- untersen Ort Erde -- 
  indessen kürz -- naht Herbstnachtgleich -- Wind bleisen frostig Stoppel schlagen Regen Graupelwetter Dach Fenster Balduin Burg -- 
  entschloß Tag schnell -- treten Aarburger sprechen -- 
  Ritter Thimo -- dulden lang Nähe Aarburg -- 
  Sturmwind spielen Fest übel -- Liebe Herz übler -- 
  beschließen -- Heer Kaiser ziehen -- Ehre erwerben -- 
  alt Burg Biet -- feil -- -- gut Käufer -- geben dünken -- 
  Ritter Thimo hört Rede ungern -- Balduin gewogen -- -- Meinung bestehen -- lassen zureden -- schließen Handel Burg -- richten Sodann Mal Valet -- lassen Ritter Balduin letzter Ergötzlichkeit Seite schön Bertha sitzen -- 
  Schluß berufen reisefertig Gast Fenster -- übergeben Brief -- sprechen -- 
  Zieht Gott -- Ritter -- kehren Fröhlicher -- ausziehen -- 
  allerwärts Herberge finden -- absonderlich -- öfters Winkel Ritter -- Knecht reisend anfüllen -- nehmet Brief -- burgvögter Haushalter schreiben lassen -- gute bewiren -- kommen -- 
  sollen Herr Burgen -- fällen -- Befehl vorzeigen -- 
  Gott befohlen -- euer Roß Harret euer -- 
  schieben Türe hinaus -- hören -- 
  unten finden Balduin Roß satteln fertig -- schwingen ziehen -- Seufzer Fenster Bertha -- Glück Welt hinein -- 
  Gebrauch Panis-Briefe nächster Vögt freundlich willfährig -- entfernteren Rauher herrisch finden -- 
  Wille -- letzter Brief unabgegeben lassen -- wideren hochfahrend Wesen Amtleute -- unfreundlich wild Schlackerwetter treiben Abend Funkenburg -- nah Stadt Leipzig Pleißnerland -- vormals mäßig Fest -- Vogt Aarburger hausen -- heutzutage anmutig Platz -- wohin Sonntag Werkeltag Städter lustwandeln -- rittermäßig sehen -- Messenzeit welsch englisch Kunstreiter -- zuweilen fahrend Ritter -- Stegreif Sattel -- Windfähnlein Luftgondel leben -- 
  Burg schimmern weit Nebel Schneegestöber -- Nähe Balduin -- lustig Fenster beleuchten -- feiern Vogt Freudenfest Ehre Burgherrn -- 
  Balduin stoßen einigemal Horn -- geschäftig -- Wanderer draußen antworten -- 
  ertönen innen allgemein Präliminarfrage Einlasses -- 
  Werda -- Ritter langweilig Examen auftun -- 
  schicken Burgvogt Brief -- müssen indessen Roßbube verweilen -- Vogt Befehl Burg führen -- 
  Munter -- Geiger Pfeifer spielen lustig -- Ritter Dirn dreht Tanz -- sitzen vertraut Umarmung weichen Lotterbettlein -- 
  sitzen Schenktisch leert Becher geschwind Diener füllen -- singen Trink -- Schimpf- Liebeslied -- lachen -- Becher Tisch klirrten -- 
  Vogt taumelt ankommend Ritter entgegen -- bitten Platz nehmen lassen -- Balduin Lärm bleiben sehnt Ruhe -- 
  ziehen Wirt Augbraun aufwärts -- zucken Achsel Ohr -- sprechen -- 
  Edler Ritter -- fest gestreng Herr Thimo Aarburg gebieten eurer gut pflegen -- gleichwohl Nacht eng schlecht Zimmerlein verleiben nehmen -- -- Sehet -- Burg besetzen -- -- Herrenzimmer erwählten -- Geheuer -- 
  arge Schalk -- Späher -- Ritter halten -- Art entledigen -- hoffen Hausherr bestehen -- sagen -- tun Rechnung Haushalt -- 
  Zimmerlein -- Ritter Schlafstätte anbieten -- luftig -- Gast Schloßhofe angenehmen däuchen -- Herrenzimmer lang wüst Behausung Geist -- Waghals -- Strauß gespenstisch Usurpator unternehmen -- rückwärts gekehrt Gesicht finden -- 
  Ritter lassen Gemächer zeigen -- Verwarf Befahl Herrenzimmer Bett aufzuschlagen Abendessen nebst Schlaftrunk bereiten -- 
  Einsam Mahlzeit geschwinder -- Bankettierer Tafel Vogtes -- Jubel Gesang schallen -- 
  verrufen Stunde -- Unterwelt gespenstisch Missionar Bekehrung Ungläubigen Freigeister Oberwelt entsenden -- still still Burg -- Fackel Kerze erloschen -- Sänger verstummn Geiger Pfeifer ziehen Haus -- 
  Balduin stärken Schlaftrunk Anfechtungen Nachtgrauen -- schieben Feuer Kamin werfen bereitet Bett -- Gedanke Bertha entschlummern -- Traum hold Schönheit erfreuen hoffen -- 
  Wächter -- Stunde Mitternacht Burg ansagen -- rufen Ritter anmutig Vorhalle Traumtempel dornig Wildni Leben -- neckend Kobolde Liebespein Unmut Irre führen -- Traumpfort finden -- 
  versuchen mancherlei Weg -- vergessen dürren -- Sandig Hohlweg Langenweil -- humoristischen Jean Paul probat rekommandieren -- [ * ] -- Leser Wohltat froh lassen -- Weg führen Ziel -- seltsam romantisch abenteuerlich Partien unterbrechen -- 
  Ritter wenden ausf Pfühl unmutig Seite -- dünken -- rauschen Schlot Kamin -- 
  richten Auge -- Schornstein herabfallen -- Menschenhand -- 
  -- rauschen Neuem fallen Fuß Weg herab -- folgen Hand Fuß -- Requisit menschlich Körper -- jeder Gebühr bekleiden -- herab -- fügt -- chinesisch Schattenspiel Pygmäentheater -- womit Herr Charles Compagnie Pariser Oper pygmäisiren -- alsbald stehen riesenhaft Schweizer Wehrgehenk Partisane fertig -- stellen an Seite Kamin -- 
  Organisationsprozeß beginnen kurz neu -- Hellbardierer treten geschmückt gerüstet Seite wunderbar Laboratorium -- 
  verwandelt allmählich Gliederrege prasselnd Hagelwetter -- 
  Weiberfüßch -- Männerfäust -- Kinderkopf -- Sortiment menschlich Gliedmaß polteren herab -- Material Tisch -- Sessel -- Schemeln -- Tafelgedeck -- golden Kanne -- Pokale Kessel Zubehör sardanapalisch Male -- halb Zimmer erfüllet -- 
  Erstgeboren gespenstisch Schöpfung legen Partisan Hand -- fangen -- eingekommen Beitrag Miszell neu Welt Menschenkund redigieren -- 
  setzen Chaos menschlich Fragment geschickt zierlich Mensch -- Sagensammler Vorzeit Rhapsoden Homer -- Grieche Griechengenossen Muster Mannes passieren -- deutsch Fugen Zusammensetzung ausspähen -- 
  Hand entstehen stattlich Dienerschaft -- geschäftig umhertreiben -- Tisch -- Sessel Schemel zusammensetzt Tafel servieren -- Gast fehlen -- 
  gehen alchimistischen Schornstein hervor -- 
  Mann Frau prächtigst Galatracht früheren erscheinen -- nehmen Sessel Platz spazieren umher -- 
  zuletzt finsteren Schlot holder Fräulein -- weiß Seide kleiden -- schön -- zart Schlank -- blaß Lilie -- 
  Antlitz -- Seufzer Himmel -- kummervoll -- unaussprechlich Lieblichkeit -- 
  Seite Ritter -- schwarz unholdselig ansehen -- Mund lachend Grimm -- Auge finster Gewitterwolke voll düster Blitz -- 
  führen Fräulein Spiegel -- schön Gestalt schmählich Totenbild zeigen -- voll entsetzen abwenden -- zwingen Unhold sanft Auge abscheulich Trugbild beschauen Spiegel schmücken -- 
  bringen Diener Kleid Gold Silberstück Brautkrone -- Halsschmuck Armspang -- Fingerreifen Ohrengehänge -- geglüht höllisch Feuer zischt Funke rot Stahl Amboß Waffenschmiedes -- 
  hierh Ritter Balduin Lager stummen Zeuge Abenteuer abgeben -- scheinen Teilnahme nötigen -- 
  unwillkürlich Schrei -- Mitleid Geängstet auspreßen -- wendet Geisterversammlung Bett -- stehen -- gülden Pokal Tafel kredenzen menschlich Gast -- nötigt Zeichen erheben mitternächtig Mahl nehmen -- 
  mutig alt Ritter -- körperlich Feind gelten -- achteten -- wahr Gegenfüßler tapfer Paladin -- schand -- Geisterwelt Schauder empfinden -- 
  Ritter Balduin hundert Sarazenensäbel blinken sehen -- golden Pokal -- nächtlich Zechbrud entfleischt Knochenhand bieten -- 
  indessen Entkomme -- zögern Gast regen -- langsam Bett nähern -- 
  Augenblick stark Gemüt Übergang ängstlich Zweifelmut tapferst Heroismus schnell -- Hasenherze Poltron Sprung großtuend Prahlerei kleinmütigst Verzagtheit -- 
  Ritter Balduin ermannen -- springen frisch Lager -- fassen Schwert -- linke ergreifen dargeboten Becher setzen gewaltsam Tisch -- 
  -- rufen fest Ton -- rechtlich Ritter auffordern -- Bescheid Becher leeren -- Gewalt üben schwach Dirnen Art Raubgesindel -- 
  Mensch -- stellen Schwert -- Dirne fechten -- -- heben weg Mensch Wohnung -- 
  Rede lachen schwarz Ritter verbissen -- dumpf heimlich Gelächter erzittert Mauer Haus -- 
  Dirne -- rufen -- Braut ergeben bleiben -- 
  Nacht prangen feurig Schmuck -- Stein zurückkehren Hand Herr -- 
  Schmücken -- schön Braut -- -- Ritter -- tun Bescheid -- 
  Wort drang Hochzeitgäste -- dürr Hand Pokal -- rotem dampfend Schaum füllen -- Balduin -- 
  Mann scheinen Trunk -- Frau Tanz einladen -- 
  Balduin halten Griff Schwerte Platz grinsend Haufen -- 
  brauchen aretinsch Gedächtniskunst -- peinlich Toilettenscene verschwunden Aarburger Brautschmuck erinnern -- blass Braut Fräulein Liede Harfner Palästina -- Uda erkennen -- Aarburger Geschlechtsregister schwiegen -- verschwinden unhold Gesellschaft genügend Licht -- 
  Sache gewiß treten schwarz Ritter sprechen -- 
  Bescheid -- Verdienst -- 
  Jungfrau Uda Aarburgerin fernerhin -- 
  Stein Gabe Bergkönigin Saffira -- Hand rechtmäßig Eigentümer -- nehmen hiermit Ritter Thimo Aarburg Besitz -- 
  mündlich Proklamation -- Balduin erobert Territorium okkupiern -- Erfolg -- gedrucken unser diplomatisch Zeitalter -- 
  feindlich Besatzung -- Herrenzimmer garnisonieren -- warten -- zufrieden -- Persönlichkeit salvieren -- lassen nächtlich Bankett Zubehör Sieger Beute -- 
  Balduin erstaun Freude -- Morgenstrahl Pracht zurückgelassen golden silbern Geschirre nebst Reichtum Glanz Juwele zeigen -- Zweifel bleiben -- Nachlaß gespenstisch Braut verloren Aarburger Brautschmuck -- 
  Musterung Reichtum beschäftiget -- Burgvogt mehrere Knecht Tür öffnet -- höchlich verwundert -- Ritter fürchterlich Brause -- Schläfer Schloß Mitternacht aufschrecken ängstigen -- lebend Glanz Umgebung finden -- 
  schalk gewiß glauben -- tosend Schwarm verwogen Geisterseh -- Mephistopheles Doktor Faust Lüfte führen -- 
  Ritter Balduin durchschaute Herz Vogt -- glänzend Beute Geisterwelt gelüsten -- 
  befehlen -- Wagen Roß bereit halten -- Schatz Geleit Aarburg bringen -- Bedeute -- Geist Herrenzimmer hausen -- -- wagen -- Hand gering Stücklein Kleinodien legen -- alsbald höllisch Heerschar Lüfte führen -- Speisung Raben zerrissen -- 
  folgend Nacht Geisterspuk Herrenzimmer gehören -- gelten Ritter Balduin kräftig Teufelsbanner Vogt gehorcht Befehl pünktlichsen -- 
  Ritter Thimo Balduin Abschied mißmutig -- 
  schön Bertha sitzen -- singen traurig Lied Scheid Meide -- harfeniren trübselig -- 
  blies Türmer morgens lustig Stücklein -- edelknaben verkündigen -- Walde nahe glänzend Zug Wagen Riesig -- Ritter -- Zug führen -- trag Ritter Balduin feldbind Helmzeichen -- Gestalt anderer -- 
  schlagen Vater Thimo Herz Freude -- hold Bertha laufen -- treten eilend Burgzinn deckt weiß Hand Auge Licht rot Morgensonne -- 
  Walde blinkt Helm Schilder hell poliert Harnisch Schwert entgegen -- 
  -- -- 
  rufen herab alt Ritter befehlen schleunigst Burg öffnen -- 
  rasselt Riegel Tore Kette zugbrücken klirrten -- Edelknecht schwang Ros -- Türmer intoniert Willkommen -- widerschallen Wald Gebirge Hirsche Eber waldeinwärts fliehen -- 
  schön Bertha steigen eilig Burgsöller herab Barg verschämt Kloset -- geheim Fenster lauschen einzuge Ritters -- 
  springen fröhlich Roß -- umhalste Aarburger sprechen -- 
  Vater Thimo -- zurückbringen spend Bergkönigin Saffira -- Wert achten euren Burge -- köstlich Schatz Gold Silbergerät -- achten wert eu Eidam lassen wohnen holdseligen Bertha -- eur Burge -- dieweil nötig hinzugeb Brautschmuck Wille eurer Tochter -- 
  Aarburger meinen Rede eitel Rätsel vernehmen -- heißen Ritter Balduin Burg -- Becher Rätsel lösen -- 
  gehören -- Kleinodien Verwunderung betrachten -- sprechen -- wissen -- Herz schnöder Geld hängen Bertha weigern -- 
  vorenthaln -- hätten Frist nochmals werben -- wiewohl ungern minder reich sehen -- Hausfrau -- Dirne -- 
  nehmen -- 
  Saffira's Brautgeschenk Ehre tragen -- lassen eur Hochzeit sobald fällen -- 
  Balduin Bertha säumen -- Liebesbund heilig Weihe Kirche einsegnen lassen -- 
  hold Braut -- schmücken -- Bergkönigin Saffira -- Schmuck überstrahlend -- edle Diamant golden Fassung -- Brautgemach führen -- Seite Balduin sanft entschlummeren -- treten Traumbild Lager -- flüstern -- 
  Uda -- Erlöste -- 
  bitte deinen Gemahl -- Leib Berghöhle Gruft Vater bestatten lassen -- 
  Stimme erwachen Bertha Gemahl Gesicht -- 
  finden -- Traumbild anzeigen -- bringen Uda Gebeine Gruft Ruhe -- 
  Vogt Funkenburg verehrt Herr Thimo schönen -- gülden Pokal -- Bankett gespenstisch schwarz Hochzeiter -- ausführlich Verzeichnung sämtlich Kleinodie Gold -- Silber -- Perle Edelstein Gedächtnis eingraben lassen -- Ritter Balduin Geistern Herrenzimmer erbeuten -- 
  Hierdurch erhalten Sage -- Funkenburg Leipzig verborgen Schatze -- wovon Besitzer heutig ausführlich Verzeichni vorzeigen wissen -- 
  Geschichte ergeben -- eitel Mühe Nachforschung -- Ritter Balduin wahr Schatz längst Funkenburg abführen -- Eigentümer weitbekannt Besitzung übrig lassen -- vollständig Beschreibung -- * * * 