Journalistikum bestehen Person -- 
  Aktuar Wermut gelehrt Blatt -- Stadtphysikus Bärmann elegann -- -- weder lehren elegant -- beide -- 
  gleichwohl Convente Schmäuse Journalgesellschaft -- -- übertrafen -- täglich Konvent Schmaus sobald Aktuar Delinquent Stadtphysikus Patient abfertigen -- 
  kommen -- Pfeife Tabak Krug Bier lesen neu Literatur machen Bemerkung -- 
  Aktuar lassen lang gewöhnlich warten -- 
  schmält viertelstündche beschließen -- -- literarisch Lektion anfangen -- 
  allgemein Anzeiger liegen neu Tisch Post grau Couvert Freimütige -- 
  verlieren -- 
  ergreifen Anzeiger -- Liefer- Lese-Departement gehören -- lesen -- 
  Blatt enthalten Vorhaltung Freimütige -- grau Stube -- 
  lesen heimlich Freude -- Stadtphysikus grau Stube disputieren -- hoffen alliierter Hand -- Gespensterglauben Haupt schlagen -- 
  gewundert Freimütige -- -- Realität halten -- obendrein Berlin Aufklärung Hand -- Ding aufnimmen -- Blatt gleichsam Obskurantenpropaganda -- 
  neugierig -- rechtfertigen -- 
  -- -- 
  fahren Stadtphysikus -- schweigen -- wie_es Gegner verdienen -- -- 
  werfen Lehne Stuhl -- ziehen kräftig -- Pfeife Mund vulkanisch Krater dampften -- 
  bitte -- fahren fort -- Ding glauben -- wandelnd Totengerippe geistig Gertrud -- anfühlen lassen Licht anzünden -- körperlich Kammermädchen -- 
  bitte -- erwidern erhitzen -- glauben -- Aufgeklärt Weisheit besitzet -- Natur Hand sehen können -- wirken vermögen -- -- 
  schwatzen schwatzen -- Sache verstehen -- desto laut sprechen -- 
  stopfte nachdrücklich Finger Pfeif -- Kopf abbrach -- glimmend Asche Stuhl fallen -- 
  Excüse -- -- 
  fahren fort -- stäuben Stuhl -- nimm_es übel -- nehmen schlecht Ton Pfeife -- 
  -- sagen -- Herzensbruder -- Schulkollaborator Gelegenheit -- Natur Kraft -- Arzt -- 
  Glaube -- wissen blutwenig -- Natur -- bewirken -- -- -- begreifen -- Schnupfe kurieren -- fallen -- 
  glauben -- -- -- 
  schnell Wort -- schicken meilenweit -- Consulirt tun Verständnis Beutel -- -- 
  ihr_es -- 
  glauben -- wünschen -- wobei wenigster inkommodieren brauchen -- 
  Moralisch -- Politische überall -- 
  Leute arretieren -- sagen -- Feind Schlacht gewinnen -- 
  Land -- Geist Haus -- Obskurant -- nennen -- Kuckuck jagten -- 
  fast glauben -- kopfschüttelnd -- habest Geist sehen -- 
  -- antworten -- Geisterseh ausgeben -- ähnlich -- Blendheim grau Stube -- passieren -- -- wunderlich -- Schlafstell heißen schwarz Kammer -- 
  helfen -- Stadtphysikus müssen schwarz Kammer erzählen -- 
  kurz Weiger stopfte frisch Pfeif -- verbat lachen -- fing -- 
  Universitätsstudie beschließen -- famulieren -- Bekanntschaft -- Doktor Wendeborn -- stark Praxis -- 
  gut Reiter gelten -- überlassen hauptsächlich auswärtig kranke alt bequem -- 
  schicken benachbart Rittergut Oberstlieutenant Silberstein -- Tochter heftig Nervenfieber liegen -- 
  helfen -- indessen verordnet Medizin Diät -- Umstand bringen -- Weg -- 
  Eltern lassen schlechterdings fort -- wiewohl Verordnung schriftlich hinterlassen -- Mißgriff Behandlung kranke -- 
  müssen bleiben -- 
  Frau Haus lassen geschwind Zimmer zurecht -- kranke ruhig -- entfernt Zeit Abend Familie -- 
  Schloß ziemlich finst -- stübch freundlichsen -- 
  altväterisch schwer Tür schwarz angestrichen -- getäfelen Decke Holzwerk -- Fenster unten Wand hinziehen -- 
  -- gefiel -- Bett -- schneeweiß überzogen -- Wand schwer grünseiden Vorhang stehen -- 
  setzen ausführlich Bericht Krankheitszustand Fräulein alt Herr -- gähnt Komma -- 
  pocht Türe -- 
  fahren -- fassen geschwind -- rufen -- barsch -- Herein -- 
  Dasmal bedenklich -- Jäger Oberstlieutenant -- nachfrag -- befehlen -- 
  erzähl Vorsatz Kleinigkeit -- Ding pünktlich -- Pedanterie -- Visum repertum -- 
  Jäger jung -- artig Mensch -- sprechen -- fragen -- einsam Stübchen vorkäme Erbot bleiben -- 
  lachen -- scheinen sogar düstern Behältnis ängstlich -- gering Geräusch bedenklich Winkel -- 
  erzählen -- stübch heiß schwarz Kammer -- tragen allerhand seltsam Erzählung -- Herrschaft verbergen bleiben müssen -- Aufenthalt verleiden -- 
  erzählt Histörchen Spukereien erbieten nochmals angelegentlich bleiben -- Schlafzimmer -- freundlich liegen -- teilen -- 
  Vorschlag annehmen -- Herzhaftigkeit kompromittieren -- -- unbeweglich Vorsatz bleiben -- -- wiederholen Tür Warnung Unglaube -- verderben stürzen -- 
  übel berüchtigt schwarz Kammer -- 
  -- Geist leichtsinnig denken -- ungefähr -- -- gewiß aufgeklärt Leute -- glauben Gelegenheit finden -- heldenmute abgerissen Larve Gespenste ewig Lorbeer verdienen -- freuen nah Mitternacht -- 
  zuvörderst untersucht Zimmer genauest -- 
  verschließen Tür -- verriegelen innen besonderer Schlos verschieden Riegel -- 
  gleich geschehen Fenster -- 
  Überfluß stören Reisesäbel Bett Tisch schränken umher -- genau Unmöglichkeit überzeugen -- Mensch Tier Besuch -- kleiden -- 
  Nachtlicht stellen Ofen -- Zimmer völlig dunkel -- Beleuchtung Furcht rege -- befreien -- 
  Vorbereitung legen nieder -- schlief vielfach Ermüdung -- hoffen -- 
  Schlafe -- dünken -- hören Name leise nennen -- 
  fahren horchen -- hören nochmals deutlich rufen -- August -- 
  Schall -- scheinen -- Vorhang Bett -- 
  reißen Auge -- dicht Dunkelheit -- 
  indessen leis Ruf Fieberfrost übergießen -- drücken Auge fest fing einzuschlummern -- 
  wecken Rausch Bettvorhänge Ruf Namen tönen deutlich -- 
  öffnen Auge halb -- Zimmer verwandeln -- wunderbar Licht durchdämmeren -- eiskaln Hand berühren Bett liegen totbleich Gestalt Leichenhemd -- kalt Arm ausstrecken -- 
  schrie Schreck laut -- prallen -- Augenblick geschehen heftig Schlag -- Gestalt verschwinden -- vorig Dunkelheit -- 
  ziehen Decke Kopf -- schlagen Turmuhr -- zählen -- Mitternacht -- 
  ermennen springen Verzug Bett -- sicher überzeugen -- Traum täuschen -- 
  zündet Licht -- untersuchen zuvor Zimmer -- 
  Zustand -- verlassen -- Riegel Tür verschieben -- Fensterwirbel verrückt -- 
  versuchen -- Erscheinung -- klar bewußt -- dennoch Traume -- -- Jäger Erzählung aufgeregt Fantasie zuzuschreiben -- -- ununtersucht lassen -- Licht Bett leuchten -- 
  liegen schön dunkel Locke Kissen -- 
  Traum Täuschung hergekommen -- 
  heben -- Begebenheit Nacht niederschreiben -- fern Geräusch aufmerksam -- 
  unterschied ängstlich laufen werfen Tür -- Zimmer hastig stark Tür pochen -- 
  rufen -- 
  -- 
  stehen schnell -- Herr Bärmann -- antworten draußen -- gnädig Fräulein sterben -- 
  werfen möglichst Eile Kleid -- fliegen Krankenzimmer -- spät -- Fräulein liegen entseeln -- 
  Mitternacht heißen -- Schlafe erwachen weniger schnell Atemzüg verschieden -- 
  Eltern untröstlich -- braucht ärztlich Beistand -- Mutter -- Leiche verlassen -- fast Gewalt trennen müssen -- 
  -- müssen gestatt Lock Haupt tote Reliquie Andenken nehmen -- 
  Denke -- schauert -- lang dunkel Ringel -- Haupt Leiche herabwallten -- Ebenbild nächtlich Geschenk erblicken -- 
  gefährlich krank -- -- merken -- Krankheit -- Patientin verschieden -- 
  sagen Tatsache -- Gewißheit Eid bekräftigen -- 
  sonderbar -- antworten -- Sprächst ernsthaft -- Hättest versichern -- Zimmer genauest Durchsucht Hättest -- ' fast Bedenklichkeit -- 
  sagen -- fallen Stadtphysikus -- Täuschung unmöglich -- 
  wachend Sinn sehen gehören -- Locke setzen vollends Zweifel -- 
  gleichwohl gestehen -- erwidern -- Locke Anstoß -- 
  Erscheinung Täuschung -- müssen geistig Einwirkung -- nennen -- herrühren -- Dazwischenkunft körperlich Locke zweideutig -- 
  Geist -- körperlich Ding hinterlassen -- verdächtig widrig Eindruck -- Schauspieler -- Charakter unschicklichen fallen -- 
  Stadtphysikus rücken ungeduldig Stuhle -- 
  Gott ehr Konsequenz -- -- rufen -- -- 
  glauben Geist werft meilenweit -- Theorie gespenstisch Charakter fertig -- kritisieren Erscheinung -- 
  treten Aktuar -- trocknen Stirn -- 
  gewiß Theater -- -- rufen entgegen halten Strafbüchse -- 
  reden -- antworten -- setzen hinauf vernehmt früh geschlagen Spitzbub -- Vagabund and solch Gesindel -- 
  gestern Pärch einbringen -- Stück Lunge kosten -- 
  Himmel Wille -- rufen Stadtphysikus -- bleiben Spitzbub Vagabundenhistorien Hals -- 
  Stunde grau Stube herumgestritten -- liegen Anzeiger Freimütiger ungelesen -- 
  grau Stube Gegenstück geben -- fallen Aktuar -- Freimütige einschicken -- -- Titel -- schwarz Kammer -- 
  schwarz Kammer -- -- rufen -- Stadtphysikus -- Tone -- 
  -- -- -- 
  wiederholen Aktuar -- hören -- brilliant Spitzbub Gespensterhistorie -- 
  kurios -- murmelt Stadtphysikus trommeln Tisch -- 
  kennen -- fing Aktuar -- Advokat Tippel -- -- Hanswurst -- Weiber herumflattern -- müßt kennen -- 
  -- -- -- 
  rufen -- komm Sache -- 
  -- fahren fort -- neulich -- draußen Rabenau Termin silbersteinischen Gericht -- 
  Sache Länge ziehen -- Abend heran -- ehe Tippel abfertigen -- 
  Natur -- wissen -- Herzhafteste -- Geschichte Posträuber Zungenabschneider besorgt -- Mensch Versprechung Welt nachts Straße locken -- 
  Silberstein Leute -- Angst sehen -- offerier Nachtlager Schlos -- 
  Tippel nehmen groß -- bitten Voraus Entschuldigung -- früh Lärm Haus -- müssen Tagesanbruch fort -- 
  lassen Tippel hören sehen -- 
  Stunde vergehen -- klopfen Türe -- rufen -- lärmen -- Mensch antworten -- 
  Leute bedenklich -- Türe Gewalt -- 
  liegen Tippel Totenblaß Besinnung Bett sehen -- abscheiden -- 
  Bemühung bringen -- erzählen fürchterlich Ding -- Nacht begegnen -- 
  Abends zeitig Bett legen -- Tageszeit Weg -- 
  Schlafe liegen -- wecken pochen Türe -- 
  Tippel Kopf voll Schreckenshistorien -- schmiegen möglichst Wand -- verstecken Kopf Decke -- 
  Augenblick eingeschlummeren -- wecken neu dumpf Rauschen Bett -- aufblicken -- stehen weiß Figur Schranke -- zuvor Stube sehen -- Schranke glänzt lauter Gold Silber Edelstein -- 
  Geist überzählen Reichtum -- klimperen Geld -- schließen Schrank -- nähern Bette -- 
  sehen Tippel blass Totengesicht altväterisch Kopfbinde schwarz Haar -- 
  wehen eiskalt Luft -- Geist Anstalt moderfleckig Grabtuch abzuwerf tippeln Bett teilen -- 
  Todesangst drehen Tippel -- schließen Auge fest rücken Wand -- 
  Augenblick tun laut Schrei heftig Fall Nähe -- vollends Besinnung rauben -- 
  liegen früh Morgen -- Leute -- erzählen -- halb tot bette finden -- 
  denken -- Sache gewaltig Aufsehen Haus -- 
  Silberstein -- ohnedies Vision -- erzählt alt Tante -- eher zeigen -- vermauert Schätz -- Rutengänger vorig Gutsbesitzer anzeigen -- 
  beteuern Tippel jeder Wort Erzählung vermaß teuer -- tausend Eiden bekräftigen -- 
  deponiert Aussage gerichtlich -- Gerichtshalter -- Ungläubig gehören -- bestehen Lokalbesichtigung Zimmer -- Tippel schlafen -- 
  alt Silberstein -- meinen -- mögen Haus Geister anbinden -- können schwarz Kammer entbehren -- zufrieden -- Geist begnügen -- Gerichtshalter behaupten Satz entschlossen Mann -- setzen dasmal Meinung Gerichtsherr -- 
  schwarz Kammer öffnen -- Tippel angeben -- Schrank Schatz gestehen -- Bett Fenster -- Platz -- Schrank sichtbar unsichtbar stehen -- 
  untersuchen eng Zimmerchen -- nirgends finden geringst Spur Unheimlichem Verdächtigem -- 
  Gerichtspersonen Zuschauer beweisen unwidersprechlich -- Geschehen Ding zugegangen können -- 
  Tippel erbat beglaubigt Abschrift Protokolle Aussage -- Zeitung ächten aufrichtig -- gerichtlich attestiert Geisterseh aufführen -- fallen Gerichtshalter -- Bett untersuchen -- worin Geisterseh schlafen -- 
  schütteln -- rütteln -- pochen visitieren herum -- fahren Brettwand Bett Schieber Fugen Höhe -- öffnen Kommunikation Bett Seite Wand -- Vorhang Aussicht allerliebst nett Zimmerchen -- I -- Donner -- -- fallen Stadtphysikus drollig Ärger -- schlagen Stirn -- 
  Aktuar verstehen Beziehung Ausruf fahren fort -- rufen Tippel -- unerwartet Prospekt öffnen -- 
  Gesellschaft passiert Bett benachbart Zimmer -- 
  Tippel rekognoszieren Wandschrank Geistes -- Gutsherrschaft Schlafzimmer Kammermädchen -- 
  eröffnen Schrank -- -- Tippel sehen -- Juwele Gold Silber flimmeren -- manch hübsch Stückchen Silbergerät -- Schmuck Geldröllche enthalten -- 
  hübsch Bewohnerin Stübchen Schatz nächtlich Erscheinung näh Auskunft geben -- Jäger Oberstlieutenants unsichtbar -- 
  Jäger -- -- wiederholen Stadtphysikus -- 
  herrschaftlich Revierjäger -- August Leisegang -- bekräftigen Erzähler -- 
  August Spitzbube -- -- fallen Stadtphysikus nochmals Heftigkeit -- Weißt gewiß -- 
  wissen -- erwidern Aktuar verdrußlich -- 
  schöne vernehmen -- 
  fallen Name -- 
  Namensvetter -- murmeln Stadtphysikus gelassen zupft Halskrause -- erzähl -- -- 
  -- übrig erraten -- fahren fort -- beweglich Wand -- uralt Zeit Schloßherr Dienst leisten -- vergessen Liebespärchen neu entdecken benutzen -- 
  Tippel Schlaf Feder drücken Wand heben -- Rausch -- wecken -- Kammermädch -- Jäger fremd Gast Bett finden -- aufgeschrien -- Schieber fallen lassen -- Fall -- Tippel gehören -- 
  erklären -- 
  schicken Leutch Steckbriefe -- gestern unser Gerichtsdiener einbringen -- 
  morgens sitzen vernehmen -- groß Spaß -- Tippel ungefähr müssen totärgern -- nett rotbäckig Schwarzköpfch -- -- leichenblassen tot Geizhals -- Nacht Auge fest zugedrücken -- 
  passieren -- -- Kind versäumt Küsse nachholen -- -- schwarzäugig Schelm drehen flink -- Tippel Lippe rot Nase Gerichtsfrohn zusammenstießen -- 
  nehmen -- -- April -- jedesmal -- 
  Krabbe -- -- 
  murmeln Stadtphysikus -- Abenteuer geben müssen -- 
  -- schließen -- Ausgelacht -- schwarz Kammer Preis geben -- grau Stube disputieren weg -- 
  Lektüre -- 
  griff Freimütige -- 
  grau Stube -- -- 
  rufen -- alt Stück -- 
  besahen -- Datum neu -- 
  Stadtphysikus lesen -- 
  ehe -- werfen Blatt derb Tisch -- enthalten -- sonnenklar Auflösung bekrittelt verschrien Wunder grau Stube -- 
  -- rufen -- leben Schlecht -- 
  alt Grund -- rechtschaffen Gespenst halten -- 
  Komme Gespensterhistorie -- 
  Bewahr -- 
  -- erwidert -- Gespenster -- Zeitalter Geschichte -- 
  Geschichte Wirklichkeit -- Leser -- Glück -- Wahrheit -- * * * 