Berg heben Sonne -- leuchteen klar Majestät freundlich -- eng Tal wecken fröhlich Leben Geschöpfe -- schaffen -- Sonne Leben freuen -- 
  vergoldet Waldessaume schmettert Amsel Morgenlied -- funkelnden Blume perlend Grase tönt sehnsüchtig Wachtel eintönend Minnelied -- dunkel Tanne tanzen brünstig Krähe hochzeitreigen krächzen zärtlich Wiegenlieder dornig Bettchen ungefiedert Junge -- 
  Mitte sonnenreich Halde Natur fruchtbaren -- beschirmt Boden eingraben -- mittendrin stehen stattlich Blank schön Haus -- eingefassen prächtig Baumgarte -- Hochäpfelbaum prangen spät Blumenkleid -- halb stehen Hausbrunn bewässern üppig Gras -- halb Futtergange zuwandern -- 
  Haus liegen sonntäglich Glanz -- Besenstrichen -- angebracht Samstag abends Nacht -- erzeugen vermögen -- Zeugnis köstlich Erbgut angestammt Reinlichkeit -- pflegen -- Familienehr -- einzig unbewacht Stunde Flecken bringen -- Blutflecke unauslöschlich bleiben Geschlecht Geschlecht -- Tünche spottend -- 
  umsonst glänzt Gott Hand erbaut Erde Menschenhänd erbaut Haus reinsten Schmucke -- erglänzt Stern blau Himmel -- hoch Feiertag -- 
  -- Sohn Vater gehen Zeugnis -- Leiter Himmel stehen -- Engel auf niedersteig Seele Mensch -- Leib entwinden -- Heil Augenmerk Vater droben Erde -- -- Pflanzenwelt Himmel entgegenwächsen blühen voll Üppigkeit -- Mensch neu werdend Sinnbild Bestimmung -- 
  wunderbar klingen Hügel -- wissen -- woher Kling -- tönt Seite -- Kirche draußen weit Täler -- dorther kündet Glocke -- Tempel Gott öffnen -- Herz Stimme Gott -- 
  rege Leben bewegen schön Haus -- 
  Brunnen Nähe besonderer Sorgfalt Pferd striegeln -- stattlich Mutter -- umgaukelt lustig Fülle -- breit Brunnentroge stillen behaglich blickend Kuh durst -- zweimal müssen Bube Besen Schaufel nehmen -- Spur Behaglichkeit sauber weggeräumen -- 
  Herzhaft wusch Brunnen handlich Zwilchfetz stämmig Mägde Rotbräg Gesicht -- Haar Knäuel Ohren zusammengedrehen -- tragen eilfertig Emsigkeit Wasser geöffnet Türe -- mächtig Stößen heben blau Luft empor kurz Schornstein dunkel Rauchsäule -- 
  Langsam gebeugen Hakenstock Großvater Haus -- schweigend treiben Knecht Mägde -- streichelt Pferd -- wehrt Kuh schwerfällig Mutwille -- zeigen Stecke unachtsamen Bube vergessen Strohhalm fleißig lang Weste tief Tasche Feuerzeug -- Pfeif -- Morgen trotz schwer Atem wohlleben -- anzünden -- 
  rein gefegt Bank Haus Türe sitzen Großmutter -- schön Brot schneidend mächtig Kachel -- dünn Größe Bissen -- unachtsam Köchinn Stubenmägde -- manchmal Stück -- Walfisch ersticken müssen -- 
  Wohlgenährte -- stolz Hühner schön Taube stritt Brosame Fuß -- schüchtern täubchen -- werfen Großmutter Stücklein eigens -- tröstend freundlich Wort Unverstand Ungestüm -- 
  Drinn weiten -- rein Küche knistert mächtig Feuer Tannenholz -- Pfanne knallt Kaffeebohne -- stattlich Frau hölzern Kelle durcheinanderrühren -- nebenbei knarrt Kaffeemühle Knium frischgewaschen Magd -- offen Stubentüre stehen -- offen Kaffeesack Hand -- schön -- blaß Frau -- -- -- Hebamme -- rösten Kaffee schwarz -- können -- Pulver sparen -- 
  Götti -- Pate -- 
  Frau grausam mißtreu legen zuungunsten -- 
  halb Pfund -- 
  Vergiß -- Weinwarm bereitzuhalten -- 
  Großvater -- Kindstauf -- Gevatterleuten Weinwarm aufstellen -- ehe Kirche -- 
  Spar -- Hörst -- 
  Schüssel Kachelbank Safran Zimt -- Zucker Tisch -- nimm Wein -- dünken -- halb zuviel -- Kindstaufe brauchen Kummer -- Sache brauchen -- -- 
  hören -- Kindstaufe halten Haus -- Hebamme versiehen Amt Köchin geschickt Amt Wehmutter -- spuen -- fertig einfach Herde kochen -- Sitt fordern -- 
  Keller mächtig Stück Käse Hand stämmig Mann -- blanken Kachelbank Teller -- legen Käse Stube Tisch tragen braun Nußbaumholz -- 
  -- Benz -- Benz -- -- rufen schön -- blaß Frau -- -- lachen -- gut Teller Kindstaufe -- -- 
  glänzend Schrank Kirschbaumholz -- Buffet nennen -- -- Glasfenst Hause Zierd prangen -- 
  schön Teller -- blau rändern -- Mitte Blumenstrauß -- umgeben sinnig Sprüche -- -- 
  O Mensch -- faß Gedanke -- 
  Batz gelten dsPfund Anke -- 
  Gott Mensch Gnade -- wohn Maat -- 
  Hölle -- heiß -- Hafner schaffen Fleiß -- 
  Kuh -- frißen Gras -- Mensch -- Grab -- 
  Käse stellen mächtig Zupfe -- eigentümlich Berner Backwerk -- geflocht Zöpfe Weiber -- schön Braun gelb -- fein Mehl -- eiern Butter backen -- jährig fast schwer -- unten pflanzen Teller -- 
  Hochaufgetürmt liegen appetitlich Küchlein -- Habeküchlein -- Eierküchlein -- 
  heiß -- dick Nidel stehen schön geblümt Hafen zudecken Ofen -- dreibeinigen -- glänzend Kann gelbem Deckel kochen Kaffee -- 
  Harrt erwartet Gevatterleut Frühstück -- Fürst selten Bauer Welt Berner -- 
  Tausend Engländer rennen Schweiz -- weder abgejagt Lord steifbeinig Ladies Frühstück -- 
  -- kommen -- bereit -- -- seufzt Hebamme -- 
  -- jedenfalls -- fertig jeder Sache -- Pfarrer grausam pünktlich scharf Verweis -- -- -- 
  -- Großvater erlauben -- Wägeli nehmen -- -- jung Frau -- 
  -- Glaube -- Kind -- Taufe tragen -- führen -- träge Lebtag Bein brauchen lerne -- 
  Gotte -- Patin -- -- versäumen längsten -- Götten kurz können immerhin nachlaufen -- -- 
  Angst Gevatterleute verbreiten durch Haus -- 
  -- -- -- hören allenthalben -- eck Haus schauen Gesicht -- Türk bellt leibeskräfte -- herbeirufen -- 
  Großmutter -- -- ehemals -- wissen -- aufzusteh Herr warten -- -- 
  stürzt Bub Küche Nachricht -- Gotte kommen -- 
  -- schweißbedecken belad Neujahrkindlein -- 
  Hand schwarz Schnür -- blumenreich Wartsäcklein -- -- fein -- weiß Handtuch wickeln -- Zupfe stach -- Geschenk Kindbetterin -- 
  Hand tragen Säcklein -- Kleidung Kind nebst etwelch Stück eigen Gebrauch -- namentlich schön weiß Strümpfe -- arm Drucke Kränzch Spitzenkappe prächtigen -- schwarzseiden Haarschnür -- 
  freudig tönt Gottwillche -- Gott willkommen -- entgegen Seite -- -- Bürde abstellen -- entgegengestreckt Hand freundlich begegnen -- 
  Seite streckten dienstbar Hand Last -- Türe stehen jung Frau -- neu grüße -- Hebamme Stube mahnen -- 
  können drinnen sagen -- Brauch -- 
  handlich Manier setzen Hebamme Gotte Tisch -- jung Frau Kaffee -- Gotte weigern vorgeben -- -- 
  Vater Schwester täte -- ungegess Haus gehen -- schade jung Mädchen übel -- sagen -- 
  alt -- Jungfraue -- Mägde -- möchten -- spät -- liegen -- längstens -- 
  Kaffee dick Nidel gegossen -- Gotte wehren -- lieben -- werfen Frau Stück Zucker -- 
  Gotte zulassen -- ihretwegen Zupfe angehauen -- indessen müssen tüchtig Stück vorlegen lassen essen -- 
  Käse -- nötig -- -- 
  -- halbmageren -- -- Schatz -- Frau -- Gotte müssen ergeben -- 
  küchle -- wissen wohin -- -- 
  glauben -- sauber -- gut gewöhnen -- erhalten Antwort -- 
  küchle essen -- 
  Nöt Art abgemess Schlick Kachele ausgetrunken -- erheben eigentlich Streit -- 
  Gotte kehren Kachele -- Platz ferner Guttat -- 
  sollen Ruhe lassen -- müssen verschwören -- 
  Frau -- leid -- finden -- Hebamme dringlichst befohlen -- -- vermögen wahrhaftig -- -- trinken mögen -- Nidel fehlen -- abnehmen -- Brauch -- 
  arm Gotte Kachele einschenken lassen -- 
  Ungeduldig Hebamme herumgetrippeln -- bändigt Wort lang -- -- -- helfen -- sagen -- -- -- 
  -- He -- pressiern -- -- Frau -- 
  arm Gotte -- rauchen Dampfkessel -- verstehen Wink -- versorgen heißen Kaffee schnell Absätz -- glühend Trank zwingen -- -- Zweck -- nehmen -- hinunterbring -- kommen -- -- 
  stehen -- packen Säcklein -- übergeben Zupfe -- Kleidung -- Einbund -- blank Neutaler -- eingewickeln schön gemalt Taufspruch -- Entschuldigung -- -- 
  darein redet Hausmutter Ausruf -- Art Gattung -- verköstig -- fast nehmen dürfen -- wissen -- ansprechen -- 
  Mädchen Werk -- verbeiständen Hebamme Hausfrau -- wenden möglich -- schön Gotte Schuh Strümpfe hinauf Kränzche kostbaren Spitzenkappe -- 
  Sache umständlich trotz Ungeduld Hebamme -- Gotte Sache -- Ort -- 
  Großmutter herein -- -- sehen -- schön Gotte -- -- 
  nebenbei lassen fallen -- Zeichen läuten Got draußen äußern Stube -- 
  draußen sitzen männlich Pate -- alt jung -- neumodischen Kaffee -- -- verschmähend -- dampfend Weinwarm -- altertümlich -- gut Bernersuppe -- bestehend Wein -- geröstet Brot -- eiern -- Zucker -- Zimt Safran -- altertümlich Gewürz -- Kindstaufeschmaus Suppe -- Voress -- süß Tee vorkommen -- 
  lassen wohlschmecken -- alt Götti -- Vetter nennen -- allerlei Späße Kindbettiman -- schon -- Weinwarm gönnen -- sparen -- Merk -- Zwölfmäßig Sack letzter Dienstag Boten Bern geben -- Safran bringen -- 
  wissen -- Vetter -- -- letzthin Nachbar Kindbetti -- Boten Sack mitgegeben Kreuzer Auftrage -- sollen Sacke Kreuzer gelb Pulver bringen -- Mäße Anderthalbes -- Kindstaufen müssen -- Weiber -- 
  Gotte hinein jung Morgensonne Mitgevatt Gottwillch geheißen Tisch ziehen Teller voll Weinwarm stellen -- essen -- -- Kind zurechtmachen -- 
  arm Kind wehrt Hände Fuß -- behaupten -- gegessen -- können schnaufen -- 
  helfen -- 
  alt jung Spott Ernst -- Löffel greifen -- seltsam -- Löffel finden Plätzchen -- 
  Hebamme schön eingewickelt Kind -- ziehen gestickt Käppche rosenrot Seidenband -- legen schön Dachbettlein -- stecken süß Lulle Mäulchen -- 
  begehr versäumen denken -- wollen zurechtmachen -- können -- wollen -- 
  Umstand Kind rühmen billig -- wunderappetitlich Bübch -- 
  Mutter freut Lobe -- -- gerne Kirche kommen Gott empfehlen helfen -- -- Kind taufen -- sinnen -- versprechen -- 
  zudem unbequem -- Woche Dachtraufe -- -- Hand voll Anpflanze -- -- 
  Großmutter -- -- Sohnsfrau arm Frau Kirchgang müssen -- Hebamme setzen hinzu -- gerne -- jung Weiber Kind Kirche gehen -- 
  Angst -- gehen daheim Krummes -- Andacht Kirche -- Heimweg pressieren stark -- versäumen -- erhitzt -- übel krank sterben -- 
  Gotte Kind dachbett arm -- Hebamme legen schön -- weiß Tauftuch schwarz Quast Eck Kind -- sorgfältig schön Blumenstrauß Gotte Brust schonend -- -- -- Gott heilig Name -- -- 
  Großmutter legen Hand ineinander beten still inbrünstig Segen -- 
  Mutter Zug hinaus Türe -- 
  -- Bübli -- Bübli -- sehen Stunde -- halten -- -- 
  alsobald schoß Auge -- rasch fahren Vortuch Haus -- 
  Rasch schriten Gotte Halde Kirchweg entlang -- stark arme munter Kind -- hintendrein Götteni -- Vater Großvater -- Sinn -- Gotte Last entledigen -- obgleich jung Götti stattlich Maium Hute Zeichen Ledigkeit tragen Auge Wohlgefallen Gotte -- freilich Blende Gelassenheit verbergen -- 
  Großvater berichten -- welch schrecklich Wetter -- Kirche tragen -- Hagel Blitz Kirchgänger glauben -- Leben davonzukommen -- 
  Hinten_h Leute allerlei weissagen Wetter -- schrecklich Tod -- Glück Krieg -- gehen Stille -- fünfundsiebzigsen weder Früh sterben Glück Krieg -- 
  halb Weg gehen -- Jungfrau nachgesprungen -- Kind Haus tragen -- sobald taufen -- Eltern Gevatterleute alt schön Sitt Predigt beiwohnen -- 
  Jungfrau anwend Kraft -- schön -- 
  handlich Arbeit verspäten Gotte Kind abnehmen -- lassen -- zureden -- 
  Gelegenheit -- schön ledig Götti zeigen -- stark arme wieviel erleiden möchten -- 
  stark arm Frau Bauer anständig zart -- liederlich Stäbch -- Bysluft -- ernstlich -- auseinanderwehen -- stark arm Mutter Kind Heil -- Vater sterben Mutter Rute führen -- alleine Haushaltungswagen Loch heben müssen -- geraten -- 
  ist_es -- stark Gotte Zupfe halt Kopf schlagen -- prallen ordentlich -- Jungfrau Kind -- bleiben stellen -- Strumpfband -- 
  -- gesellt Mann -- mischen Gespräch -- Großvater unterbrechen -- -- ablenken Gegenstand -- fassen -- 
  halten -- alt Leute meist gewohnen -- Gegenstand fest knüpfen unverdrossen abgerissen Fade neu -- 
  Kindes Vater versuchen allerlei Frage Privatgespräche verführen -- einsilbig lassen angesponnen Fade fallen -- 
  Gedanke -- Vater -- Kind Taufe tragen namentlich Bübch -- 
  näh Kirche -- desto Leute schließen Zug -- warten Psalmbücher Hand Weg -- springen eilig eng Fußweg hinunt -- Prozession ähnlich rücken Dorf -- 
  Kirche stehen Wirtshaus -- nah Beziehung stehen Freude Leid miteinander teilen Ehre -- 
  stellen -- Bübch trocken -- Kindbettiman bestellt Maß -- einredet -- sollen -- -- Herz verlangen -- möchten weder Dickes Dünne -- 
  indessen -- Wein -- tranken -- vornehmlich Jungfrau -- denken -- müssen Wein trinken -- Wein geben wollen -- geschehen lang manchmal -- 
  Gotte Tropfen bewegen trotz Zureden -- nehmen -- Wirtin -- 
  sollen nachlassen nötige -- Mädchen zusehends Bläs -- Hoffmannstropfe tun Nöter Wein -- 
  Gotte -- Glas bloß Wasser -- müssen Tropfen Riechfläschchen auf Nastuch schütten lassen -- ziehen unschuldigerweise verdächtig Blick rechtfertigen -- helfen lassen -- 
  gräßlich Angst leiden Gotte merken lassen -- 
  -- Name Kind erhalten sollen -- Gotte alt Übung Pfarrer -- Kind übergeben -- einzuflüstern -- eingeschriebenen Name -- Kind taufen -- verwechseln -- 
  besorgend Ding Angst -- spät -- Mitteilung Namen vergessen -- Name fragen -- Vater Schwester -- Base -- allemal streng verbieten -- Kind unglücklich wollen -- sobald Gotte Kind Name fragen -- zeitlebens neugierig -- 
  Name wissen -- fragen -- Pfarrer vergessen laut öffentlich fragt Schuß Buben Mädeli Bäbeli taufen -- Leute lachen schand Leben -- 
  schrecklich -- stark Mädchen zittert Bein Bohnenstaude Wind -- blass Gesicht rann Schweiß bachweise -- 
  mahnen Wirtin Aufbrechen -- Pfarrer angerebelen -- Gotte -- 
  -- -- Meitschi -- stehst -- wissen frischgewaschen Hemd -- -- 
  laufen -- meinen -- gut -- frisch Luft kommen -- 
  gut -- schwarz scheinen Leute Kirche -- fing Kind schreien -- mörderlich Mörderlicher -- 
  arm Gotte beginnen wieg arme -- heftig Heftiger -- laut schreien -- Blatt stoben mal Brust -- 
  Brust eng schwer -- laut hört Atemfasse -- 
  hoch Brust heben -- hoch fliegen Kind arme -- hoch fliegen -- laut Schrie -- laut Schrie -- Gewaltiger lesen Pfarrer gebeter -- 
  Stimme prasselten ordentlich Wände -- Gotte wissen -- -- sau braust meereswogen -- Kirche tanzt Luft herum -- 
  Pfarrer -- Amen -- -- schrecklich Augenblick -- entscheiden -- Spott Kind Kindeskinder -- müssen Tuch abheben -- Kind Pfarrer geben -- Name Ohr flüstern -- 
  decken -- zitternd bebend -- reichen Kind dar -- Pfarrer -- -- fragen scharf Auge -- tauchen Hand Wasser -- netzen plötzlich schweigend Kind Stirn taufen Mädeli -- Bäbeli -- Hans Uli -- ehrlich -- wirklich Hans Uli -- 
  Gotte -- sämtlicher Emmentalerberge Herz fallen -- Sonne -- Mond Stern -- feurig Ofen tragen kühl Bad -- Predigt bebt Glied stillen -- 
  Pfarrer predigen schön eindringlich -- eigentlich Leben Mensch sollen Himmelfahrt -- Andacht bringen Gotte -- Predigt -- Text vergessen -- 
  warten -- geheim Angst offenbaren Grund blass Gesicht -- 
  Lachen -- Witz müssen hören Neugierde -- Weiber fürchten Mädchen anhängten -- Bube täte -- 
  getrost fragen -- 
  schön Haberacker -- niedlich Flachsplätz -- herrlich Gedeihen Wiese Acker ziehen Aufmerksamkeit fesselt Gemüt -- 
  finden Grund -- langsam -- stillzusteh -- schön -- steigend Maisonne warm -- heimkam -- Glas kühl Wein -- sträuben -- 
  setzen Haus -- Küche Hand emsig rühren -- Feuer gewaltig prasselen -- 
  Hebamme glüht feurig Ofen -- 
  rufen Essen -- Dienst -- spei vorweg -- reichlich -- froh -- -- Knecht namentlich -- Weg kommen -- 
  langsam fließen Haus sitzend Gespräch -- versiegen -- essen stören Gedanke Magen Gedanke Seele -- indessen lassen gerne innerer Zustand innewerden -- bemänteln langsam Wort gleichgültig Gegenstand -- 
  stehen Sonne über Mittag -- Hebamme flammend Gesicht -- blank Schürze Türe erscheinen willkommen Nachricht bringen -- essen -- sein -- 
  meister geladener fehlen -- gesandt Boten bringen Knecht Evangelium allerlei Bescheid -- Unterschied -- eigentlich -- -- Werkleute -- Leute bestellen -- müssen wohin -- warten sollen -- fürfahren Sache -- 
  Rätig -- Mahnung folgen -- warten müssen -- -- können -- Mond kommen -- nebenbei freilich brummt Hebamme -- Dümmeres Wartenlassen -- Herz gerne -- eher -- sollen merken -- 
  müssen Mühe -- Wärme stellen -- wissen -- -- fertig -- 
  Rat Abwesende schnell fassen -- anwesende fertig -- bedenklich Mühe -- Stube -- Sitz bringen -- -- -- -- 
  sitzen -- Suppe Tisch -- schön Fleischsuppe -- Safran färben würzen schön -- weiß Brot -- Großmutter eingeschniten -- dick gesättigen -- Brühe sichtbar -- 
  entblößt Häupt -- Hand falten -- feierlich beten jeder Geber gut Gabe -- 
  greifen langsam blechern Löffel -- wischen schön -- fein Tischtuch lassen Suppe -- Wunsch laut -- 
  -- begehren anderer -- 
  Suppe fertig -- wischen Löffel Tischtuch -- Zupfe herumgebot -- schneiden Stück -- Voress Safranbrühe aufgetrag -- Voressen Hirn -- Schaffleisch -- saure Leber -- 
  erledigen bedächtig Zugreifen -- -- Schüssel aufgeschichten -- rindfleisch -- grün dürr -- Belieben -- kommen Dürre Bohne Kannenbirenschnitze -- breit Speck prächtig Rückenstücke -- Dreizentnerche Schwein -- schön rot wissen saftig -- 
  folgen langsam -- neu Gast -- Suppe aufgetragen -- müssen anfangen -- -- einzig Gericht schenken -- 
  Zwischendurch schenken Benz -- Kindbettiman -- schön -- weiß Flasche -- Maß enthielt Wappe Sprüche reich zieren -- fleißig -- 
  wohin Arm reichen -- tragen Schenkamt -- nöten ernstlich Trink -- mahnen -- -- -- -- trinken -- -- 
  Hebamme Schüssel hineintragen -- bringen Glas -- bringen -- -- allemal gehörig Bescheid -- Küche wunderlich -- 
  jung Göttl müssen Spottred hören -- Gotte Trinke halten wissen -- Gesundheitmachen verstehen -- krieg Frau -- 
  Oh -- Hans Uli begehren -- Gotte -- ledig Bursch heutzutage Sache Kopf Heirat -- meister vermöchen -- 
  He -- Hans Uli -- dünken -- 
  Schlärpli -- heutzutage meister Mädchen -- geben teuer Frau -- meister meinen -- brav Frau -- nötig blauseiden Tüchlein Kopf -- Händschli Sommer gesticken Pantoffel Winter -- 
  Kuh fehlen Stalle -- freilich übel schlagen -- können ändern -- Frau -- Haus Hof bringen -- Austubaket -- müssen behalten -- 
  nützlich -- sinn Sache Heirat lassen Mädchen Mädchen -- 
  -- -- -- -- -- alt Götti -- -- unscheinbar Männche gering Kleid -- Ehre halten Vetter -- Kind -- bezahlt Hof hunderttausend Schweizerfranke Zins -- -- -- -- -- -- -- Weibervolk -- 
  sagen -- hie -- Haus anstehen -- dünn säen -- 
  Narrenwerk Hoffart Kopf -- ziehen Pfauen -- ziehen sturm Störch -- halb arbeiten -- Kopfweh liegen Bett -- ehe selber -- 
  alte buhlen -- -- müssen Kummer -- krieg brav Hausmutter Hausnarr Hausteufel -- -- 
  -- He -- he -- Götti Uli -- -- Gotte -- reden -- kommen -- -- -- deinen Zeit Bauerntöchter -- 
  Kennst achtest Mädchen -- alt Manne anstehen -- -- alt jung -- 
  rühmen -- Vater manchmal -- fortfahren -- tun Mutter selig -- berühmt Frau -- 
  schwer Schwein vorig Vater Markt führen -- 
  Metzger manchmal -- 
  meitschi sehen -- mästen -- 
  heutig Bube klagen -- lieben Welt Wille -- 
  Tubake -- Wirtshaus sitzen -- weiß Hüte Seite tragen Auge aufsperren Stadttore -- Kegelt -- Schießet -- schlecht Meitschene nachstreichen -- -- Kuh melken Acker fahren -- fertig -- Werkholz Finger nehmen -- tun dumm Herr Schreiber -- 
  manchmal verreden -- wollen Mann -- wissen gewiß -- fahren können -- hie Bauer abgeben -- wissen -- Mann -- -- 
  lachen -- treiben Mädchen Blut Gesicht Gespött -- 
  -- Probe nehmen müssen -- gewiß wissen -- Mann -- 
  lachen Scherz Fleisch -- vergessen Kannenbirenschnitze -- alt Götti -- 
  dünk -- einstweilen Tisch weg -- Bein Tisch steif -- Pfeif schmecken -- zuvor Fleisch gegessen -- 
  Rat erhalten Beifall -- Kindbettileute einredet -- sollen Tisch weg -- -- bringen Mensch fast -- 
  -- Kummer -- Bas -- -- Vetter -- -- Tisch stellen -- gering Mühe -- strecken -- handlich Essen -- -- 
  Mann machen Runde Ställe -- tun Blick Bühne -- alt Heu vorhanden -- rühmen schön Gras schauen Baum hinauf -- Segen mögen -- hoffen -- 
  blühend Baum Vetter halten -- 
  schick -- abzusitz Pfeifch anzustecken -- kühl -- Weiber anrichten -- nahe Hand -- 
  gesellt Gotte -- Weiber Garten Pflanzplätze besehen -- 
  Gotte kommen Weiber -- lassen nieder Gras -- vorsichtig schön Kittel Sicherheit bringend -- unterröcke hell rot Rand Gefahr aussetzend -- Andenken erhalten grün Grase -- 
  Baum -- Gesellschaft lageren -- stehen oberhalb Haus sanft Anfang Halde -- 
  Auge fallen schön -- Haus -- weg Blick schweifen jenseitig Talesrand -- schön -- reich Hof weiterhin grün Hügel dunkel Täl weg -- 
  -- stattlich Haus -- angeben -- -- Vetter -- -- Platz -- begreifen -- schlecht Haus leiden -- Geld Holz bauen -- Exempel -- -- 
  -- Vexier -- Vetter -- -- Großvater -- -- beid rühmen -- bauen wüst Sache -- wissen -- anfängen -- -- aufhören -- manchmal Weg -- Ort -- -- 
  -- fällen Haus ausnehmend -- -- Frau -- 
  -- neu -- scheu Kosten -- 
  sobald Mann -- besehen -- dünken -- einer können -- Himmel -- 
  fragen -- nehmen ungut -- Fenster wüsen -- schwarz Fensterpost -- Bystel -- -- stehen Haus übel -- -- 
  Großvater bedenklich Gesicht -- ziehen hart Pfeif -- 
  Holz fehlen Aufricht -- anderer Hand -- Not Eile alt Haus nehmen -- 
  -- -- -- Frau -- -- schwarz Stück Holz -- unten ansetzen -- Nachbar Herzen gerne neu Stück geben -- -- 
  -- -- halten sinnen Nachbar neu plagen -- geholfen Holz Fahren -- -- antworten alt -- 
  -- Hör -- Ätti -- -- Vetter -- -- machen Schneckentänze -- gib Wahrheit aufrichtig Bericht -- 
  Raun hören -- Punktum Wahr vernehmen -- 
  schicken -- Weiber Braten zweghaben -- Würdest kurz -- gib aufrichtig Bericht -- -- 
  Schneckentanz Großvater -- ehe verstehen -- Vetter Weiber lassen -- versprechen -- ausdrücklich Vorbehalt -- -- erzählen -- bleiben kommen -- 
  scheuen Leute Haus -- alt gerne Leute bös Spiel -- 
  -- Allemal -- Holz betrachten -- -- beginnen ehrwürdig alt -- -- verwundern -- Zuging -- fern Morgenlande -- Menschengeschlecht entstehen -- Mensch hierher kommen Winkel eng Graben finden -- denken -- -- hierher verschlagen drängen -- ausstanden -- 
  nachfragen -- erfahren -- Gegend früh bewohnen -- Sumiswald -- ehe Heiland Welt -- Stadt -- aufgeschrieben stehen nirgends -- 
  wissen -- sechshundert -- Schloß stehen -- Spital -- wahrscheinlich stehen Haus gehören samt Umgegend Schlos -- müssen dorthin Bodenzinse geben -- Frondienst leisten -- -- Mensch leibeigen rechtens -- -- sobald -- 
  ungleich Mensch -- nahe beieinand wohnt Leibeigene -- Händel -- -- schwer -- fast unerträglich drücken -- Leben sicher -- 
  Zustand hing jeweil Herr -- ungleich fast unumschränkt meist Leute -- finden -- leichtlich wirksam klagen -- 
  -- Schloß gehören -- schlimm Zuzeit meister -- Schlössern gehören -- 
  meister Schlöss gehört Familie -- kommen Vater Sohn -- kennen Herr Leute Jugend -- Leute Vater -- 
  Schloß nämlich früh Hand Ritter -- deutsche nennen -- -- befehlen -- nennen Komtur -- 
  Oberen wechseln -- Sachsenland Schwabenland -- Anhänglichkeit -- bringen Brauch Art Land -- 
  eigentlich Polen preußenland Heide streiten -- -- obgleich eigentlich geistlich Ritter -- gewöhnen fast heidnisch Leben gehen Mensch -- Gott Himmel -- heimkamen -- meinen -- Heidenland -- treiben gleich Leben fort -- 
  -- Schatten lustig leben wüsten Land blutig streiten -- -- Wunde heilen -- Leib stärken müssen -- kommen Gut -- Orden -- Gesellschaft Ritter nennen -- Deutschland Schweiz besitzen -- tun Art -- wohlgefiel -- 
  wüstesen Han Stoffeln Schwabenland -- zugetragen -- wissen Vater Sohn vererbet -- 
  Hans Stoffeln fallen -- hinten Bärhegenhubel Schloß bauen -- -- -- wild Wetter geben -- Schloßgeister Schatz sonnen sehen -- stehen Schloß -- 
  bauten Ritter Schlösser Straße -- Wirtshäuser Straße bauen -- beide -- Leute plündern -- verschieden Weise freilich -- 
  Ritter wild -- wüst Hubel Einöde Schloß -- wissen -- -- -- Bauer -- Schlos gehören -- müssen bauen -- 
  Ritter fragt Jahreszeit geboten Werk -- Heuet -- Ernte -- Säet -- 
  Soundso Zug müssen fahren -- soundso Hand müssen arbeiten -- letzter Ziegel decken -- letzter Nagel schlagen -- 
  schenkt Zehntgarbe -- Mäße Bodenzins -- Fasnachthuhn -- Fasnachtei -- Barmherzigkeit kennen -- Bedürfnis arm Leute kennen -- 
  ermuntert heidnisch Weise Schlägen Schimpfen -- müde -- langsam rührt ruhen -- Vogt Peitsche -- weder alt Schwachheit verschonen -- 
  wild Ritter -- Freude dran -- Peitsche knallen -- treiben Schabernack Arbeiter -- Arbeit mutwillig verdoppeln -- sparen Freude Angst -- Schweiß -- 
  Schloß fertig -- Ellen dick Maur -- wissen -- stehen -- Bauer froh -- stehen -- stehen müssen -- letzter Nagel schlagen -- letzter Ziegel -- 
  wischt Schweiß Stirn -- sehen betrübt Herz Besitztum -- sehen seufzend -- unselig Bau zurückgebracht -- 
  lang Sommer Gott -- fassen Mut kräftig Pflug trösten Weib Kind -- schwer Hunger gelitt -- Arbeit Pein scheinen -- 
  Pflug Feld führen -- Botschaft -- Hofbau Abends bestimmt Stunde Schloß Sumiswald einfinden -- 
  bangten hoffen -- 
  freilich gegenwärtig Bewohner Schlosses genießen -- laut Mutwille Härte -- dünken billig -- Herr tun unerhört Frondienst -- dünken -- meinen -- dünk Herr selb Abend Geschenk Nachlaß verkünden -- 
  finden bestimmt Abend zeitig klopfend Herz -- müssen warten Schloßhofe -- Knecht Gespött -- 
  Knecht Heidenland -- 
  zudem -- jeder halbbatzig Herrenknechtlein meinen -- gesessen Bauer verachten verhöhnen -- 
  Rittersaal entboten -- öffnet schwer Türe -- drinnen sitzen schwer Eichentisch schwarzbraun Ritter -- wild Hund Füßen -- obenan Stoffeln -- wild -- mächtig Mann -- Kopf doppelt Bernmäß -- Auge Pflugsräder Bart alt Löwenmähne -- 
  gerne hinein -- stoßen -- 
  lacht Ritter -- Wein Humpen spritzen -- wütend stürzt Hund -- zitternd -- zagend Glied sehen -- -- gehören jagend Wilde -- 
  Bauer zumute -- dünken -- daheim sein -- drücken -- 
  hund Ritter schwiegen -- erheben Stoffeln Stimme -- tönt hundertjährig Eich -- 
  > Schloß fertig -- fehlen -- Sommer -- droben Schattengang -- 
  Monat sollen Pflanze -- sollen hundert ausgewachsen Buche nehmen Minneberg Ästen Wurzel sollen pflanz Bärheg -- einzig Buch fehlen -- büßen Blut -- 
  drunter stehen Trunk Imbiß -- Buch Bärheg stehen -- 
  < Trunk Imbiß hören -- meinen -- Ritter gnädig gelaunt beginnen reden notwendig Arbeit Hunger Weib Kind Winter -- Sache -- 
  beginnen Zorn Ritter Kopf groß groß schwellen -- Stimme brechen Donner Fluh -- -- gnädig -- übermütig -- 
  Polenlande nackt Leben -- küss Fuß -- Kind Rind -- Dach Fach -- 
  > Gehorsamer Genügsamer machen -- Hans Stoffeln -- Monatsfrist hundert Buche stehen -- lassen peitschen -- Fingerlang -- Weiber Kind werfen Hunde -- 
  < wagt Einred -- begehren Trunk Imbiß -- drängt -- zornig Befehl geben -- Türe hinaus -- gerne -- weithin folgt Ritter donnernd Stimme -- Ritter Gelächter -- Knechte Spott -- Rüden Geheul -- 
  Weg beugen -- Schloß sehen -- setzen Weg Rand weinen bitterlich -- Trost -- Mut recht Zorn -- Not Plage Mut auslöschen -- Kraft Zorne -- Jammer -- 
  Stunde wild Weg Buche führen Ast Wurzel steil Berg hinauf -- Berg wachsen schön Buche -- müssen stehen lassen -- 
  Monatsfrist Werk geschehen -- -- Baum schleppen durch Tal -- steil Berg ermattet Vieh -- 
  Maimond -- Bauer rühren Acker -- fast Nacht verlassen -- Brot Speise Winter -- 
  ratlos weinen -- ansehen -- Jammer sehen -- seinig Zusammenschlug -- heimdurft Botschaft -- Jammer heimtrag Weib Kind -- stehen plötzlich -- wissen -- woher -- Dürre grün Jägersmann -- 
  kecken Barett schwanken rot Feder -- schwarz Gesicht flammen rot Bärtch -- gebogen Nase zugespitzen Kinn -- fast unsichtbar Höhle überhangend Gestein -- öffnet Mund fragen -- > -- gut Leute -- sitzet heulet -- Stein Boden sprengen Äste Bäumen -- 
  < zweimal fragen -- zweimal erhalten Antwort -- 
  schwärz grüne schwarz Gesicht -- Röter rot Bärtch -- scheinen knistern spretzeln Feuer Tannenholz -- Pfeil spitzt Mund -- auseinander fragen Holdselig Mild -- > -- gut Leute -- helfen -- dasitzeen heulet -- 
  können heulen -- Sündflut eu Geschrei Stern Himmel sprengen -- wahrscheinlich helfen -- 
  Leute fragen -- hättet -- Leute -- -- helfen können -- sollten -- heul -- Antwort vernünftig Wort reden -- hülfen -- 
  < schüttelt alt Mann weiß Haupt sprechen -- 
  > Haltet ungut -- -- worüber weinen -- nehmen Jägersmann -- Herz Jammer verschwollen -- Wort -- 
  < schütteln spitzig Haupt grüne sprechen -- 
  > Vater -- reden dumm -- -- 
  schlagen -- -- Stein Baum -- Ton -- Klaget -- 
  Mensch klagen -- klagen -- klagen -- helfen gut -- 
  Jägersmann -- wissen -- daheim tüchtig Gespann -- Holz stein Buche Tanne führen -- 
  < arm Bau Wort Gespann hören -- fallen Herz -- Hoffnungsfunk -- Auge sehen -- alt Mund -- sprechen -- -- sagen -- Herz -- anhören -- -- helfen können -- wollen Hehl -- 
  schwer gelitt Schloßbau -- Hauswesen Herrschaft -- bitterlich Mangel -- 
  frisch aufgeatmet Meinung -- frei Hand Arbeit -- neu Mut Pflug Feld führen -- soeben Komtur befohlen -- Minneberg gewachsen Buche Monatsfrist Schloß Schattengang pflanzen -- 
  wüßten -- vollbring Frist abgekarrt Vieh -- vollbrächen -- hülfen -- 
  Anpflanze können müssen nachher Hunger sterben -- Fall hart Arbeit töten -- 
  Botschaft dürfen Heimtrag -- möchten alt Elend Jammer schütten -- 
  grüne mitleidig Gesicht -- heben drohend -- mager -- schwarz Hand Schloß empor vermaß schwer Rache Tyrannei -- 
  wollen helfen -- 
  Gespann -- kein Land -- sollen Kilchstalde weg -- diesseits Sumiswald -- Buche -- dorthin bringen vermöchen -- Bärheg führen -- zuleiben -- Ritter trotz gering Lohn -- 
  horchen hochauf arm Mann unerwartet Anerbiet -- 
  Lohn einig -- retten -- Kilchstald Buche führen -- Landarbeit versäumen zugrunde gehen -- 
  alte -- 
  > sagen -- verlangst -- Handel einig -- 
  < grüne pfiffig Gesicht -- knistert Bärtch -- Schlangenaug funkelt Auge -- greulich lachen stehen Mundwinkeln -- Voneinandertat -- > -- begehr -- ungetauft Kind -- 
  < Wort zucken Mann Blitz -- Decke fallen Auge -- Spreu Wirbelwinde stoben auseinander -- 
  lachen Hellauf grüne -- Fisch Bach bargen -- Vögel Dickicht suchen -- grausig schwanken Feder Hute -- auf niederging Bärtch -- 
  > Besinnet Suchet euren Weiber Rat -- Nacht finden -- 
  < -- rufen Fliehenden scharf tönend Stimme -- Wort Ohr hängenblieben -- Pfeil Widerhak hängenbleiben Fleisch -- 
  Blaß zitternd seel Gliedern stäuben Mann Haus -- -- Hals drehen -- Gut Welt -- 
  verstört Mann dahergestoben kommen Taube -- Vogel jagen -- Taubenschlag -- drang Schrecken Haus -- bebt Kunde -- Mann Glied durcheinanderwarf -- 
  zitternd Neugierde schlich Weiber Mann -- Ort -- still vertraut Wort reden -- 
  müssen Mann Weib erzählen -- Schloß vernehmen -- hört Wut Fluch -- müssen erzählen -- begegnen -- antragen -- 
  Ergriff namenlos Angst Weiber -- Wehgeschrei ertönt Berg Tal -- -- Kind Ruchlose begehren -- 
  einzig Weib schreien -- 
  grausam handlich Weib -- Lindauerin -- Hofe gewohnen -- 
  wild -- schwarz Auge fürchten Gott Mensch -- 
  böse -- Mann Ritter rundweg begehren abschlagen -- dabeisein -- sagen -- -- 
  grüne hören Antrage Mann davongestoben -- böse Schalt Mann Feigheit grüne keck Gesicht sehen -- Lohne begnügen -- Arbeit Schloß -- Seele schaden -- Teufel machen -- 
  ergrimmt Seele -- dabeisein -- -- Teufel sehen wissen -- Aussehen -- 
  weinen Weib -- redet Grimm hart Wort Mann Mann -- 
  folgend Tag -- still Gewimmer Wehgeschrei verglommen -- sitzen Mann -- suchten Rat finden -- 
  Anfangs Rede neu bitt Ritter -- bitten -- scheinen Leib Leben feil -- 
  Weiber Kind schicken Geheul Jammer -- verstummen schnell -- Weiber reden beginnen -- weiber Nähe -- Mann Rate sitzen -- 
  wissen Rat -- Gott Name Gehorsam versuchen -- Messe lesen lassen -- Gott Beistand gewinnen -- Nachbaren nächtlichen geheim Hülfe ansprechen -- offenbar Herr erlauben -- teilen -- Hälfte Buche schaffen -- Hälfte Hafer säen Viehes warten -- 
  hoffen -- weis Gott Hülfe täglich Buche Bärheg hinauf schaffen -- grüne reden -- denken -- verzeichnen -- 
  teilen -- rüsteten Werkzeug -- Maitag Schwelle -- sammeln Mann Minneberg beginnen gefißtem Mute Arbeit -- 
  weit Ring müssen Buche umgraben -- sorgfältig Wurzel schonen -- sorgfältig Baum -- verletzt -- Erde lassen -- 
  Himmel -- Abfahrt bereitlagen -- führen -- schwer Weg Hand Vieh gegenseitig helfen können -- 
  stehen Sonne Mittag -- Buche Walde hinaus -- stehen Berg -- Zug Sumiswald hinaus -- finden Fuß Berge -- Schloß stehen -- Buche pflanzen -- 
  -- Unster -- 
  Mißgeschick treffen -- Geschirre zerrissen -- Wagen brechen -- Pferd Ochsen fallen weigert Gehorsam -- 
  Ärger -- 
  Not bringen Immerfort Mühe -- rastlos Arbeit keucht arme -- Buch -- Buch Sumiswald hinausgeschaffen -- 
  Stoffel schalt fluchen -- Schalt fluchen -- groß Unster -- stetiger Vieh -- 
  Ritter lachen höhnen freut Zappel Bauer -- Zorn Stoffeln -- 
  lachen Stoffel neu Schloß nackt Gipfel -- 
  geschworen -- Monatsfrist müssen schön Laubgang droben -- 
  fluchen -- lacht Ritter -- wein tat Bauer -- 
  fürchterlich Mutlosigkeit erfassen -- Wagen -- Zug unbeschädigen -- Buche Stelle bringen -- Kraft erschöpfen -- 
  Nacht -- schwarz Wolke steigen -- blitzen Mal -- 
  Weg Mann setzen -- gleich Beugung Wege -- sitzen -- wissen -- 
  sitzen Hornbachbauer -- Lindauerin Mann -- Knecht -- sitzen -- 
  Buche warten -- Sumiswald -- ungestört sinn Elend -- ruhen lassen zerschlagen Glied -- 
  rasch -- fast Pfiff -- Wind pfeifen -- Kammer entronnen -- Weib -- Korb Kopfe -- 
  Christin -- Lindauerin -- Hornbachbauer Eheweib -- kommen -- Herr Feld ziehen -- 
  Weiber -- froh -- daheim -- still Geschäft beschicken -- kümmern Haus Kind -- 
  Christin wissen -- -- Rat geben -- gehen -- meinen -- 
  Speise Magd sanden -- schwer Korb Kopf nehmen Mann suchen umsonst -- bitter Wort lassen fallen -- sobald finden -- 
  unterdessen müßig -- reden schaffen gleich -- 
  stellen Korb -- decken Kübel -- Hafermus -- legen Brot Käse zurecht stecken Mann Knecht Löffel heißen zugreifen -- speislos -- 
  fragt Mann Tagewerk wieviel schaffen -- 
  Hunger Wort Mann ausgehen -- griff Löffel -- Antwort -- 
  leichtfertig Knechtlein -- gleichgültig -- regne Sonnenschein Ernte -- umgehen Lohn Essenszeit essen Tisch -- greifen Löffel berichten Christine -- Buch pflanzen gehen -- Verhext sein -- 
  Schalt Lindauerin -- eitel Einbildung Mann Kindbetterinn -- schaffen Weinen -- hocken heulen Buche Bärheg bringen -- 
  widerfahren -- Ritter Mutwille ausließen -- weib Kind Wille müssen Sache Hand nehmen -- 
  plötzlich Achsel Weibe schwarz Hand -- gellend Stimme rufen -- > -- -- 
  < mitten stehen grinsend Gesicht grüne -- lustig schwankt rot Feder Hute -- 
  heben Schreck Mann dannen -- stoben Halde Spreu Wirbelwinde -- 
  Christin -- Lindauerin -- fliehen -- erfahren -- Teufel leibhaftig kriegen -- Wand Mal -- 
  bleiben stehen bannen -- müssen schauen rot Feder Barett rot Bärtch lustig auf niederging schwarz Gesicht -- 
  Gellend lacht grün Mann -- Christine zärtlich Gesicht fassen höflich Gebärde Hand -- 
  Christin wegziehen -- entrinnen grüne -- -- zisch Fleisch glühend Zange -- 
  schön Wort beginnen reden -- Wort zwinkeren lüstern rot Bärtch -- 
  schön Weibche sehen -- -- Herz lach Leib -- zudem gerne mutig -- lieb -- stehenbleiben dürfen -- Mann davonliefen -- 
  reden -- Christine grüne schreckhaft -- 
  reden -- denken -- wissen -- davonlaufen -- Wüstere sehen -- 
  Gedanke -- lassen -- reden wissen -- täte Gefallen -- übertölpeln Mann -- 
  wissen -- fahren grüne fort -- scheu -- Mensch -- grob -- müssen wundern -- Leute täte -- liebsn -- 
  fassen Christine Herz antworten -- 
  erschreck Leute -- schrecklich -- 
  ungetaufen Kind verlangen -- Lohn reden -- kommen Leute verdächtig -- Kind Mensch -- ungetaufen einer Hand geben -- Christ -- 
  > Lohn -- gewohnen -- fahren -- fragen Kind -- kennen -- 
  jung liebsn weg -- Freude Mühe -- 
  jüng -- Kind erziehen Manier -- bringen -- Taufe nötig -- 
  < Christine -- Lohn begnügen -- wachsen Gedanke -- 
  einzig -- Betrüg -- 
  -- 
  verdienen wollen -- müssen Lohne begnügen -- geben können -- gegenwärtig Haus ungetaufen Kind -- Monatsfrist geben kein -- müssen Buche liefern -- 
  schwänzelen höflich grüne -- > begehr Kind voraus -- 
  sobald versprechen -- liefern ungetaufen -- gebären -- zufrieden -- 
  < gefiel Christin -- 
  wissen -- geraum Kind geben Herr Gebiet -- 
  grün Versprechen halten Buche pflanzen -- brauchen geben -- weder Kind anderer -- lasse Messe lesen Schutz Trutz lach tapf grüne -- dachen Christine -- 
  danken Herzhaft Anerbiet -- Bedenken wollen Mann reden -- 
  > < -- grüne -- > weder denken reden -- 
  bestellen -- Bescheid -- Ort bloß -- 
  mußt zu- absagen -- nachh Handel wissen -- 
  < Christine Sache verdrehen -- gerne -- sogar gerne zärtlich -- Stündigung erhalten -- grüne auflegen -- wanken -- > -- 
  < -- 
  sobald Handel schließen einzig Kind -- wollen Nacht soviel Buche Bärheg führen -- Mitternacht unten Kirchstalde liefern -- Empfang nehmen -- 
  > -- schön Frau -- bedenken -- 
  < grüne klopfen Christine holdselig Wange -- 
  klopfen Herz -- Mann hineingestoßen -- Hintendrein Schuld geben -- 
  drängen -- Mann Sündenbock -- Glaube verlassen -- listig grün Einfall -- lang Nase abspeisen -- 
  Christin -- 
  Person wollen zusagen -- Mann -- vermögen sollen entgelten lassen -- 
  Versprechen -- -- können -- hinlänglich zufrieden -- grüne -- 
  schauderen Christine Leib Seele -- -- meinen -- kommen schrecklich Augenblick -- Blut Blute grün Akkord unterschreiben müssen -- 
  grüne leichtlich -- hübsch Weiber begehr Unterschrift -- Kuß zufrieden -- 
  somit spitzen Mund Christines Gesicht -- Christine fliehen -- wiederum bannen -- Steif starr -- 
  berührt spitzig Mund Christines Gesicht -- -- spitzig Eisen Feuer Mark Bein fahren -- Leib Seele -- gelb Blitz fahren zeigen Christine freudig verzerren grüne teuflisch Gesicht -- Donner fahren -- Himmel zersprungen -- 
  Verschwunden grüne -- Christine stehen versteinern -- tief Boden hinunt Fuß Wurzel treiben schrecklich Augenblick -- 
  Glied mächtig -- Gemüte brausten sau -- mächtig Wasser Flut wälze turmhoh Fels hinunt schwarz Schlund -- 
  donner Wasser Stimme hören -- Christin Gedanke bewußt Tos -- donnert Gemüte -- 
  Unwillkürlich fliehen Berg hinan -- glühend fühlt Brenn Wange -- grün Mund berühren -- Rieb -- wusch -- Brand -- 
  wild Nacht -- 
  lüften Klüft heuln tost -- Geist Nacht Hochzeit halten schwarz Wolke -- Winde wild Reigen spielen graus Tanze -- Blitz Hochzeitfackel sein Donner Hochzeitsegen -- 
  Jahreszeit Nacht erleben -- 
  finster Bergestal regen Haus -- drängen schirmend Obdach -- 
  treiben Gewittersturm Angst Herd Landmann Dach -- sorgsam wachend -- solange Gewitter Himmel stehen -- Wahret hüten Haus -- 
  gemeinsam Not größ Angst Gewitter -- 
  treiben Haus -- vorbeigehen müssen -- Sturm Minneberg treiben -- -- Bärheg flüchten -- 
  Graus Nacht elend vergessend -- hören klagen groll Mißgeschick -- 
  Unglück Toben Natur kommen -- 
  Pferd Ochsen scheu -- betäuben -- Wagen zertrümmeren -- Fels stürzen -- schwer verwunden stöhnter Tiefem Schmerze -- laut schreien -- zerrissen Glied einziehen Zusammenband -- 
  Elend hinein flüchtet schauerlich Angst -- grüne sehen -- erzählten Bebend wiederholt Erscheinung -- 
  Bebend hört Menge -- Mann erzählten -- drängen weiten -- dunkel Raume Feuer -- Mann sitzen -- Wind Sparren fahren Donner Haus rolln -- schreien laut Menge meinen -- brech durch Dach grüne -- zeigen Mitte -- 
  -- Schreck verging -- alt Elend bleiben Jammer Leidenden lauter -- steigen allmählich Gedanke -- Mensch -- Not -- gerne Seele bringen -- 
  beginnen rechnen -- wieviel wert einzig ungetaufen Kind -- vergaßen -- Schuld Seele tausendmal schwer wieg Rettung tausend abermals tausend Menschenleben -- 
  Gedanke allmählich laut begann misch verständlich Wort Schmerzensgestöhn Leidenden -- 
  fragen näh grüne -- grollt -- Rede gestehen -- nehmen -- fürcht -- tun Mensch -- 
  Tal helfen -- Herz Ort -- 
  beginnen Mann entschuldigen -- 
  sagen -- Teufel spaßen lassen -- -- Ohr Leihe -- Kopf geben müssen -- reden grüne schrecklich Gestalt -- Flammenbarte -- feurig Feder Hute -- Schloßturme -- schrecklich Schwefelgeruch -- ertragen -- 
  Christines Mann -- gewöhnen -- Wort Zustimmung Frau Kraft erhalten -- -- Frau fragen -- können sagen -- aushalten -- kuraschiert Weib -- wüßten -- 
  sehen Christin -- -- 
  Rettung denken -- trocken sitzen -- meinen -- säßen -- 
  fallen -- Christin schrecklich Augenblick sehen -- Haus kommen -- 
  beginnen Mann jammern -- -- Christin helfen wissen -- 
  plötzlich Türe -- Christine stehen mitten -- Haar trieft -- rot Wang -- Auge brannen dunkel unheimlich Feuer -- 
  Teilnahme -- Christine gewohnen -- empfangen -- erzählen -- denken Kummer -- 
  Christin -- bedeuten -- verbergen innerer Glut spöttisch Wort -- werfen Mann übereilt Flucht arm Weib bekümmert umgesehen -- grüne beginnen -- 
  brechen Sturm Neugierde -- wissen -- grüne anfangen -- Hinterst heben hochauf -- hören Frau nah sehen -- grüne nahe gestehen -- 
  sagen -- meinen Christin -- verdienen -- Fremde übel plagen Tale -- Weiber Übel Name anhängen -- Mann allenthalben Stiche lassen -- sinnn Mut -- weder Trost Ausweg -- 
  redet Christine -- werfen hart Wort Weiber -- glauben -- Bodensee groß Schloßteich -- anhalten -- Härter scheinen stützen -- -- sagen -- übel ausleg -- Sache kommen -- -- kommen Übel -- lüde Schuld Verantwortung -- 
  Versammlung Christine Knien liegen Bitte Fleh verwundeter laut aufschrien Anhielt -- scheinen Christin erweichen beginnen erzählen -- standgehalt grüne Abred treffen -- Kuß -- -- Wang brannen Getost Gemüte -- 
  erzählen -- seither gesinnt verschlagen Gemüte -- 
  Wichtigste -- Buche Bärheg schaffen -- -- können sehen -- wollen -- Hauptsache -- -- soviel -- Kind gebären -- 
  laufen kalt Rücken Erzählung -- sehen können -- wollen -- gefallen -- 
  jung Weibchen weinen bitterlich -- Auge Hand waschen -- sagen -- 
  alt -- ehrwürdig Weib -- hochgestalten Gesicht -- beugen fliehen müssen -- treten Mitte sprechen -- Gottvergessen handeln -- Ungewisse Gewisse stellen spielen ewig Leben -- 
  bösen einlassen -- kommen böse nimmer -- Finger geben -- behalten Leib Seele -- 
  elend können helfen Gott -- verlass Not -- versinke Not -- 
  diesmal verachtet alt Rede -- schweigen heißen jung Weibche -- Wein heulen diesmal helfen -- bedürf Hülfe anderer Art -- heißen -- 
  Rätig -- Sache versuchen -- 
  Bös können bösest Fall -- erstemal -- Mensch schlimmsen Geist betrügen -- wüßn -- fänd Priester Rat Ausweg -- 
  finster Gemüte denken -- bekennen -- Geld umtriebe wagen ungetauft Kind -- 
  Rat Christines Sinn fassen -- -- wirbelwind Haus zusammenstießen -- He wild Jäger vorübersausten -- Posten Haus wankten -- Balken bogen -- Baum splittert Haus Speere Ritterbrust -- 
  Blaß drinnen Mensch -- Grauen überfiel -- Rat lösen -- grauendem beginnen Ausführung -- 
  schön hell -- Gewitter Hexenwerk verschwinden -- Äxte hieben scharf -- Boden locker -- Buch fallen -- -- Wagen brechen -- Vieh willig stark Mensch schützen Unfall unsichtbar Hand -- 
  sonderbar -- 
  unterhalb Sumiswald führen Weg hintern Tal -- Sumpf -- zügellos grüne bewässern -- müssen Stalden durch Dorf fahren Kirche vorbei -- 
  fahren früh Zug -- helfen Rat -- Kraft Vieh -- Sumiswald fahren -- außerhalb Dorf Kirchstalden -- Kapelle stehen -- unterhalb eben Weg Buche ablegen -- 
  sobald Stalden eben Weg Kirche kommen -- Gewicht Wagen leicht -- schwer schwer -- müssen Tier vorspannen -- -- müssen unmenschlich schlagen -- müssen Hand Speiche legen -- scheuten sanftest Ros -- Unsichtbarer Kirchhofe Weg stehen -- dumpf Glockenton -- fast verirrt Schall fern Totenglocke -- Kirche -- eigentümlich grauen stark Mann ergreifen jedesmal Mensch Tier bebten -- Kirche -- 
  vorbei -- ruhig fahren -- ruhig abladen -- ruhig frisch Ladung -- 
  Buche laden selbigen Tag nebeneinander abgeredet Stelle -- Buche folgend Bärheg pflanzen -- durch Tal Achse gehören -- umgedrehen Spule -- Fuhrleut üblich Geschrei -- Pferd Wieher -- Ochsen einförmig Gebrüll -- 
  Buche stehen -- sehen -- -- Buche -- unten Stald hinlegen -- -- 
  Staun Tale -- Neugierde regen männiglich -- 
  absonderlich Ritter Wunder -- Pacht Bauer schließen Weise Buche Stelle schaffen -- 
  gerne heidnisch Weise Bauer Geheimnis ausgepreßen -- 
  sehen -- Bauer wüßen -- halb erschrocken -- 
  zudem wehren Stoffel -- 
  gleichgültig -- Buche Bärheg kommen -- Gegenteil -- Buche heraufkamen -- gerne -- Bauer schonen -- 
  sehen -- Spott Ritter Unbesonnenheit verleiten -- Bauer zugrunde gehen -- Feld unbestellt bleiben -- Herrschaft groß Schaden -- -- Stoffel -- bleiben -- 
  Erleichterung -- Bauer verschaffen -- gleichgültig -- Seele verschreiben -- gehen Bauer Seele -- Tod Leiber nehmen -- 
  lacht Ritter schützt Bauer Mutwille -- 
  Handel ergründen sandt Knappe Wache -- finden Morgen halb tot Gräben -- wohin unsichtbar Hand schleudern -- 
  ziehen Ritter Bärheg -- 
  kühn Deg -- Wagnis bestehen Heidenland -- bestehen -- 
  finden erstarren Boden -- Rede mächtig -- sagen -- rot Ritter feurig Lanze niedergerannen -- 
  neugierig Weibsseel enthalten -- Mitternacht -- Spalte Luke Weg Tale sehen -- 
  Alsbald wehten giftig Wind -- Gesicht schwellen -- wochenlang weder Nase Auge sehen -- Mund Mühe finden -- 
  verging Leute Spähen -- Auge Tale -- Mitternacht liegen -- 
  plötzlich Mann sterben -- bedürfen letzter Trost -- Priester holen -- Mitternacht nahe -- Weg führen Kilchstalde vorbei -- 
  laufen unschuldig Bübch -- Gott Mensch leiben -- Angst Vater ungeheißen Sumiswald -- 
  Kilchstalde -- Buche auffahr Boden -- feurig Eichhörnchen ziehen -- nebenbei reit schwarz Bock grün Mann -- feurig Geißel Hand -- feurig Bart Gesicht -- Hute schwanken Glutrot Feder -- 
  Zug gefahr Lüfte Egg weg schnell Augenblick -- 
  Knabe -- -- 
  Woche vergehen -- Stunde neunzig Buche Bärheg -- machen schön Schattengang -- schlagen üppig -- einzig Verdorrt -- 
  Ritter Stoffel erging -- wehten allemal heimlich Grauen -- Sache wissen -- -- trösten -- fehl -- tragen Schuld -- 
  Bauer wohlet Buch -- -- Buch wachsen Hoffnung -- Herr genügen -- grüne betrügen -- Unterpfand -- hundertst -- fragen grüne -- 
  indessen Sache sicher -- fürchten -- spielen Schabernack lassen Stiche -- 
  Urbanustage bringen letzter Buche Kilchstalde -- alt jung schlief selber Nacht -- fast glauben -- Umstand Kind Pfand Arbeit vollenden -- 
  folgend Sonne alt jung Bein -- regen gleich neugierig Angst -- wagen Platz -- Buche liegen -- wissen -- liegen Beize -- grüne betragen -- 
  wild Küherbub -- Zieg Alp bringen -- wagen -- springen voran finden Buche -- Hinterlist Platz kund -- 
  trauen Spiel -- vorauf müssen Küherbub Bärheg -- 
  Ordnung -- hundert Buche stehen Reih Glied -- verdorren -- laufen Gesicht -- Glied weh -- 
  steigen Jubel Herz -- Spott grün Ritter fließen -- 
  drittenmal sandt wild Küherbub lassen Stoffel sagen -- Bärheg Ordnung -- Buche zählen -- 
  gräulich -- lassen sagen -- -- heimkämen -- 
  gerne sagen lassen -- Schattengang wegschaffen -- Ritter -- heißen -- fürchten -- wissen Bauer Pacht Handel mischen -- 
  Kühersbub Bescheid bringen -- schwoll Herz trotzig -- wild Jugend tanzt Schattengang -- wild Jodel halln Kluft Kluft -- Berg Berg -- hallter Maur Schlosses Sumiswald wider -- 
  bedächtig alte warnen bat -- trotzig Herz bedächtig alt Warnung -- Unglück -- alt Zag Warne herbeigezogen -- 
  -- erkennen -- Trotz Unglück Boden stampfen -- 
  Jubel ziehen Berg Tal Häuser -- Finger Fleisch rauche hing -- kochen -- Handgroß Butter Hafen -- kücheln -- 
  Fleisch gegessen -- Küchle schwand -- verronnen -- anderer steigen Himmel -- 
  nah -- Weib Kind gebären -- -- nah -- dringlich Angst -- grüne künden -- fordern -- gehören -- Beize legen -- 
  Jammer jung Weibe -- Kind gebären -- ermessen -- 
  Haus tönen wider -- ergriff Glied Haus -- Rat wissen -- -- -- einlassen -- trauen -- 
  nah verhängnisvoll Stunde -- nah drängen arm Weibch Gott -- umklammert arme -- Leib Seele ganz Gemüte heilig Mutter -- bittend Schutz gebenedeien Sohn Wille -- 
  klar -- Leben sterben Not groß Trost Gott -- -- -- dürfen böse -- 
  deutlich treten Glaube Seele -- -- Priester Herr Allerheiligst -- heilig Leib Erlöser -- Geburt zugegen bewaffnet kräftig Bannsprüche -- dürfen bös Geist nahen -- alsobald Priester neugeboren Kind Sakramente Taufe versehen -- damalig Sitt erlauben -- arm Kind Gefahr entrissen -- Vermessenheit Vater ihn bringen -- 
  Glaube steigen -- Jammer jung Weibe Herz -- scheut -- Priester Pacht Satan bekennen -- seither Beicht gehen -- Rede gestehen -- 
  fromm Mann -- Ritter Schlosses treiben Kurzweil -- Wahrheit -- 
  Sache tun -- können hindern -- Bauer denken -- gerne -- -- Gewissen -- -- 
  Drang Weibe Jammer Herzen -- laufen offenbart Priester Handel arm Weibe Wunsch -- 
  Gewaltig entsetzt fromm Mann -- leer Wort verlieren -- kühn treten arm Seele Kampf gewaltig Widersacher -- 
  -- hart Kampf scheuen -- krönen Krone ewig Leben wissen -- krönen -- kämpfe -- 
  Ums Haus -- Weib Stunde harren -- ziehen heilig Bann geweiht Wasser -- böse Geist überschreiten -- segnet Schwelle -- Stube -- ruhig gebar Weib -- ungestört tauft Priester Kind -- 
  Ruhig bleiben draußen -- klar Himmel flimmern hell Stern -- leis Lüfte spielen Bäum -- 
  wiehernd Gelächter gehören ferne -- meinen -- Käuzlein Wald Saum -- 
  -- -- freuen höchlich -- Angst verschwinden -- -- meinen -- grüne angeführen -- gleichen -- 
  mal zugerichten -- weith Gast entboten -- 
  Umsonst mahnen Priester Herr Schmaus Jubel -- mahnen -- zag beten -- Feind besiegen -- Gott sühnen -- 
  Geist -- dürfen Buße Sühnung auferlegen -- nah Buße gewaltig schwer Gott selbsteigen Hand -- 
  hören -- befriedigen Speise Trank -- 
  betrüben Weg -- bitten -- wüßten -- tun -- rüsten -- Bete Faste kämpfen getreu Hirte anvertraut Herde -- 
  mitten Jubilierenden Christin sitzen -- sonderbar still glühend Wang -- düstern Auge -- seltsam zuck Gesicht -- 
  Christine Geburt zugegen erfahren Wehmutter -- plötzlich Taufe Gevatter stehen frech Herz Furcht -- Priester Wasser sprengen Kind taufen hoch Name -- -- drücken plötzlich feurig Eisen Stelle -- grüne Kuß empfangen -- 
  jäh Schrecken zusammengezucken -- Kind fast Erde fallen -- seither Schmerz abnehmen -- glühend Stunde Stunde -- 
  Anfangs stillgesessen -- Schmerz erdrücken heimlich schwer Gedanke gewälzt erwacht Seele -- häufig fahren Hand brennend Fleck -- giftig Wespe sitzen scheinen -- glühend Stachel bohr Mark hinein -- 
  Wespe verjagen -- Stiche heiß -- Gedanke schrecklich -- beginnen Christin Wange zeigen -- fragen -- sehen -- neu fragt Christin -- -- späh Wang Lust verkürzen -- 
  alt Weib erbitten -- kräht Hahn -- graut -- alt Christines Wange fast unsichtbar Fleck -- 
  -- -- vergehen -- -- 
  Christin tröst -- vergehen -- Pein -- unmerklich wachsen Punkt -- sehen fragen -- Schwarz geben Gesicht -- 
  denken -- Rede fahren Stiche Herz -- wecken schwer Gedanke -- müssen denken -- gleich Fleck grüne küßen gleich Glut -- Blitz Gebein fahren -- bleibend brennen Zehre -- 
  weichen Schlaf -- Essen schmeckt Feuerbrand -- unsten laufen hierhin -- dorthin -- suchen Trost finden -- Schmerz wachsen -- schwarz Punkt groß schwärz -- einzeln dunkel Streife laufen -- Mund scheinen rund Fleck Höcker pflanzen -- 
  litt laufen Christin lang Nacht Mensch Angst Herzen offenbaren grün Stelle erhalten -- wissen -- Weise Pein loswerden -- Himmel Erde opfern -- 
  Natur vermess Weib -- erwilden wütendem Schmerze -- 
  geschehen -- wiederum Weib Kind erwarten -- 
  diesmal Angst -- Leute wohlgemut -- sobald Priester sorgen -- meinen -- grüne spotten -- 
  Christin -- 
  näh Geburt -- desto schrecklich Brand Wange -- desto mächtig dehnt schwarz Punkt -- deutlich Bein strecken -- kurz Haar treiben empor -- glänzend Punkt Streifen erscheinen Rücken -- Kopfe Höcker -- glänzend giftig blitzt Auge hervor -- 
  laut schri -- giftig Kreuzspinn sehen Christines Gesicht -- voll Angst Grauen fliehen -- sehen -- fest sitzen Gesicht herausgewachsen -- 
  Allerlei reden Leute -- raten -- anderer -- Christine gönnen -- -- wichen flohen -- -- 
  Leute fliehen -- desto treiben Christin -- fahren Haus Haus -- fühlen -- Teufel mahnen verheißen Kind -- Opfer Leute einzured unumwunden Wort -- fahren Höllenängste -- 
  kümmern -- Christine peinigen -- weh -- litt -- Meinung verschulden -- entrinnen -- sagen -- 
  > sehen -- 
  Kind verheißen -- einer -- 
  < wütender Rede setzen Manne -- 
  fliehen -- fliehen -- sprechen Christine kaltblütig -- gut -- Malzeich -- Mensch -- auswachsen -- hören Schmerz abzubinden -- 
  unterdessen hören Schmerz -- jeder Bein Höllenbrand -- Spinne Leib Hölle -- Weibe erwartet Stunde -- Christin -- umwall Feuermeer -- wühlt feurig Messer Mark -- fahren feurig Wirbelwind Gehirn -- 
  Spinne schwellen -- bäumt -- kurz Borst hervor quoll giftig Auge -- 
  Christin glühend Pein nirgends Teilnahme -- Kreißende bewachen finden -- stürzen Wirbelsinnig Weg entlang -- Priester müssen -- 
  Raschen Schritt Halde entlang -- begleiten handfest Sigrist -- heiß Sonne steil Weg hemmen Schritt -- gelten -- Seele retten -- unendlich Unglück wenden -- entfernt kranke kommend -- bangt Priester schrecklich Säumnis -- 
  Verzweifelnd werfen Christine Weg -- umfaßt Knie -- bitten Lösung Hölle -- Opfer Kind -- Leben kennen -- Spinne schwellen hoch -- funkeln schrecklich schwarz Christin rot angelaufen Gesicht -- gräßlich Blick glotzt Priester heilig Gerät Zeichen -- 
  schieben Christine rasch Seite schlagen heilig Zeichen -- Feind -- lassen Kampf -- Seele retten -- 
  Christine fahren -- stürmen versuchen Äußerste -- Siegristen stark Hand halten wütend Weib Priester -- Haus schützen -- geweiht Hand Kind empfangen Hand legen -- Hölle überwältigen -- 
  draußen unterdessen Christin schrecklich Kampf kämpfen -- 
  Kind ungetaufen Hand -- hinein Haus -- stark Mann wehrn -- 
  Windstöße stieß Haus -- fahl Blitz umzingelen -- Hand Herr -- Kind taufen -- Christine umkrei vergeblich machtlos Haus -- 
  wilderer Höllenqual ergreifen -- stoßen Ton -- Tön glich Menschenbrust -- Vieh schlotteren ställen reißen Strick -- Eich Walde rauschen -- entsetzend -- 
  Haus beginnen Jubel Sieg -- grüne Ohnmacht -- Helfershelferin vergeblich Ringen -- draußen liegen Christin -- entsetzlich Pein Boden werfen -- Gesicht beginnen Wehe kreißen -- Wöchnerin erfahren Erde -- Spinne Gesichte schwellen hoch brannt glühend Gebein -- 
  Christin -- plötzlich Gesicht platz -- glühend Kohle gebären -- lebendig -- gramselt Gesicht weg -- Glied weg -- lebendig glühend gramsle Leib weg -- 
  Blitz fahl Schein langbeinig -- giftig -- unzählbar schwarz spinnchen laufen Glied -- hinaus Nacht -- Entschwunden laufen langbeinig -- giftig -- unzählbar -- 
  früh Folge -- Brand Gesicht legen -- Spinne lassen nieder -- fast unsichtbar Punkt -- schaut erlöschend Auge Höllenbrut -- gebären ausgesandt Zeichen -- grüne spaßen lassen -- 
  Matt -- Wöchnerin -- schlich Christin Haus -- Glut heiß brannt Gesicht -- Glut Herzen abnehmen -- matt Glied Ruhe sehnten -- grüne lassen Ruhe -- -- -- 
  Drinn Haus -- jubeln freuen hören -- Vieh brüllt tobt Stalle -- 
  fahren -- -- nachzuseh -- Schreckensblaß kommen -- gehen -- bringen Kunde -- schön Kuh liegen tot -- übrig toben wütet -- sehen -- 
  -- Absonderliches walen -- 
  verstummt Jubel -- laufen Vieh -- Gebrüll erscholl Berg Tal -- Rat -- 
  Zauber versuchen weltlich geistlich Kunst -- umsonst -- -- graut -- Tod sämtlicher Vieh Stalle strecken -- 
  Stumm -- beginnen brüllen brüllen -- -- hören -- ställ Not brechen -- wehelich Vieh Meister Hülfe rufen grausen Angst -- 
  Flamm dach schlügen -- eilen heim -- Hülfe bringen -- strecken Tod Vieh -- Wehgeschrei Mensch Tier erfüllen Berg Tal -- Sonne -- Tal fröhlich verlassen -- entsetzlich Jammer hinein -- 
  Sonne scheinen -- sehen Mensch -- Ställe -- Vieh fallen -- wimmle zahllos schwarz Spinn -- 
  kroch Vieh -- Futter -- berühren -- vergiften -- lebendig -- beginnen toben -- Tod strecken -- 
  spinn Stall -- -- säubern -- -- wüchsen Boden herauf -- Stall -- -- behüten -- unversehens kroch Wand -- fallen haufenweise Diel -- 
  treiben Vieh Weide -- treiben Tod Rachen -- 
  -- Kuh Weide Fuß setzen -- beginnen lebendig Boden -- schwarz -- langbeinig Spinn sproßten -- schrecklich Alpenblume -- kroch Vieh -- fürchterlich wehelich Geschrei erscholl Berg nieder Tale -- 
  Spinne sehen Spinne Christines Gesicht ähnlich Kind Mutter -- sehen -- 
  Geschrei arm Tier Schlos dringen -- kommen Hirt -- verkündend -- Vieh gefall giftig Tier -- höherem zorne vernehmen Stoffel -- Herde Herde verlorengehen -- vernehmen -- Pacht grüne -- Mal betrog Spinne ähnlich -- Kind Mutter -- Spinne Lindauerin Gesicht -- grün Bund alleine Bericht geben -- 
  riten Stoffel grimmem Zorn Berg hinauf donnert arme -- ihretwill Herde Herde verlieren wollen -- schädigen -- müssen ersetzen -- versprechen -- müssen halten -- freiwillig tun -- müssen tragen -- 
  Schaden leiden ihretwegen wollen -- leiden -- müssen büßen tausendfältig -- 
  können vorsehen -- 
  redet -- unbekümmert -- zumuten -- treiben -- fallen -- tun -- rechnen -- 
  meisten aufgedämmeren -- Spinnen Plage bösen -- Mahnung -- Pacht halten -- Christine Näheres wissen müssen -- -- grüne verhandeln -- 
  zittert grüne -- lachen -- zittert weltlich Herr -- befriedigt -- geistlich Herr -- erlauben -- Buße -- 
  Angst versammelt Angesehenst einsam Scheuer -- Christine müssen klar Bescheid geben -- eigentlich verhandeln -- 
  Christin -- verwildern -- rachedurstig -- auf wachsend Spinne foltern -- 
  Zag Mann Weiber -- erzählen Punktum -- begegnen -- grüne schnell Wort nehmen Pfande Kuß geben -- achten -- selbig Fleck Spinne wachsen Höllenpein Augenblick -- Kind taufen -- Spinn -- Kind taufen grüne narren -- höllenweh Spin gebären ungemeßen Zahl -- narren lassen ungestraft -- fühlen tausendfach Todesschmerze -- 
  wachsen Spinne -- Pein mehrere -- nächster Kind grüne -- wissen -- gräßlich einbrechend Plage -- gräßlich Ritter Rache -- 
  erzählt Christine -- Herz Mann bebten -- reden -- 
  kommen angstgepreßt Kehle abgebrochen Laute hervor -- zusammensetzen -- meinen -- Christine meinen -- einzeln Einwilligung geben Rat -- 
  stehen redet deutlich -- gute schiene -- Christin totzuschlagen -- tot -- grün tote halten -- Handhabe Lebendig -- 
  lacht Christin wild -- treten Gesicht -- 
  sollen zuschlagen -- -- grüne wollen -- ungetaufen Kind -- zeichnen -- ebensogut können Hand zeichnen -- vergreifen -- 
  zucken Mann Hand -- reden -- setzen hören schweigend Rate -- 
  abbrechen -- -- -- bedeuten -- überein -- nächster Kind opfern -- Hand bieten -- Kind Kilchstalde tragen -- Buche hinlegen -- 
  -- meinen -- Teufel brauchen -- scheuen -- persönlich Bekanntschaft -- begehrten -- 
  erbieten Christine willig -- Teufel -- zweitenmal schaden -- 
  wissen -- nächster Kind gebären -- redet -- Vater zugegen -- 
  Verständigt Wort -- auseinander -- 
  jung Weib -- grauenvoll Nacht -- Christine Bericht grüne bringen -- zagen weinen -- wissen -- -- erwartet nächster Kind -- 
  früh Vorgang machen getrost zuversichtlich -- unnennbar Angst liegen Herz -- weder Bete Beichte wegbrehen -- 
  verdächtig schweigen scheinen ihns umring -- sprechen Spinne -- verdächtig schien Auge -- ruhen -- scheinen berechnen Stunde -- Kindes habhaft -- Teufel versöhnen können -- 
  einsam verlassen fühlt unheimlich -- Beistand Schwiegermutter -- fromm Frau -- stehen -- vermögen alt Frau wild Menge -- 
  Mann -- versprechen -- jammert Vieh gedacht arm Weibe Angst -- 
  Priester verheißen -- schnell früh -- verlangen -- begegnen Augenblick -- gesandt -- -- arm Weib zuverlässigen Boten Mann -- Schutz Wache -- arm Weibche wohnen Christine Haus -- Mann Bruder -- verwandte -- Waise Haus kommen -- 
  arm Weibe Herzensangst denken -- Bete fromm Mutter finden Vertrauen -- alsobald Schwand -- sobald böse Auge -- 
  unterdessen Krankheit -- unterhalten Schrecken -- 
  freilich -- hie fallen Stück -- zeigen Spinne -- 
  sobald Schreck nachlassen -- sobald irgendeiner denken -- übel lassen -- Bedenken -- ehe Kind versündig -- flammen Christines Höllenpein -- Spinne blähte hochauf -- -- denken reden -- kehren neu Wut Tod Herde -- 
  -- näh erwartet Stunde -- scheinen Not zuzunehmen -- erkannt -- bestimmt Abred treffen müssen -- Kinde sicher sond Fehl bemächtigen können -- 
  Mann fürchten meisten -- Gewalt brauchen zuwider -- 
  übernehmen Christin -- gewinnen -- gewinnen -- 
  Sache wissen -- weib Wille -- Priester holen -- eilen -- Abwesenheit vorgehen -- wollen fragen -- finden Gewissen -- Gott Messe abfinden -- arm Kind Seele -- denken -- gewinn fromm Priester Teufel -- Handel -- tun böser prellen -- 
  denken Mann -- jedenfalls -- mögen -- wollen -- Sache Schuld -- sobald selbsteigen Hand tätig -- 
  arm Weibche verkaufen wissen -- hoffen Bangen Rettung -- beschließen Rate Mensch Stoß Herz -- droben beschließen -- deckt Wolke -- Zukunft liegen -- 
  gewitterhaft Ernte kommen -- Kraft angespannen -- heiter Stunde Korn sicher Dach bringen -- 
  heiß Nachmittag kommen -- schwarz Häupt streckt Wolke dunkel Berg empor -- ängstlich um Dach flattert Schwalben -- arm Weibche eng bingen Haus -- Großmutter draußen Acker -- helfen Wille -- 
  zuckt Zweischneidende Schmerz Mark Bein -- dunkelt Auge -- fühlen nah Stunde -- 
  Angst treiben Haus -- schwerfällig schriten Acker -- müssen niedersetzen -- fern Stimme schicken -- beklemmt Brust -- 
  klein Bübch -- Beinchen brauchen lernen -- Bein Acker -- Mutter Arm -- 
  Bübch müssen arm Weib Boten brauchen -- wissen -- Acker finden -- Beinchen ihns tragen -- 
  treu Bübch -- Angst Mutter -- laufen fallen stehen -- Katze jagt Kaninchen -- Taube Hühner laufen Fuß -- stoßend spielend springen Lamm -- Bübch -- lassen säumen richten treulich Botschaft -- 
  Atemlos erscheinen Großmutter -- Mann säumen -- Fuder sollen ausladen -- heißen -- 
  Ewigkeit verstreichen -- -- wiederum verstreichen Ewigkeit -- langsam lang Weg -- Todesangst fühlen arm Weib -- Stunde schnell schnell nahen -- 
  Frohlockend Christine draußen Acker zusehen -- 
  Heiß brannt Sonne schwer Arbeit -- Spinne brennen fast -- scheinen Gang nächster Stunde -- 
  treiben fröhlich Arbeit eilt Heimgehen -- wissen -- langsam Bote -- 
  letzter Garbe gelad Windstöße nahend Gewitter verkünden -- eilt Christine Beute -- sichern -- meinen -- 
  Heimging -- winken bedeutungsvoll Begegnende -- nickn -- tragen rasch Botschaft heim -- schlottert Knie -- Seele beten unwillkürlich Angst -- -- 
  Drinn Stübchen wimmeren arm Weib -- Ewigkeit Minute -- Großmutter vermögen Jammer still Bete Tröst -- 
  stübch verschlossen schwer Gerät Türe stellen -- 
  solange alleine Haus -- dabeizusein -- Christin heimkommen sehen -- schleichend Tritt Tür hören -- draußen manch Tritt hören heimlich Flüstern -- Priester zeigen -- anderer treu Mensch nah nah ersehnt Augenblick treten -- denken -- Angst arm Weiber schwammen siedend Öl -- Hülfe Hoffnung -- 
  hören -- Christine Türe wich -- fühlt arm Weib wild Schwägerin feurig Auge Türe hindurch -- brannen Leib Seele -- 
  wimmeren Lebenszeichen Kind Türe -- unterdrücken schnell -- spät -- 
  Türe fliegen wütendem -- vorbereiten Stoß -- Raub Tiger stürzen -- stürzen Christine arm Wöcherin -- 
  alt Frau -- Sturm entgegenwirfen -- fallen nieder -- heilig Mutterangst raffen Wöcherin -- schwach Leib brechen -- Christin Hand Kind -- gräßlich Schrei brechen Herz Mutter -- hüllen schwarz Schatten Ohnmacht -- 
  Zag Grauen ergriff Mann -- Christin geraubt Kind herauskommen -- 
  Ahn grausen Zukunft -- Mut -- hemmen -- Furcht Teufel Plage stark Furcht Gott -- 
  Christine zagen -- glühend leuchtet Gesicht -- Sieger leuchten überstanden Kampfe -- -- Spinne sanft Jucke liebkosen -- Blitz -- Weg Kilchstalde umzüngeln -- scheinen fröhlich Licht -- donner zärtlich Grollen -- lieblich Säusel racheschnaubend Sturm -- 
  Hans -- arm Weibe Mann -- Versprechen halten -- 
  langsam Weg gehen -- bedächtig Acker beschauet -- Vogel nachgesehen -- Fisch Bach abgewarten -- sprang Mück fangen einbrechend Gewitter -- 
  jucken vorwärts -- rasch Schritt -- Ansatz Springen -- -- treiben -- Haar kopfe emportreiben -- Gewissen -- -- Vater verdienen -- Weib Kind verrat -- Liebe -- Weibe Leibesfrucht -- 
  halten anderer -- stark -- Furcht Mensch -- Furcht Teufel Liebe -- nehmen -- 
  langsam -- langsam Mensch -- letzter Gang tun -- Richtstätt -- 
  -- wissen Mensch -- letzter Gang tun -- wissen -- täte -- 
  spät -- ehe Sumiswald -- 
  schwarz Wolke jagen Minneberg -- schwer Tropfen fallen -- vermengt Staube -- dumpf beginnen Glöcklein turm Mensch mahnen -- denken möchten Gott bitten -- Gewitter Gericht lassen -- 
  Haus stehen Priester -- jeglicher Gang rüsten -- bereit -- Herr -- Haupt daherfahren -- Sterbende brennend Haus sonstwohin rufen -- 
  Hans -- erkennen Ruf schwer Gange -- schürzt Gewand sandte Botschaft läutend Sigrist -- ablösen lassen Glockenstrang einfind Begleitung -- 
  unterdessen stellen Hans Labetrunk -- wohltätig rasch Lauf schwül Luft -- Hans bedürftig -- Priester ahnt Tücke Mensch -- 
  Bedächtig laben Hans -- 
  Zögernd finden Sigrist gerne Tranke -- Hans bieten -- 
  Gerüstet stehen Priester -- verschmähend Trank -- Gang Kampf bedürfen -- 
  heißen ungern Kanne weggehen -- aufstellen -- ungern verletzt Gast -- kennen -- höh Gastrecht -- säumig trinken fahren zornig Glied -- 
  fertig -- -- bekümmern Weib harren -- grauenvoll Untat -- Weib Untat müssen stehen heilig Waffe -- säumen -- -- droben -- durst unten löschen -- 
  sprechen Hans -- harrend Weibe Mann -- eil -- Weibe gehen Sache schwer -- 
  alsobald flammen Blitz Stube -- blenden -- donner brechen über Haus -- Posten Haus -- jeder Glied Haus beben -- 
  sprechen Sigrist -- Segenspruch vollenden -- 
  > Hören -- draußen -- Himmel bestätigen -- Hans -- warten -- nützen -- gehen -- lebendig kommen Nimmer hinauf -- -- Weibe Eile -- 
  < stürmt Gewitter -- Menschengedenken erleben -- 
  schlünd Grund stürmen heran -- stürmt Seite -- Winde treiben Sumiswald -- Wolke Kriegesheer -- Wolke stürmen -- Wolke Leben -- Wolkenschlacht beginnen -- Gewitter stehen -- Blitz Blitz entbinden -- Blitz Blitz schlagen Erde nieder -- Durchgang bahn Erde Mitte Erde Seite -- 
  Unterlaß brüllen Donner -- zornesvoll heuln Sturm -- geborsen Wolke Schoß -- Flut stürzen nieder -- 
  plötzlich gewaltig Wolkenschlacht losbrach -- Priester Siegristen antworten -- niedergesetzen -- steigend bangen ergreifen -- Drang -- hinauszustürzen Element Tobe -- Gefährt zauderen -- 
  -- hören Donner schrecklich Stimme Weibe markdurchschneidend Weheruf -- 
  plötzlich donner Gott schrecklich Scheltwort Säumnis -- -- sagen -- 
  Schritt -- fassen -- hinaus feurig Wetter -- Sturme Wut -- Wolke Flut -- langsam -- unwillig kommen -- 
  sau brau toster -- Ton zusammenschmelzen letzter Posaune -- Welt Untergang verkünden -- feurig Garb fallen Dorf -- Hütte aufflammen -- Diener -- Donner Stimme Blitz Knechte -- Mitknecht gleich Herr fürchten -- Gott -- getrost Gott Wettern überlassen -- 
  Schritt Priester unerschrocken Wetter Kilchstalde -- geweiht heilig Waffe tragen -- Gott Herz -- 
  gleich Mute folgen -- gleich Ort Herz -- Kilchstalde -- Wetter -- Nacht -- Hans besonderer Grund -- -- 
  bat Priester -- umkehren -- -- Hans wissen näh -- Sigrist gut -- warnen Wasser Tale -- aufgeschwollen grüne -- 
  Priester hören -- achtet Rede -- wunderbar Drange treiben -- eilt Flügel Gebet kilchstalden -- Fuß stoßen Stein -- Auge Blitz blenden -- bebend -- decken -- meinen -- Heiligst -- Priester tragen -- folgen Hans Sigrist -- 
  hinauskam Dorf -- Tal hinunt Stald senken -- stehen Priester plötzlich still schirmen Hand Auge -- 
  unterhalb Kapelle schimmeren Blitz Schein rot Feder -- Priester scharf Auge sehen grün Hage hervorrag schwarz Haupt -- schwanken rot Feder -- 
  lang schauen -- sehen jenseitig Abhange schnellst Lauf -- jagen Wind wildest Stoß -- daherfliegen wild Gestalt dunkel Haupt -- Fahne rot Feder schwanken -- 
  lodert Priester heilig Kampfesdrang -- -- sobald böse ahnen -- -- gottgeweiht Herzens -- Trieb Samenkorn -- Leben ihns dringen -- Blume dringen -- entfalten -- Held -- Feind Schwert erheben -- 
  Lechzende Strome kühl Flut -- Held Schlacht stürzen Priester Stalden nieder -- stürzen kühnst Kampf -- drang grün Christine -- Kindlein Arm legen -- mitten hinein -- schmettern hoch heilig Name -- halten Heiligst grüne an Gesicht -- sprengen heilig Wasser Kind treffen Christine -- 
  fahren fürchterlich Wehegeheul grüne dannen -- glutrot Streife zucken -- Erde verschlingen -- geweiht Wasser berühren -- schrumpfen entsetzlich Zischen Christine Wolle Feuer -- Kalch Wasser -- schrumpfen zischend -- flammensprühend schwarz -- hochaufgeschwollen -- grauenvoll Spinne Gesichte -- schrumpfen -- Zischt hinein -- sitzen giftstrotzend -- trotzig mitt Kind sprühen Auge zornig Blitz Priester entgegen -- 
  sprengen Weihwasser entgegen -- zischen heiß Stein gewöhnlich Wasser -- größ Spinne -- strecken schwarz Bein Kind -- glotzen giftig Priester -- fassen feurig Glaubensmut kühn Hand -- 
  -- griff glühend Stachel hinein -- unerschütteren greifen fest -- schleudern Ungeziefer weg -- fassen Kind eilen sond Weile Mutter -- 
  Kampf -- stillt Kampf Wolke -- eilten dunkel Kammer -- flimmert still Sternenlicht Tal -- zuvor wilde Schlacht toben -- fast atemlos ereilt Priester Haus -- Mutter Kind Freveltat begehen -- 
  Mutter ohnmächtig -- gellend Schrei Leben fortgesenden -- sitzen betend alt -- traut Gott -- mächtig Teufel böse -- 
  Kind bringen Priester Mutter Leben -- 
  erwachend Kindlein -- durchfloß Wonne -- Engel Himmel kennen -- Mutter arme taufen Priester Kind Name Gott Vater -- Sohn heilig Geist -- entreissen Teufel Gewalt -- freiwillig übergeben -- 
  hüten Gott -- Gewalt Seele übergeben -- Leib Spinne vergiften bleiben -- 
  schied Seele -- Brandflecko Leibchen zeichnen -- 
  arm Mutter weinen -- -- -- hingehöret -- Gott Seele -- Erde Leib -- finden Trost -- -- -- 
  sobald Priester heilig Amt verrichten -- beginnen seltsam Jucke fühlen Hand Arm -- womit Spinne weggeschleuderen -- 
  schwarz Flecken Hand -- sichtbarlich groß schwollen -- Todesschauer rieselen durch Herz -- 
  segnen Weiber eilen Heim -- heilig Waffe getreu Streiter bringen -- hinhörten -- Hand -- 
  hochauf schwellen Arm -- schwarz Beule quoll hoch -- kämpfen Tod Mattigkeit -- erliegen -- 
  Kilchstalde -- Hans -- gottvergessen Vater -- wissen -- bleiben -- mitten Weg Rücken liegen -- 
  Hochgeschwollen brandschwarz Gesicht -- mitten sitzen schwarz grausig Spinne -- 
  Pfarrer -- blähte -- giftig bäumt Haar Rücken -- giftig sprühend glotzt Auge -- Katze -- rüsten Sprung Todfeinde Gesicht -- 
  beginnen Priester gut Spruch heben heilig Waffe -- Spinne schrak -- kroch langbeinig schwarz Gesicht -- verlieren zischend Grase -- 
  Pfarrer vollends heim -- stellen Allerheiligste Ort -- wild Schmerz Leib Tod rissen -- harren süß Frieden Seele Gott -- streiten kühn gotteskampfe -- lassen Gott harren -- 
  solch süß Friede -- still Herr harren -- hinten Tale -- Berg -- 
  Augenblick -- Christin geraubt Kind Berg hinuntergefahren Teufel -- Heilloser Schreck Herzen fahren -- 
  fürchterlich Ungewitter bebten Mensch Schrecken Tod -- Herz wissen -- Gott Hand vernichtend kommen -- wohlverdient -- 
  Gewitter vorüber -- laufen Kunde Haus Haus -- Pfarrer Kindlein zurückgebracht taufen -- Hans -- Christine sehen -- 
  grauend finden lauter bleich Gesicht -- schön Sonne färben -- wissen -- Schrecklichst -- 
  hören -- schwarz Beule Pfarrer sterben -- finden Hans schrecklich Gesicht -- gräßlich Spinne -- Christine verwandeln -- hören seltsam verwirrt Wort -- 
  schön Erntetag -- Hand rührt Arbeit -- Leute laufen -- pflegen -- Unglück begegnen -- 
  fühlen bebend Seele -- heiß -- irdisch Not Plage unsterblich Seele loskaufen -- fühlen -- Gott Himmel -- Unrecht -- arm Kind -- wehren -- antun -- fürchterlich räch -- 
  Stunde bebend jammerten -- -- heim -- Zank Streit -- schuld -- abgemahnt warnen -- dawider -- Strafe Schuldigen treffen -- Haus Strafe -- 
  schrecklich Harren Streit neu -- unschuldig Opfer wissen -- -- freveln Hoffnung -- retten -- 
  schreien mitten Haufen entsetzlich -- -- glühend Dorn treten -- Nagle glühend Nagel Fuß Boden -- ström Feuer Mark Gebein -- 
  haufen fahren auseinander -- Auge sehen Fuß -- Hand Schreiende fahren -- 
  Fuße sitzen schwarz Spinne glotzen giftig schadenfroh Runde -- 
  starren Blut Ader -- Atem Brust -- Blick Auge -- ruhig schadenfroh glotzt Spinne umh -- Fuß schwarz -- Leib war_es -- kämpfen zischend wütend Feuer Wasser -- Angst sprengen Fessel Schrecken -- Haufen stob auseinander -- 
  wunderbar Schnelle Spinne Sitz verlassen kroch Fuß Ferse -- Glut fahren Leib -- gräßlich Geschrei jagen Fliehende heftig -- 
  Windeseil -- Todesschrecke -- gespenstig Wild wild Jagd stoben Hütte -- meinen Spinne -- versammelt Türe hören beben unsäglich Angst -- 
  Spinn verschwinden -- neu Todesgeschrei hören -- Leute müssen versammelt Haus verlassen -- müssen Speis suchen für Vieh -- tun Todesangst -- 
  Spinne -- unversehens Fuß setzen -- 
  vorsichtigst niedertrat Auge schärfsen spähen -- Spinn plötzlich sitzend Hand Fuß -- laufen über Gesicht -- sitzen schwarz Nase glotzt Auge -- feurig Stachel wühlt Gebein -- Brand Hölle schlagen -- Tod strecken -- 
  Spinne nirgends -- -- -- Tale unten -- Berg -- zischt durch Gras -- fallen Decke -- taucht Boden -- 
  hellem Mittage -- Leute Habemus sitzen -- erscheinen glotzend unten Tisch -- ehe Mensch Schrecken sprengen -- Hand laufen -- sitzen Tisch Hausvater Haupt glotzt Tisch -- schwarz werdend Hand weg -- 
  fallen nachts Leute Gesicht -- begegnet Walde -- suchen heim Stalle -- 
  Mensch meiden -- nirgends allenthalben -- Wachen schützen -- schlafend sicher -- 
  Sicherst wähnn unterem frei Himmel -- Baume Gipfel -- kroch Feuer Rücken -- Spinne feurig Fuß fühlen Nack -- glotzen Achsel -- 
  Kind Wiege -- Greis Sterbebette schonen -- Sterbet -- wissen -- sterben schrecklich -- erfahren -- schrecklich Sterbe namenlos Angst Spinne -- allenthalben nirgends -- -- Sichersten wähnen -- todbringend plötzlich Auge glotzen -- 
  kund Schrecken alsobald Schloß dringen dorthin Schreck Streit bringen -- soweit Regel Orden stattfinden -- 
  Stoffel bange -- heimsuchen möchten Vieh -- verstorben Priester äußern -- Seele aufrühren -- 
  manchmal -- Leid -- Bauer antuen -- zurückfahren -- glauben -- meinen -- Gott Unterschied wissen Ritter Bauer -- verschieden erschaffen -- 
  Angst -- gehen Priester Wort -- hart Wort Ritter meinen -- kommen schwer Strafe leichtfertig Wort -- 
  Ritter schuld -- schieben -- -- meinten_es -- gehen eigentlich Stoffel -- nehmen -- Schuld -- 
  sehen jung Polenritter -- eigentlich meister leichtfertig Wort Schloß sprechen Stoffel meisten gereizt Bau vermessen Schattengange -- 
  jung -- wilde -- vermessen gelten -- voran -- Heide fürchten weder Gott Teufel -- 
  merken -- meinen -- sagen -- merken heimlich Angst -- 
  höhnten -- Spinne fürchten -- Drache -- 
  wappnen riten Tal hinauf -- vermessend -- zurückkehren -- Roß Spinne zertreen -- Faust zerdrücken -- 
  wild Hund springen -- Falke sitzen Faust -- Sattel hing Lanze -- lustig bäumt Pferd -- halb schadenfroh -- halb ängstlich Schlos reit gedacht nächtlich Wache Bärheg -- Kraft weltlich Waffe Feind bewähren -- 
  riten Saume Tannenwalde nächster Gehöfe -- scharf Auge spähend -- 
  Haus erblicken -- Leute -- rufen Hunden -- Haupt Falke frei -- lose klirrt Scheide Dolch -- 
  Falke geblendet Auge Ritter kehren -- Winkes gewärtig -- prallt Faust schoß Luft -- hergesprungen Hund heulter suchen Schweif Bein Weite -- 
  vergebens riten rufen Ritter -- Tier -- 
  riten Mensch -- Kunde einziehen -- Stunde -- nahekommen -- 
  Schrie gräßlich floh Wald Schlucht -- Ritter Helm sitzen schwarz -- übernatürlich Größe Spinne glotzen giftig schadenfroh Land -- 
  suchen -- tragen Ritter wissen -- glühendem Zorne rufen riten Mensch -- rufen wütender -- riten Toller -- brüllen entsetzlich -- Roß Fluh hinab Tale stürzen -- 
  finden Helm Leib -- Helm hindurch Fuß Spinne brannen Ritter Gehirn hinein -- schrecklichst Brand entzünden -- Tod finden -- 
  kehren Schreck Schloß -- schließen fühlen sicher -- suchen geistig Waffe -- finden -- führen wissen führen wagen -- 
  lassen ferner Pfaff locken Geld Wort -- auszieh heilig Wasser heilig Sprüche böse Feind -- 
  stärkt Gebet Fast -- tafelen morgens früh Ritter zählen Becher leben Hirsch Bär -- 
  redet geistig Heldentat Ritter weltlichen -- Becher zählen -- Spinne vergessen -- 
  löscht Leben -- Hand halten erstarren Becher Gabel -- Mund bleiben -- stier Auge Punkt richten -- Stoffeln trank Becher leer erzählt Heldentat Heidenland -- 
  kopf sitzen Spinne glotzt Rittertisch -- Ritter fühlen -- 
  beginnen Glut ström Gehirn Blut -- gräßlich schreien -- fahren Hand kopfe -- Spinn -- schrecklich Schnelle Ritter Gesicht laufen -- wehren -- schreien -- Glut verzehren -- Pfaffe Glatz nieder glotzt Greuel hinein -- Becher -- Hand -- Pfaff Brand löschen -- lodert Kopf herab Mark Bein -- 
  Waffe trotzt Spinne glotzt Throne herab Greuel -- letzter Ritter letzter Schrei ausgestoß -- letzter Atemzug enden -- 
  Schlos bleiben Diener verschonen -- Hohn Bauer treiben -- erzählten -- schrecklich gehen -- 
  Gefühl -- Ritter geschehen -- tröstet Bauer -- Schreck groß -- gräßlich -- 
  suchen fliehen -- 
  Tal verlassen -- fallen Spinne -- 
  Weg finden Leichname -- 
  fliehen hoch Berg -- droben Spinne -- retten glauben -- sitzen Spinne Nacken Gesicht -- 
  Untier boshafter -- teuflisch -- 
  überraschen unerwartet -- brennen unversehens Tod -- sitzen Mensch Grase -- hing Baume -- glotzen giftig -- 
  fliehen Mensch -- Fuß tragen -- stehen atemlos still -- sitzen Spinne glotzen giftig -- 
  Floh abermals -- müssen abermals Schritt hemmen -- sitzen -- fliehen -- kroch langsam heran Tod -- 
  versuchen Verzweiflung Widerstand -- Spinne töten -- werfen zentnerig Stein -- Grase sitzen -- schlagen Keule -- Beile -- umsonst -- schwer Stein erdrücken -- scharf Beil verletzen -- unversehens sitzen Mensch Gesicht -- unversehren kroch heran -- 
  Flucht -- Widerstand -- eitel -- 
  hoffen -- Verzweiflung füllen Tal -- sitzen Berg -- 
  einzig Haus Untier verschonen erscheinen -- Haus -- Christine gewohnen -- Kindlein rauben -- 
  Mann einsam Weide anfallen -- finden Leichnam gräßlich zugerichten -- Zug zerrissen unaussprechlich Schmerz -- gräßlichst Zorn auslassen -- gräßlichst Wiedersehen Ehemanne bereiten -- 
  Zuging -- sehen -- 
  Haus kommen -- zuletzt sparen scheut -- erriet -- 
  Ort Angst eingekehren -- 
  fromm Weibche genesen -- zagen -- fast treu Bübch schwesterchen wacht Nacht -- treu Großmutter teilen Sorge Wachen -- 
  gemeinsam betet Gott -- Auge offenhalten Wache -- erleucht stärk Rettung unschuldig Kindlein -- 
  -- wachen Nacht -- sehen Spinne glimmen glitzern dunklem Winkel -- glotz Fenster herein -- Angst -- wissen Rat -- Spinne Kindlein schützen -- brünstig bat Gott Rat Beistand -- 
  allerlei Waffe Hand legen -- hören -- Stein schwere -- Beil Schärfe verlieren -- beiseite legen -- 
  Mutter deutlich -- lebendig Sinn -- wagen -- Spinne Hand fassen -- vermögen überwältigen -- 
  hört Leute -- -- Stein helfen -- Hand erdrücken versuchen -- vergeblich -- 
  gräßlich Glutstrom -- Hand Arm zucken -- tilgt Kraft bringen Tod Herz -- 
  -- erdrücken vermögen Spinne -- erfassen dürfen -- Kraft Gott verleihen -- irgendwohin -- unschädlich -- 
  gehören -- kundig Mann Geist einsperren Loch Fels Holz -- Nagel zuschlagen -- solange Nagel ausziehen -- müssen Geist bannen Loche -- 
  gleich versuchen -- drängen Geist -- 
  bohren Loch Bystal -- nächster liegen Hand -- Wieg sitzen -- rüstet Zapfe -- scharf Loch passen -- weiht geheiligt Wasser -- legen Hammer zurecht betet Nacht Gott Kraft -- 
  manchmal Fleisch stark Geist -- schwer Schlaf drücken Auge -- Traum Spinne -- glotzend Bübchen golden Locke -- fahren Traume -- fahren Bübch Locke -- 
  Spinne -- lächeln sitzen Gesichtchen -- Kindlein lächeln -- Engel Traume sehen -- Mutter glitzert Ecke Spinne giftig Auge -- weichen Schlaf -- 
  streng Wachen Schlaf überwältigen -- dicht umnachten -- 
  -- stürz fromm Priester -- Rettung Kindlein sterben -- herbei weit Raum ruf Ferne -- > Weib -- wachen -- Feind -- 
  < Dreimal rufen -- drittenmal Rang Schlaf eng Bande -- schwer Augenlider mühsam erheben -- langsam -- giftgeschwoll Spinne schreiten über Bettlein hinauf Gesicht bübchens -- 
  dachen Gott greifen rasch Hand Spinne -- 
  fahren Feuerström -- treu Mutter Hand Arm Herz hinein -- muttertreu Mutterlieb drückt Hand -- Aushalten Gott Kraft -- 
  tausendfach Todesschmerze drücken Hand Spinne bereitet Loch -- zapfen schlagen Hammer fest -- 
  Drinn sau braust -- Meer Wirbelwinde streiten -- Haus wankt Grundfest -- fest sitzen Zapfe -- gefangen bleiben Spinne -- 
  treu Mutter freuen -- Kindlein retten -- danken Gott Gnade -- sterben gleich Tod -- Muttertreue löscht Schmerz -- Engel geleitet Seele Gott Thron -- Held -- Leben einsetzen -- Gott wagen -- 
  schwarz Tod -- 
  Ruhe Leben kehrt Tal -- 
  schwarz Spinne sehen selben -- sitzen Loche gefangen -- sitzen -- -- 
  -- -- schwarz Holz -- -- schreien Gotte fahren Satz Boden -- Ameisenhaufe sitzen -- 
  Holz sitzen Stube -- 
  brennen Rücken -- drehen -- schaut -- fahren Hand Angst -- schwarz Spinne sitz Nacken -- 
  Herz zugeklemmen -- Großvater schweigen -- 
  schweigen kommen -- 
  Spott wagen -- Sache beistimmen gerne -- hört Wort -- Rede richten -- verfehlen wenigster -- 
  Hebamme -- mehrere Mal rufen -- Antwort bekommen -- hergelaufen -- Gesicht brennen Hochrot -- -- Spinne herumgekrochen -- 
  beginnen schmälen -- wollen -- laut rufen -- 
  wunderlich Sache -- kochen -- wollen Tisch -- -- sollen Schuld -- wissen -- gehen -- 
  fett Fleisch -- drinnen stehen -- können essen -- kalt -- ungesund -- 
  kommen Leute -- langsam -- kein Türe -- Großvater müssen -- 
  diesmal sowohl üblich Sitt -- Schein -- mögen warten -- Essen kommen -- zögern -- befällen -- Eingang stehen schauerlich Ort -- drinnen Schauerliche -- 
  Hell glänzt Tisch -- frisch füllen -- schön Weinflasche -- glänzend Schinke prangen -- gewaltig Kalbs- Schafbrate dampfen -- frisch Zupfe liegen -- Teller Tatar -- Torten -- -- Teller dreierlei Küchele dazwischengezwängen -- Kännche süß Tee fehlen -- 
  war_es schön schauen -- achteen -- sehen ängstlich Auge -- Spinne irgendeiner Ecke glitz prangend Schink herab anglotz giftig Auge -- 
  nirgends -- üblichen Kompliment -- 
  Sinn -- aufstellen -- essen sollen -- zuviel -- drängen unterer Ecke Tisch -- hinauf -- 
  Umsonst mahnen Gast zeigter leer Platz -- Stunde unten angenagelt -- vergebens schenken Kindbettiman rufen -- Gesundheit -- eingeschenken -- 
  Gotte arme -- -- Witzigeste gib Exempel -- -- 
  Kraft -- klein -- sperrt Gotte rufen -- -- tausend Pfund sitzen -- 
  gramselt Rücken nieder -- führ Nessel herum -- 
  säß Bystal -- fühlen schrecklich Spinne sond Unterlaß Nacken -- -- 
  -- schuld -- Großvater -- -- Großmutter -- -- bringst Ding auf Tapet -- 
  tragen heutzutage Haus schaden -- 
  einst Kind Schule weinen klagen -- Kind halten -- Großmutter Hexe Bystal bannen -- -- -- 
  -- ruhig -- Großmutter -- -- Großvater -- -- heutzutage vergessen behalten Gedächtnis ehedem -- 
  Sache -- -- Leute vernehmen punktum Wahrheit -- ersinnen -- Wahrheit bringen unser Haus Unehr -- 
  sitzeen -- 
  Seht -- Zapfe sitzen -- 
  tausend sitzen Furcht Zag Gefährde -- 
  böse Gedanke aufstiegen -- Teufel Handhabe -- -- Schnurre -- Katze schnurret -- anlassen -- Balg streichen -- behaglich -- fahren Rücken seltsam absonderlich -- 
  halten Mäusestill innen -- solange außen Gott vergessen -- warten innen -- -- 
  faßn Gast Mut setzen -- nahe Großvater rücken -- 
  Kindbettiman vorlegen -- legen mächtig Stück Braten Nachbarin Teller -- schneiden Stückchen legen Rest Nachbars Teller -- Daumen Gabel streifend -- 
  Stück -- -- denken -- behalten -- -- -- neu Stück beginnen Runde -- 
  Kindbettiman einschenken vorlegt Gast sagen -- strengen -- Hebamm herum süßen Tee -- stark würzen Safran Zimt -- bieten fragen -- lieben -- sollen sagen -- -- 
  -- Liebhaber -- schenken Tee Wein -- 
  lieben -- mögen Wein ertragen -- machen Kopfweh -- 
  aß trank -- 
  Lärm vorbei -- allemal entstehen -- Gericht -- still -- ernst Gesicht -- merken -- Gedanke Spinne -- 
  scheu verstohlen blickt Auge Zapfe Großvater Rücken -- scheut -- anfangen -- 
  schreien laut Gotte fast Stuhle fallen -- 
  Fliege Zapfe laufen -- glauben -- Spinne schwarz Bein gramselt Loche heraus -- zitteren Schreck Leib -- 
  ausgelacht -- Schreck willkommen Anlaß -- neu Spinne anfangen -- Sache Seele berühren -- schnell -- 
  -- hör Mal -- Vetter -- -- alt Götti -- -- Spinne seither Loche kommen -- bleiben hundert -- -- 
  -- E -- -- Großmutter -- -- -- schwieg Sache -- Nachmittag reden -- -- 
  -- E -- Mutter -- -- Vetter -- -- laß dein alte reden -- kurz -- vorhalt Ding -- stammen Christine -- 
  bringst Gedanke Sache -- reden -- reden -- kurz -- 
  -- Großvater -- reden -- alt vergönnen -- -- 
  -- He -- zwingen wollet -- zwinget meinethalben -- gescheut -- angefang Nacht -- -- Großmutter -- 
  beginnen Großvater -- Gesicht spannen -- 
  -- wissen -- -- wissen -- sagen -- heutig Exempel nehmen -- schaden wahrhaftig -- 
  Leute Spinne einsperren wissen -- Leben sicher -- -- Himmel lieben Gott Seligkeit mitten -- -- 
  halten Gott fliehen Teufel -- Ritter -- frisch eingezog Schloß -- Respekt Gott Hand halten mild Mensch helfen -- 
  Haus betrachten Ehrfurcht -- fast Kirche -- 
  Anfangs schauderen freilich -- ansahen -- Kerker schrecklich Spinne sehen denken -- losbrech Elend vorne anfangen Teufel Gewalt -- 
  sehen -- Gott Gewalt stark Teufel -- Mutter -- sterben -- halfen Kind bauen unentgeltlich Hof -- arbeiten -- 
  Ritter bewilligen -- neu Haus bauen -- Spinn fürchten Zufall bewohnt Haus loskommen -- Nachbaren helfen -- Scheu Untier -- schrecklich zittern -- loswerden -- 
  alt Großmutter -- 
  lehren Enkel -- Spinne gebannen Gott Vater -- Sohn heilig Geist -- solange heilig Name gelten Haus -- solange heilig Name Tisch gegessen trinken -- Spinn sicher fest Loch -- Zufall machen Sache -- 
  Tisch -- Spinn -- vergessen -- nötig Gott mächtig -- mahne Spinne Gott müssen Teufel trotz Heil -- 
  Ließen Gott -- hundert Stunde -- Spinn finden Teufel -- 
  fassen Kind -- bleiben Haus -- wuchsen gottesfürchtig -- Haus Segen Gott -- 
  Bübch -- treu Mutter -- treu Mutter -- wachsen stattlich Manne -- leiben Gott Mensch Gnade Rittern finden -- 
  segnen zeitlich vergessen Gott darob -- geizig -- helfen Nöt -- wünschen -- helfen letzter Not -- schwach Hülfe -- kräftiger Fürsprecher Gott Mensch -- 
  segnen weis Weibe -- unergründlich Friede -- blühn Fromm Kind -- finden spät sanft Tod -- 
  Familie blühen fort Gottesfurcht Rechttun -- 
  -- Tale liegen Segen Gott -- Glück Feld Stall fried Mensch -- 
  schrecklich Lehre Mensch Herz gehen -- halten fest Gott -- tun -- tun Name -- helfen -- säumen -- 
  Schlos Übel -- -- 
  Ritter wohnen -- hart Streit Heidenland Nöter Hand -- fechten -- -- Schloß -- mahnen täglich Totenhalle -- Spinne Ritter Bauer üben -- Gott gleich Kraft -- abfall -- Bauer Ritter -- 
  schwand Glück Segen -- Tal berühmt -- 
  stattlich Haus -- Vorrät -- manch Geldstück ruht Kasten -- Vieh schön Berg Tal -- Tochter berühmt landauf -- landab Sohn gerne sehen überall -- 
  Ruhm welkt Nacht Jona Schattenstaude -- dauern Geschlecht Geschlecht -- gleich Gottesfurcht Ehrbarkeit Vater leben Sohn Geschlecht Geschlecht -- 
  Birnbaum -- flüssigsten Genährt -- stark treiben -- Wurm bohren -- umfrißen -- welken lassen töten -- geschehen -- -- Gott Segenstrom reichsen Mensch fließen -- Wurm Segen -- Mensch blähen blind -- Segen Gott vergessen -- Reichtum -- geben -- Israelit -- -- Gott helfen -- golden Kälber vergaßen -- 
  -- Geschlecht dahingegangen -- Hochmut Hoffart heimisch Tale -- fremd Weiber bringen Mehrt beide -- 
  Kleid hoffärtig -- Kleinode glänzen -- -- heilig Zeichen wagen Hoffart -- Herz Bete inbrünstig Gott sein -- hing Auge hoffärtig golden Kugel Rosenkranze -- 
  Gottesdienst Pracht Hoffart -- Herzen hart Gott Mensch -- 
  Gott Gebot bekümmeren -- Dienst -- Diener spotten -- -- Hoffart Geld -- gerne Wahn -- Gelüste Weisheit halten Weisheit hoch Gott Weisheit -- 
  Ritter plagen -- hart Gesinde plagten -- arbeiten -- Mutet -- Arbeit Knecht Mägde fordern -- behandelten unvernünftig Vieh -- Seele -- wahr -- denken -- 
  Geld Hoffart -- fangen bauen -- schön -- Ritter bauen -- bauen -- Ritter plagten -- schonten weder Gesinde Vieh -- Bauteufel -- 
  Wandel Haus kommen -- alt Reichtum bleiben -- 
  fast zweihunderen Verflossen -- Spinne Loche gefangensitzen -- schlau kräftig Weib Meister -- Lindauerin -- glich Christin Stück -- 
  Fremd -- Hoffart -- Hochmute ergeben -- einzig Sohn -- Mann Meisterschaft sterben -- 
  Sohn schön Bube -- Gemüt freundlich Mensch Vieh -- leiben -- lassen merken -- 
  meistert Schritt Treten -- -- erlauben -- längst erwachsen Kameradschaft Kilbi Mutter Begleitung -- 
  alt glauben -- Weib Verwandtschaft -- eins Sinn -- 
  Meister -- hoffärtig hochmütig -- -- Christ -- freundlich demütig -- Anstand -- erfahren -- Meister -- 
  alt Haus Dorn Auge -- schämten -- Nachbaren Haus reich -- 
  Sage Spinne Großmutter -- Gedächtnis -- alt Haus längst einreißen -- wehrten -- 
  nehmen Wehre Neid -- neu Haus gönnen -- 
  zudem unheimelig alt Haus -- 
  Tisch sitzen -- -- Schnurre behaglich Katze -- gehen leis Loch -- Spinne ziel Nack -- 
  fehlt Sinn -- Loch vermacht -- fürchten -- Loch öffnen -- 
  finden gut Grund -- neu Haus bauen -- Spinn fürchten -- meinen -- 
  alt Gesinde überlassen -- Hoffart Weg -- rätig -- 
  Christ ungern -- wissen -- alt Großmutter -- glauben -- Familiensege Familienhaus knüpfen -- Spinne fürchten -- Tisch sitzen -- scheinen -- können andächtigst beten -- 
  -- meinen -- Weiber hießen schweigen -- Knecht -- schweigen -- weinen bitterlich -- sehen -- 
  -- oberhalb Baume -- sitzen -- Haus bauen -- eins Gegend -- 
  hoffärtig Ungeduld -- Verstand bauen warten -- Haus hochmütig -- plagt bauen Gesinde Vieh übel -- schont heilig Feiertage gönnt Nacht Ruhe -- Nachbar -- helfen -- zufrieden -- böse Nachgewünscht -- unentgeltlich Hülfe -- leisten -- Heimging -- Sache sehen -- 
  aufrichtet Zapfe Schwelle schlagen -- raucht Loche herauf nass Stroh -- anbrennen -- schüttelte Werkleute bedenklich Kopf sagen heimlich laut -- Bau alt -- Weiber lachen achtet Zeichen -- 
  Haus erbaueen -- ziehen hinüber -- richten unerhört Pracht geben sogenannter Hausräuki Kilbi -- dauern Kind Kindeskind erzählt Emmental -- 
  Haus seltsam Surre gehören Katze -- behaglich -- Balg streichen -- 
  Katze -- -- trotz Suchen finden -- unheimlich -- trotz Herrlichkeit laufen mitten Fest -- 
  weiber hören achteten -- Haus meinen gewinnen -- 
  -- blind -- sehen Sonne -- Taub -- hören Donner -- 
  freuen Weiber Haus -- hoffärtig -- denken Spinne -- führen Haus üppig -- arbeitslos Leben putzen Essen -- Mensch treffen -- Gott denken -- 
  alt Haus bleiben Gesinde alleine -- leben -- -- Christ Aufsicht -- duldet Weiber schalten -- Mutter Hochmut hauptsächlich -- Weib Eifersucht zumeist -- 
  drunt Ordnung Gottesfurcht -- Meister -- durchweg -- 
  Meister Tisch sitzen -- Meister Haus Ohr spitzen -- Meister draußen drinnen Zügel halten -- meinen Größter -- wüstesten tun -- gute -- ruchlosest Rede führen -- 
  Haus drunt -- sämtlich Gesinde glich Rudel Katze -- wüstesten -- 
  Bete wissen -- weder Gott Wille Gabe Respekt -- 
  Hoffart Meisterweiber Grenze kennen -- tierisch Übermut Gesind Schranke -- 
  schändet ungescheut Brot -- treiben Habemus Tisch weg Löffeln Kopf -- -- verunreinigen viehisch Speise -- boshaft Lust Essen vertreiben -- 
  neckt Nachbaren -- quält Vieh -- höhnen Gottesdienst -- leugnen hoch Gewalt plagt Weise Priester -- strafend reden -- -- Furcht Gott Mensch tun wüster -- 
  wüste Leben führen Knecht Mägde -- plagt -- Knecht wissen -- Art mägde quälen -- fallen -- Spinne Loche mägde schrecken zehmen -- 
  schmeißen Löffel voll Habemus Milch Zapfen schreien -- drinnen hungrig -- hundert -- 
  schri mägde gräßlich versprachen -- -- Knecht grauten -- 
  Spiel ungestraft wiederholen -- wirken -- Mägde schri -- versprach -- Knecht beginnen treiben -- 
  fing -- Messer Loch fahren -- gräßlichst Flüche vermessen -- mach Zapfe wollen sehen -- drinnen -- müssen neue sehen -- 
  wecken neu entsetzen -- Bursche -- -- Meister zwingen -- -- Mägde -- 
  seltsam Mensch -- wissen -- woher -- 
  sanft Lamm reißend Wolf -- alleine Weibsbilde -- sanft Lamm -- Gesellschaft reißend Wolf -- haßt -- aufwoll wüst Tat Wort -- Weibsbilder liebsn -- 
  entsetzt Mägde öffentlich -- -- alleine -- liebsn -- 
  ungleich Auge -- wissen -- Farbe -- haßen -- sehen gleich Weg -- lang augenhaar demütig niedersehn wissen verbergen -- 
  Haar schön locken -- wissen -- rot falb -- Schatten schön Flachshaar -- scheinen Sonne -- Eichhörnchen röteren Pelz -- 
  quäln Vieh -- 
  haßen -- 
  Knecht meinen -- Freund -- weisen -- 
  meisterweibern alleine -- alleine oberer Haus -- tun unten Mägde Wüst -- sobald merken -- stecken Messer Zapfe beginnen Drohen -- Mägde Kreuze krochen -- 
  behalten Spiel Wirkung -- 
  mägde gewohnen sagen -- 
  > Tue -- -- -- 
  < naht Weihnacht -- heilig Nacht -- 
  -- Weihet -- denken -- lustig Leben abgeraten -- 
  Schlos drunt Hauste alt Ritter -- bekümmeren um zeitlich -- schelmischer Vogt verwalten Vorteil -- 
  Schelmenstück edel Ungarwein abgehandeln -- Land Ritter groß Streite liegen -- edlen Weine Kraft Feuer kennen -- 
  fürchterlich Unwetter herauf Blitz Sturm selten -- Hund Ofen hervorgejagen -- 
  Kirche -- halten -- sein schön Wetter gehen -- Meister alleine lassen -- halten -- besuchen -- bleiben alt Haus edl Wein -- 
  beginnen heilig Abend Fluchen Tanzen -- wüsteren ärgern Ding -- setzen Mahl -- wozu Mägde Fleisch kochen -- weiß Brei stehlen -- 
  Roheit gräßlich -- schändet Speise -- lästert Heilige -- genannt Knecht spottet Priester -- teilen Brot trinken Wein -- Messe verwalten -- taufen Hund unter Ofen -- treiben -- Angst bange -- ruchlos -- 
  stach Messer Loch fluchen -- wollen Ding zeigen -- 
  darob erschrecken -- gleich manchmal getrieb Messer Zapfe abzubringen -- greifen halber Raserei Bohrer -- Vermaß auf Schrecklichste -- erfahren -- können -- büßen lachen -- Haar Berg stehen -- drehen wild Stoß Bohrer Zapfe hinein -- 
  laut aufschreiend stürzen -- ehe hindern -- lacht Teufel -- kräftig Ruck Bohr -- 
  beben ungeheur Donnerschlag Haus -- Missetäter stürzen Rücklings nieder -- rot Glutstrom brechen Loche hervor -- mittendrin sitzen schwarz -- aufgeschwoll Gift Jahrhundert -- Spinne glotzen giftig Lust Frevler -- versteinern tödlich Angst Glied bewegen -- schrecklich Untiere entrinnen -- langsam schadenfroh Gesicht kroch -- einimpft feurig Tod -- 
  erbebt Haus schrecklich Wehgeheul -- hundert Wölfe ausstoßen vermögen -- Hunger peinigen -- 
  erscholl ähnlich Wehgeschrei Haus -- Christ -- Berg aufkommen heilig Messe -- meinen -- Räuber einbrechen -- stark Arm trauend -- stürzen Hilfe -- 
  finden Räuber -- Tod -- rang Weib Mutter Stimme hochaufgelaufenen -- schwarz Gesicht -- ruhig schlummeren Kind -- gesund rot munter Gesicht -- 
  steigen Christ schrecklich Ahnung -- geschehen -- stürzen unter Haus -- Dienst verenden -- Stube Totenkammer -- öffnen schauerlich Loch Bystal -- scheußlich entstellt Knecht Hand Bohr Bohrer Spitze schrecklich Zapfe -- 
  wissen -- geschehen -- schlagen Hand kopfe -- Erde verschlungen -- -- 
  kroch hinterem Ofen hervor -- schmiegen -- entsetzt fahren -- Spinne -- arm Bübchen -- Gott Wille Haus nehmen ruchlos Gesinde lassen -- geschehen -- Kind Gott Wille nehmen Teufel Hand spielen -- 
  nehmen Greuel Gesind -- erschrecken Ofen fliehen -- ihn Spinne verschonen -- Hergang erzählen -- 
  Bübch erzählen -- scholl Wind Wetter Angstgeschrei Häusern -- 
  hundertjährig -- aufgeschwellt Lust flog Spinne Talschaft -- Las üppigst Haus -- wenigster Gott denken -- meister Welt -- Tod wenigster wissen -- 
  -- Kunde jeglicher Haus -- alt Spinne losgebrochen -- gehen auf todbringend Gemeinde -- liegen tot -- hinten Tale fahr Schrei Schrei Himmel Gezeichneten -- sterben müssen -- 
  denken -- welcher Jammer Land -- Angst Herzen -- Weihnacht Sumiswald -- 
  Freude -- bringen -- Seele denken -- Jammer Frevel Mensch -- 
  Jammer groß -- schnell -- giftig früh Mal Spinne -- 
  zuvörderst -- zuhinterst Gemeinde -- Berg -- Tale erscheinen gleich -- 
  meist -- gezeichnen Tod -- verlassen selten Haus -- ehe vergiften -- Tod wanden -- setzt Schwelle glotzen schadenfroh Vergiftung -- sagen -- -- einsperren -- 
  scheinen -- wissen -- vergönnen -- Mühe sparen -- -- -- -- 
  laueren lieb Zug -- tote Kirche geleiten -- 
  -- -- liebsn unten Kilchstalde tauchen mitten Haufen glotzen plötzlich Sarge herab Begleitend -- 
  fahren schrecklich Wehgeschrei begleitend Zug Himmel -- Mann Mann fallen nieder -- Zug Begleitend Weg liegen -- Rang Tod -- Leben -- Sarg Haufen tote liegen -- tapfer Krieger Fahne liegen -- Übermacht erfassen -- 
  tote Kirche bringen -- tragen -- geleiten -- Tod strecken -- lassen liegen -- 
  Verzweiflung liegen über Tale -- 
  Wut kocht Herz -- strömt schrecklich Verwünschung arm Christ -- Schuld -- 
  wissen -- Christ alt Haus verlassen -- Gesinde überlassen -- 
  wissen -- Meister Gesinde minder verantwortlich -- wachen sollen Bete essen -- wehren sollen gottlos Leben -- gottlos Rede gottlos Schänd Gabe Gott -- 
  Hoffart Hochmut vergehen -- tun Laster unterst Hölle hinunt Gott glauben -- schmählich tragen -- fromm -- schlechtesen Kleid alt verachtet Rosenkränze Hand überredeter -- Fromm -- fehlen -- Gott gleich überredeten -- 
  Christ gottlos -- flüch Berg kommen Seite -- 
  gute -- Wille liegen binden weiber Wille -- Gebundensein schwer Schuld Mann -- schwer Verantwortung entrinnen -- -- Gott -- 
  Christ -- trotzig -- pocht -- schuldig dar -- -- versöhnt Leute -- schri -- Schuld müssen -- nehmen -- unterziehen -- bekennen -- wert -- 
  betet Nacht Gott -- Übel wenden -- Schrecklicher -- 
  inne -- gutmachen müssen -- fehlen -- Opfer geben müssen -- liegen -- Ahnfrau tun -- 
  beten Gott -- feurig Herz Entschluß emporwuchs -- Talschaft retten -- Übel sühn -- Entschluß standhaft Mut -- wanken -- bereit gleich -- Abend -- 
  ziehen herab Kind Haus alt Haus -- schneiden Loch Zapfe -- lassen weih heilig Wasser heilig Sprüche -- legen Zapfe Hammer -- setzen Bett Kind harrt Spinne -- 
  sitzen -- beten wacht Rang schwer Schlaf fest Mut wanken -- Spinne -- allenthalben -- größ Sterbet -- wild Wut überlebend -- 
  mitten Schrecken wild Weib Kind gebären -- 
  Leute alt Angst -- ungetaufen Spinne Kindlein holen -- Pfand alt Pacht -- 
  weib gebärden unsinnig -- Gottvertrauen -- desto Haß Rache Herz -- 
  wissen -- alt grüne geschützen Zeit -- Kind gebären -- Priester Schild -- ewig Feind stellen -- 
  Priester senden -- Bote -- 
  unbegraben tote -- Spinne Leichenzüg erfassen -- sperrt Weg -- Bote wild Höhe Spinne -- wissen scheinen -- entgehen -- Priester holen -- 
  zagten -- 
  dachen Mann Weibes -- Spinne wollen -- können daheim fassen Weg -- Tod bestimmen -- entrinnen -- 
  Weg -- Stunde Stunde rann vorüber -- Bote -- 
  Wut Jammer entsetzlich -- Geburt rücken nah -- 
  reißen Weib Wut Verzweiflung Lager -- stürzen Christus Haus -- tausendfach Verwünscht -- betend Kind sitzen -- Kampf Spinne gewärtig -- 
  Weither tönt Geschrei -- Verwünschung donneren Christus Türe -- ehe aufriß Donner Stube bringen -- 
  hereinstürzt schrecklich Angesicht -- fahren -- wissen -- Christine ursprünglich Gestalt -- 
  Türe hemmen Schmerz Lauf -- Türpfosten Wand -- Flut Verwünschung ausgießend arm Christ -- 
  Bote -- verflucht wollen Kind Kindeskindern Ewigkeit -- 
  überwallen Schmerz Fluchen -- Söhnlein gebären wild Weib Christus Schwelle -- -- folgen -- stoben Weite -- Schrecklichst gewärtig -- 
  unschuldig Kindlein halten Christ arme -- stechend wild -- giftig starrt Weibe verzerrten Zügen Auge -- -- tret Spinne heraus -- -- 
  Kraft Gott -- übermenschlich Wille mächtig -- innig Blick werfen Kind -- hüllt neugeboren Kind warm Gewand -- springen glotzend Weib Berg hinunt Tal entlang -- Sumiswald -- 
  heilig Weihe Kindlein tragen Sühne Schuld -- liegen -- Haupt Haus -- übrige überlassen Gott -- 
  tote hemmen Lauf -- vorsichtig müssen Tritt setzen -- 
  ereilen leicht Fuß -- arm Bübch -- graut wild Weib -- kindlich Trieb Meister nachgetrieben -- 
  Stachel fahren Christus Herz -- Kind alleine wütenden Weibe -- 
  Fuß stehen still -- streben heilig Ziel -- 
  unten Kilchstald -- Kapelle Auge -- glühten plötzlich mitten Weg -- regt Busch -- Weg sitzen Spinne -- busche wanken rot Federbusch -- heben Spinne alswie Sprunge -- 
  rufen Christ lauter Stimme dreieinig Gott -- Busche tönen wild Schrei -- schwanden rot Feder -- Bübchens arme legen Kind greifen -- Herr Geist empfehlend -- stark Hand Spinne -- -- gebannt heilig Wort -- gleich Fleck sitzenbleiben -- 
  Glut strömt Gebein -- halten fest -- Weg frei -- Bübch -- verständig Sinn -- eilt Priester Kind -- Christ -- Feuer stark Hand -- eilt geflügelt Lauf Haus -- 
  schrecklich Brand Hand -- Spinne Gift drang Glied -- 
  Glut Blut -- 
  Kraft erstarren -- Atem stocken -- beten Fort fort -- halten Gott fest Auge -- halten Hölle Glut -- 
  Haus -- Schmerz wachsen hoffen -- Türe Weib -- 
  Kind -- stürzen entgegen Tigerin -- Junge rauben -- glauben schändlichst Verrat -- 
  achtet Winken -- hört Wort keuchend Brust -- stürzen vorgestreckt Hand -- klammert -- Todesangst müssen Wütende schlepp Haus herein -- frei Arm kämpfen -- ehe gelingen -- alt Loch Spinne drängen -- sterbend Hand Zapfe vorschlagen -- 
  vermag_es Gott Hülfe -- 
  sterbend Blick werfen Kind -- Hold lächeln Schlafe -- 
  -- hoch Hand scheinen Glut löschen -- laut betend schließen Tod Auge -- Frieden Freude finden Gesicht -- vorsichtig angstvoll kommen -- schauen -- Weib bleiben -- 
  erstaunt sehen Loch verschlagen -- Weib finden versengt verzerren Tod liegen -- Christus Hand feurig Tod holen -- 
  stehen wissen -- geschehen -- Kind Bübch wiederkehrn -- Priester begleiten -- Kind schnell taufen damalig Sitt wohlgerüsten mutvoll gleich Kampfe entgegengehen -- Vorgänger siegreich Leben lassen -- 
  solch Opfer fordern Gott -- Kampf anderer bestehen -- 
  faßn Leute -- welcher Christ vollbringen -- 
  Glaube Erkenntnis -- beten freudig Priester -- danken Gott neu geschenkt Leben Kraft -- Christ geben -- 
  bat Tod Unrecht beschließen -- hoch Ehre begraben -- Andenken stellen glorreich heilig Seele -- 
  wissen -- -- schrecklich Schreck -- fort fort Glied zitteren -- geschwund Freude blau Himmel hinaufseh Angst -- Spinne kriechen unterdessen Fuß -- 
  beschließen Messe Kilchgang -- Leiche bestatt -- Christ Drängerin -- Stätte finden -- soweit -- 
  feierlich -- Tal Kirche wanderen -- Herz feierlich -- sünd erkennen -- manch Gelübde tun -- übertrieben Wesen Gesicht Kleid sehen -- 
  Kirche Kirchhofe Träne fließen -- Gebet geschehen -- gehen Talschaft -- Begräbnis kommen -- kommen -- Glied mächtig -- -- üblich Imbiß Wirtshaus -- 
  geschehen -- üblich Weiber Kind Tisch sitzen -- sämtlich erwachsen Mannschaft Platz berühmt scheibentische -- > Bären < Sumiswald sehen -- 
  Aufbewahret Andenken -- einst Dutzend Mann -- Tausend wohnen -- Andenken -- Leben Zweitausende Hand stehen -- Dutzend retten -- 
  säumt Gräbt -- herzen voll -- Speis Trank Platz -- 
  Dorfen hervor frei Höhe kommen -- sehen Röt Himmel -- heimkamen -- finden Haus niedergebrannt Boden -- zugegangen -- erfahren -- 
  Christ tun -- vergaß Leute -- Kind vergalten -- 
  Fromm Wacker Erzog frommst Haus -- vergriff Hand -- obgleich Rechnung sehen -- 
  gemehrt besorgt -- Kind aufwachsen -- betrog -- Seele -- 
  rechtschaffen -- gottesfürchtig Mensch -- Gnade Gott Wohlgefallen Mensch -- Segen Leben finden Himmel -- 
  bleiben Familie -- fürchten Spinne -- fürchten Gott -- -- -- Gott -- bleiben -- solange Haus stehen -- solange Kind Eltern folgen Gedanke -- -- 
  schweigen Großvater -- schwieg -- sann Gehörten -- meinen -- schöpf Atem fahren fort -- 
  alt Götti -- 
  -- Scheibentisch manchmal sitzen Sterbet gehören sämtlicher Mannschaft Gemeinde Platz -- 
  Punktum zugegangen -- sagen -- 
  stürmen -- 
  sagen -- vernehmen -- -- 
  -- He -- -- Großvater -- -- erbt Vater Sohn -- Andenken Leute Tale verlieren -- halten Familie heimlich scheut -- Mensch lassen -- 
  Familie reden -- Glied vergessen -- Haus bauet Haus zerstören -- Segen bringen Segen vertreiben -- 
  Hörst alte -- ungern -- öffentlich reden -- 
  dünken -- täte lang Nöter -- reden -- Hochmut Hoffart bringen -- 
  tun geheim Sache -- erstemal -- gut Freund erzählet -- 
  denken -- Familie Glücke erhalten -- schaden -- -- Geheimnis -- Glück Gott Segen bringen -- -- 
  -- -- Vettermann -- -- antworten Götti -- -- fragen -- Haus -- einrissest -- uralen -- 
  fast glauben -- -- 
  -- -- -- Großvater -- 
  -- uralt Haus baufällig fast dreihunderen -- Segen Gott Feld Matte Platz -- 
  Familie verlassen -- neu bauen -- vergessen -- früh ergehen -- 
  Verlegenheit fragt weis Mann -- Haslebach gewohnen -- Rat -- 
  antworten -- neu Haus können bauen Stelle alt anderswo -- Ding müssen bewahren -- alt Holz -- worin Spinne -- alt Sinn -- alt Holz Spinne schließen -- alt Segen Haus -- 
  bauten Haus fügen Gebet Sorgfalt alt Holz -- Spinne rühren -- Sinn Segen ändern -- 
  Haus wiederum alt klein -- wurmstichig faul Holz -- Posten bleiben fest eisenharen -- 
  Vater bauen -- erwehren -- -- 
  lang zögern wagen -- 
  Früher -- fügen alt Holz Haus -- Spinne regen -- 
  gestehen -- 
  Lebtag beten inbrünstig -- verhängnisvoll Holz Hand -- Hand -- Leib brennen -- unwillkürlich müssen sehen -- schwarz Flecken wüchsen Hand Leib -- Berg fallen Seele -- Ort stehen -- 
  Überzeugung fest -- weder Kind Kindeskind Spinne fürchten -- solange fürchten Gott -- -- 
  schweigen Großvater -- Schauer verflogen -- Rücken heraufgekrochen -- hören -- Großvater Holz Hand -- denken -- -- darein nehmen müssen -- 
  Vetter -- 
  -- schade -- wissen -- Ding -- 
  glauben -- Sache -- alt Holz -- -- 
  -- wollen -- können lernen -- jung Götti -- kurz -- dünk -- Kirche kommen -- 
  zuviel sagen -- Großmutter -- fang Alter Geschichte -- essen trinken -- schand -- essen trinken -- 
  sollen -- anwenden -- verstehen -- 
  gegessen -- trinken zwischendurch wechseln verständig Rede -- gold Himmel Mond stehen -- Stern Kammer treten -- mahn Mensch -- -- schlafen Kämmerlein -- 
  Mensch sehen geheimnisvoll Mahner -- sitzen heimelig -- klopfen unheimlich unter Brusttuch -- an heimgehen denken -- -- -- 
  stehen Gotte schicken zitternd Herz weggehen -- fehlt sicher Begleiter -- miteinander verließ Gesellschaft gastlich Haus gut Wunsch -- Bitte einzeln -- Gesamtheit -- lang bleiben -- finst -- Trotz -- 
  still um Haus -- still -- 
  friedlich liegen -- rein schön glänzt Mond Schein Tal entlang -- sorglich freundlich Barg brav Leute süß Schlummer -- schlummern -- Gottesfurcht Gewissen Busen tragen -- schwarz Spinn -- freundlich Sonne Schlummer wecken -- 
  Sinn wohnen -- Spinn regen -- weder Nacht -- 
  -- Sinn ändern -- wissen -- wissen Kraft zuteilen -- Spinnen Mensch -- 