alt längst verfloßener Lebte wild Einsam Forst Fuldaischen Gebiet wacker Jägersmann -- Anderes Name -- 
  Leibjäger Herr Grafe Aloys Vach -- weit Reise schön Welschland begleiten -- -- unsicheren Königreich Neapel Straßenräubern anfallen -- Klugheit Tapferkeit Lebensgefahr retten -- 
  Wirtshause Neapel -- eingekehren -- befinden armes -- bildschön Mädchen -- Hauswirt -- Waise aufnehmen -- hart behandeln niedrigst Arbeit Hof Küche brauchen -- 
  anderer suchen -- verständlich -- trostreich Wort aufzuricht -- Mädchen fassen Liebe -- trennen -- mitzieh kalt Deutschland -- 
  Graf Vach -- rühren Anderes -- Bitte Giorgina Träne -- erlauben -- geliebt anderesr Kutschbock setzen -- beschwerlich Reise -- 
  -- Grenze Italien hinauskommen -- lassen anderesr Giorgina trauen zurückgekehrt Gut grafer vach -- glauben treu Diener belohnen -- Revierjäger ernennen -- 
  Giorgina alt Knecht ziehen einsam rauh Wald -- schützen wider Freijäger Holzdiebe -- 
  Stadt geholt Wohlstand -- Graf Vach verheißen -- führen beschwerlich -- mühselig -- dürftig Leben geraten Kummer Elend -- 
  Lohn barem Geld -- Grafe erhalten -- reichen -- Giorgina kleiden -- gering Gefall -- Holzverkäufen zukamen -- selten ungewiß Garten -- Bebauung Benutzung angewiesen -- verwüstet Wölfe wild Schwein -- Knecht Hut -- -- bisweilen Nacht letzter Hoffnung Lebensunterhalt vereiteln -- 
  Leben stets bedrohen Holzdieben Freischütz -- 
  Lockung Widerstand wacker fromm Mann -- darben -- ungerecht bringen verwaltet Amt getreulich tapfer -- stellen gefährlich Weise -- treu Dogg schützt nächtlich Überfall Raubgesindel -- 
  Giorgina -- Klimas Lebensweise wild Forst ungewohnen -- welken zusehends -- 
  bräunlich Gesichtsfarbe verwandeln fahl Gelb -- lebhaft blitzend Auge düster -- voll -- üppig Wuchs mageren -- 
  erwacht Mondheller Nacht -- 
  Schuß kracht Ferne Wald -- Dogg heulen -- leise erheben Mann Lager schlich Knecht murmelnd hinaus Forst -- 
  beten inbrünstig Gott heilige -- treu Mann erretten möchten schrecklich Einöde stet Todesgefahr -- 
  Geburt Knabe werfen Giorgina Krankenlager -- schwach schwach werdend -- Auge -- 
  Dumpf hinbrütend -- schlich unglücklich Anderer umh -- Glück Krankheit Weibe gewichen -- 
  neckend -- gespenstisch Wesen guckt Wild Büschen -- Gewehr abdrücken -- verstoben Luft -- 
  Tier treffen Knecht -- geübt Schütze -- beschaffen Wild -- Grafe Vach liefern halten -- 
  einst sitzen Giorgina Bette -- starr Blick geliebt Weib richten -- ermatten Tod atmen -- 
  dumpf -- lautlos Schmerz Hand fassen hört Ächz Knabe -- nahrungslos verschmachten -- 
  Knecht früh Fulda -- letzter Ersparni Erquickung kranke herbeizuschaffen -- 
  menschlich tröstend Wesen breit finden -- Sturm heuln schneidend Tön entsetzlich Jammer schwarz Tann Dogg winselten -- trostlos Klage -- unglücklich Herr -- 
  hören anderesr Haus Dacherschreit -- menschlich Fußtritt -- 
  glauben -- zurückkehrend Knecht -- unerachten früh erwarten -- Hund springen heraus bellten heftig -- 
  müssen Fremder -- 
  anderesr Tür -- 
  treten lang -- hager Mann entgegen -- grau Mantel -- Reisemütze tief Gesicht drücken -- 
  -- Ei -- -- Fremde -- -- Walde irre gehen -- 
  Sturm toben Berg herab -- bekommen schrecklich Wetter -- 
  Möchtet erlauben -- Herr -- euer Haus eintret beschwerlich Weg erholen erquicken dürfen Reise -- -- 
  -- -- Herr -- -- erwidern betrübt andere -- -- Haus Not Elend Stuhl -- ausruhen -- vermögen Erquickung anbieten -- arm krank Weib mangeln -- Knecht -- Fulda schicken -- spät Abend Labung herbeibringen -- -- 
  Wort Stube treten -- 
  Fremde legt Reisemütz Mantel -- Felleisen Kistchen tragen -- 
  ziehen Stilett paar Terzerole hervor -- Tisch legen -- 
  anderesr Giorgina Bett treten -- liegen bewußtloser Zustande -- 
  Fremde treten ebenfalls hinzu -- schaut kranke scharfen -- bedächtig Blick ergreifen Hand -- Puls sorglich erforschend -- 
  andere voll Verzweiflung ausraufen -- -- Gott -- sterben -- -- fremde -- 
  -- nicht -- Freund -- ruhig -- 
  Euerem Weibe fehlen kräftig -- Nahrung -- Hand -- reizen stärken -- Dienst -- 
  Arzt -- vielmehr Kaufmann -- Arzneiwissenschaft unerfahren -- besitzen uralt Arkanum -- führen verkaufen -- -- 
  öffnet Fremd kistch -- holen Phiole heraus -- tröpfelen dunkelrot Liquor Zucker kranke -- 
  holt Felleise geschliffen Flasche köstlichen Rheinwein flößt kranke paar Löffel voll -- 
  Knabe -- befehlen -- dicht Mutter Brust gelehnen Bette legen Ruhe überlassen -- 
  anderer zumute -- Heiliger herabgestieg Einöde -- Trost Hülfe bringen -- 
  Anfangs stechend -- falsch Blick Fremden abschrecken -- sorglich Teilnahme -- augenscheinlich Hülfe -- arm Giorgina leisten -- hingezogen -- 
  erzählt fremde unverhohlen -- Gnade -- Herr -- Graf Vach -- angedeihe lassen -- Not Elend gerat Leben drückend Armut Dürftigkeit -- 
  Fremd trösten meinen -- unverhofft Glück Hoffnungslosesten Güter Leben bringen -- wagen müssen -- Glück dienstbar -- 
  -- Herr -- -- erwidern andere -- -- vertrau Gott Fürsprache heilige -- -- treu Weib -- Inbrunst beten -- 
  -- Geld verschaffen -- 
  Gott Weisheit bescheiden -- sündlich -- trachn -- Welt Güter gelangen -- arm Weibe halber wünsch -- schön Vaterland verlassen -- wild Einöde folgen -- -- Leib Leben wagen schnöder -- Weltlich -- -- 
  Fremd lächelt Rede frommen anderer seltsam Weise Begriff -- erwidern -- Giorgina tief Seufzer Schlaf -- versinken -- erwachen -- 
  fühlen wunderbarlich stärken -- Knabe lächelen Hold lieblich Brust -- 
  anderesr Freude -- weinen -- beten -- jubelt Haus -- 
  Knecht indessen zurückgekommen bereiten -- vermögen -- mitgebracht Lebensmittel Mal -- Fremde teilnehmen -- 
  fremd kocht Kraftsuppe Giorgina -- -- allerlei Gewürz Ingredienzie hineinwerfen -- tragen -- 
  Abend -- Fremde müssen Andere übernachten -- bitten -- Stube -- Anderer Giorgina schlafen -- Strohlager bereiten mögen -- 
  geschehen -- 
  anderesr -- Besorgnis Giorgina schlafen lassen -- bemerken -- Fremd beinahe stark Atemzug Giorgina Auffuhr -- stündlich Aufstand -- leis Bette nähern -- Puls erforscht Arznei eintröpfelen -- 
  angebrochen -- Giorgina zusehends -- 
  anderer danken fremde -- Schutzengel nennen -- Fülle Herzens -- 
  Giorgina äußern -- -- inbrünstig Gebet -- Gott senden Rettung -- 
  fremd scheinen lebhaft Ausbrüche Dank gewiß Art beschwerlich fallen -- sichtlich verlegen äußern Mal -- Unmensch müssen -- kranke Kenntnis Arzneimittel -- führen -- beistehen -- 
  anderesr -- verpflichten -- -- Not unerachten -- Haus herrschen -- gastlich aufnehmen -- wollen keineswegs Pflicht unerfüllt lassen -- 
  ziehen wohlgefüllt Beutel hervor Goldstücke heraus -- andere hinreichen -- 
  -- Ei Herr -- -- anderes -- -- wofür vieler Geld annehmen -- 
  Haus beherbergen -- wild weitläufig Forst verirren hatten -- Christenpflicht -- dünken Dank wert -- überreich -- -- Wort sagen -- belohnen -- weis kunsterfahren Mann lieb Weib augenscheinlich Tod retteten -- 
  Herr -- tun -- ewiglich vergessen -- Gott mögen verleihen -- edl Leben Blut lohnen können -- -- 
  Wort wackeren andere fahren rasch funkelnd Blitz Auge fremde -- 
  -- müßt -- brav Mann -- -- sprechen -- -- Geld annehmen -- 
  Euerem Weibe schuldig -- bess Nahrungsmittel Pflege verschaffen -- bedürfen nunmehr -- vorig Zustand zurückzufallen -- Euerem Knabe Nahrung geben -- -- 
  -- -- Herr -- -- erwidern andere -- -- verzeihen -- innerer Stimme -- euer unverdient Geld nehmen -- 
  innerer Stimme -- -- hoch Eingebung Schutzheilig -- vertrauen -- sicher Leben führen beschützen Gefahr Leib Seele -- 
  großmütig handeln arme übrig -- lassen Fläschlein Eurer wundervoll Arznei -- Kraft Weib genese -- -- 
  Giorgina richten Bette -- schmerzvoll wehmütig Blick -- anderes werfen -- scheinen ansehen -- diesmal streng innerer Widerstrebe -- Gabe mildtätig Mann annehmen -- 
  Fremde bemerken sprechen -- 
  -- Geld annehmen -- schenk Euerem lieben Weib -- gut Wille -- bitter Not retten -- verschmähen -- -- 
  greifen Beutel -- Giorgina nähernd -- Geld -- vorhin anderes anbieten -- 
  Giorgina schön funkelnd Gold Freude leuchtend Auge -- Wort Dank herausbring -- hell Träne schießen Wang herab -- 
  Fremde wenden schnell weg -- sprechen andere -- 
  -- Seht -- Mann -- 
  können Gabe getrost annehmen -- groß Überfluß mitteilen -- 
  gestehen -- -- scheinen -- 
  schlichen Kleidung -- dürftig wandernd Krämer Fuß reise -- glauben gewiß -- arm kümmerlich klein Verdienst Messe Jahrmärkt nähren -- 
  sagen -- glücklich Handel trefflichst Kleinodie -- treiben -- reich Mann -- einfach Lebensweise alt Gewohnheit beibehalten -- 
  Felleisen kistch bewahr Juwele köstlich -- grau Altertum geschnitten Stein -- -- Tausend wert -- 
  diesmal Frankfurt glücklich Geschäft -- hundertst Gewinn -- Euerem lieben Weib schenken -- 
  Überdem geben Geld keineswegs umsonst -- verlangen allerlei Gefälligkeit -- 
  -- gewöhnlich -- Frankfurt Kassel Schlüchter richtig Weg -- 
  indessen finden -- Weg Forst -- reisend scheuen -- Fußgänger anmutig -- weshalb künftig gleich Reise Straße einschlagen einsprechen -- 
  jährlich zweimal eintreffen sehen -- nämlich Ostern -- Frankfurt Kassel wandern -- spät Herbst -- Leipziger Michaelismesse Frankfurt Schweiz Welschland gehen -- 
  sollen Bezahlung -- -- beherberg Gefälligkeit -- ersuchen -- 
  ferner bitte -- Kistch -- worin -- Kassel brauchen -- wandern hinderlich -- behalten -- künftig Herbst einsprechen -- 
  verhehlen -- Tausend wert -- groß Sorglichkeit empfehlen -- treu Frömmigkeit -- legen -- zutrauen -- Geringst -- zurückließen -- sorgfältig aufbewahren würden -- zumal Sache solch groß Wert -- -- kistch verschließen -- sicherlich -- 
  sehen -- Dienst -- ford -- 
  -- verlangen -- schwer fallen -- unerachten nötigsten tun -- 
  sollen euer lieb Weib verlassen Forst Straße Hirschfeld geleiten -- bekannte einsprech Reise Kassel fortsetzen -- 
  -- Wege Forst kundig zweitenmal verirren -- wacker Mann -- -- aufnehmen -- Gegend geheuer -- 
  Jägersmann Gegend anhaben -- -- einsam Wanderer -- gefährden -- 
  sprechen Frankfurt -- Räuberbande -- Gegend Schaffhausen unsicher Straßburg herauf ausdehnt -- nunmehr Fuldaische werfen -- Leipzig Frankfurt reisend Kaufleut reicheren Gewinst versprechen -- finden -- 
  -- Frankfurt reichen Juwelenhändler kennen -- Hab Rettung Eure Weibe verdienen -- reichlich lohn -- Forst Weg Steg leiten -- -- 
  anderesr Freude bereit -- erfüllen -- verlangen -- -- Fremde wünschen -- Wanderung fertig -- Jägeruniform anziehen -- Doppelbüchse tüchtigen Hirschfänger umschnallt Knecht befehlen -- Dogg anzukuppeln -- 
  Fremd unterdessen Kistch öffnen prächtigst Geschmeid -- Halskett -- ohrringe -- Spang herausnehmen -- Giorgina Bette ausbreiten -- Verwunderung Freude bergen -- 
  Fremd auffordern -- schön Halskett umzuhäng -- reich Spang wunderschön geformt Ärm streifen -- Taschenspiegel vorhalten -- worin Herzenslust beschauen -- kindisch Lust aufjauchzen -- Anderer fremde -- 
  -- Herr -- möget arm Weibe Lüsternheit erregen -- Ding putzen -- nimmermehr zukommen -- anstehen -- 
  Nehmt übel -- Herr -- einfach rot Korallenschnur -- Giorgina Hals hängen -- erstenmal Neapel -- tausendmal -- funkelnd blitzend Geschmeid -- eitel trügerisch vorkommen -- -- 
  -- -- streng -- -- erwidern Fremde höhnisch lächelnd -- -- Euerem Weibe Krankheit unschuldig Freude lassen -- schön Geschmeide herauszuputzen -- keineswegs trügerisch -- wahrhaft echt -- 
  Wißt -- Weiber Ding Freude verursachen -- 
  -- Prunk Eurer Giorgina zukommen -- Gegenteil behaupten -- euer Weib hübsch -- herauszuputzen wißen -- reich -- dergleich Schmuck besitzen tragen -- -- 
  Anderes sprechen ernst nachdrücklichen Ton -- -- bitte -- Herr -- führen geheimnisvoll verfänglich Rede -- 
  arm Weib betören -- eitl Gelüst weltlich Prunk Staat drückend Armut fühlen Lebensruhe -- Heiterkeit bringen -- 
  Packt euer schön Sache -- Herr -- treulich bewahren -- zurückkommen -- 
  -- -- Himmel verhüten mögen -- 
  unterdessen Unglück zustoßen -- zurückkehrten Haus -- wohin Kistch abliefern -- warten -- ehe Juwele einhändige -- nennen -- euer Name bitte -- -- 
  -- -- heißen -- -- erwidern Fremde -- -- Ignaz Denner -- -- Wisset -- Kauf Handelsmann -- 
  weder Weib -- Kind -- verwandte wohnen Walliser Land -- 
  keineswegs lieben -- -- arm bedürftig -- kümmern -- 
  sehen lassen -- behalten Kistchen ruhig -- wissen -- -- Giorgina -- sträuben -- reich Vermächtnis annehmen -- schenk Fall Kästchen Kleinodie Euerem Knabe -- -- firmeln lassen -- Name Ignatius beizugeben bitte -- 
  -- anderes wissen -- selten Freigebigkeit Großmut fremd Mann -- 
  stehen verstummen -- indes Giorgina gut Wille danken versichern -- Gott heilig fleißig beten -- weit beschwerlich Reise beschützen stets glücklich Haus zurückführen möchten -- 
  Fremd lächelen -- Art -- seltsam Weise meinen -- Gebet schön Frau Kraft mögen -- seinig -- 
  Bete wollen überlassen kräftig abgehärtet Körper gut Waffe vertrauen -- 
  frommen Andere mißfiel Äußerung fremde höchlich -- indessen verschweigen -- erwidern Begriff stehen -- treiben vielmehr fremde -- Wanderung Forst beginnen -- Nacht Haus zurückkehren Giorgina Furcht Angst setzen -- 
  fremd Abschied Giorgina -- ausdrücklich erlauben -- -- Vergnügen machen -- Geschmeide schmücken -- ohnedies einsamen wild Forst Belustigung mangle -- 
  Giorgina erröten inner Vergnügen -- freilich Nation Lust glänzend Staat vorzüglich kostbar Stein unterdrücken -- -- 
  schritt Denner Anderes rasch vorwärts finsteren öd Wald -- 
  dickst Gebüsch schnuppert Dogg umh klafft -- Herr klug beredt Auge anschauend -- 
  -- geheuer -- -- sprechen Anderes -- spannt Hahn Büchse schreiden hunden bedächtig fremd Kaufmann -- 
  -- rausch Baum erblickt Ferne finster Gestalt -- Gebüsch verschwinden -- 
  Dogg loskuppeln -- 
  -- Tut -- Mann -- -- rufen Denner -- -- versichern -- mindeste fürchten -- -- 
  Wort sprechen -- Schritt schwarz Kerl struppig Haar groß Knebelbart -- Büchse Hand -- Gebüsch heraustrat -- 
  anderesr schußfertig -- -- schießen -- schießen -- -- rufen Denner -- schwarz Kerl nicken freundlich verlieren Bäumen -- 
  Walde heraus -- lebhaft Landstraße -- 
  -- danken herzlich euer Geleit -- -- sprechen Denner -- -- kehren euer Wohnung -- Gestalt aufstoßen -- sehen -- ziehen ruhig euer Straße fort -- kümmern -- 
  Tut -- bemerkten -- behalten euer Dogg Strick -- Gefahr eur Wohnung erreichen -- -- 
  anderes wissen -- wunderlich Kaufmann denken -- -- Geisterbeschwörer -- Feind bannen abhalten scheinen -- 
  begreifen -- Wald geleiten lassen -- 
  getrost schreiten Anderer Forst -- stoßen Verdächtig wohlbehalten Haus -- Giorgina -- munter kräftig Bette -- voll Freude Arm fallen -- 
  Freigebigkeit fremd Kaufmann bekommen Haushaltung anderesr Gestalt -- 
  nämlich Giorgina genesen -- Fulda nötigsn Bedürfnisse Stück einkaufen -- häuslich Einrichtung abgehen wodurch ansehen gewiß Wohlstand erhalten -- 
  -- Besuch Fremden Freijäger Holzdiebe Gegend bannen scheinen -- Anderer Posten ruhig vorstehen -- 
  Jagdglück wiedergekehren -- -- -- beinahe niemals Fehlschuß -- 
  Fremde stellen Michaelis bleiben -- 
  hartnäckig Weigerung Wirtsleute unerachten freigebig -- erstemal -- 
  versichern -- Absicht -- Wohlstand versetzen -- Absteigequartier Walde freundlich angenehm -- 
  bildhübsch Giorgina kleiden -- gestehen anderesr -- Fremde zierlich gearbeitet golden Nadel -- Mädchen Weiber Gegend Italien Zöpfen zusammengeflochten aufgewirbelt Haar stecken pflegen -- beschenken -- 
  andere ziehen finster Gesicht -- Augenblick Giorgina Tür herausgesprungen dauern -- kehren kleiden schmücken -- anderesr Neapel sehen -- 
  schön golden Nadel prangt schwarz Haar -- malerisch Sinn bunt Blume geflochten -- Anderer müssen gestehen -- Fremd Geschenk sinnig wählen -- Giorgina wahrhaft erfreuen -- 
  anderer äußern unverhohlen Giorgina meinen -- Fremde Schutzengel -- tief Dürftigkeit Wohlstande erheben -- begreifen -- Anderer wortkarg -- verschließen fremd traurig -- kehren -- bleiben können -- 
  -- -- lieb Herzensweib -- -- sprechen andere -- -- innerer Stimme -- laut -- fremde annehmen dürfen -- schweigen keineswegs -- 
  innerer Vorwurf martern -- -- Gelde fremd unrecht Haus kommen freuen -- anschaffen -- 
  öfter kräftig Speise -- Glase Wein erlaben -- glauben -- lieben Giorgina -- holzverkauf vorgefallen lieb Gott paar verdient Grosch bescheren -- gewöhnlich -- schmeckt Glas gering Wein -- Wein -- Fremde mitbringen -- 
  sonderbaren Kaufmann befreunden -- Gegenwart unheimlich zumute -- 
  bemerken -- lieben Giorgina -- fest anschauen vermögen -- 
  blitzen zuweilen tiefliegend Auge sonderbar heraus -- unser schlichten Rede -- bübisch sagen -- lachen -- eiskalt überläufen -- -- 
  -- möchten innerer Gedanke -- -- liegen allerlei schwarz Unheil Hintergrunde -- Fremde einemmal hervorrufen -- künstlich Schling gefangen -- -- 
  Giorgina suchen Mann schwarz Vorstellung auszureden -- versichern -- vaterlande vorzüglich Pflegeelter wirtshause -- Person kennen lernen -- Äußere widrig -- unerachten grundgut Mensch -- 
  anderer scheinen trösten -- inneren beschließen Hut -- 
  Fremde sprechen andere -- Knabe -- wunderschön Kind -- Mutter Ebenbild -- Monat alt -- 
  Giorgina Namenstag -- fremdartig sonderbar herausputzen -- lieb neapolitanisch Tracht werfen besseres Mal -- gewöhnlich -- bereiten -- wozu Fremde Flasche köstlichen Wein Felleis hergab -- 
  fröhlich Tisch sitzen Knabe solch wunderbar verständig Auge umherblickt -- heben Fremde -- 
  -- euer Kind versprechen besonderer Wesen schaden -- imstande -- gehörig erziehen -- 
  Vorschlag -- verwerfen -- unerachten Bedenken möchten -- eu Glück -- euren Wohlstand bezwecken -- 
  wißen -- reich Kind -- fühlen besonderer Liebe Zuneigung eur Knabe -- geben -- -- 
  bringen Straßburg -- Freundin -- alt ehrbar Frau -- gut erzog Freude -- 
  eur Kind Last frei -- müßt eur Entschluß schnell fassen -- nötigen -- abend abzureisen -- 
  arme tragen Kind nächster Dorf -- nehme Fuhrwerk -- -- 
  Wort fremd reißen Giorgina Kind -- Knien schaukeln -- hastig fort drücken Busen -- Träne Auge treten -- 
  -- Seht -- Herr -- -- sprechen andere -- -- Frau euer Vorschlag antworten -- sinnen -- 
  euer Absicht -- möget Liebste rauben -- Erde besitzen -- möget Last nennen -- Leben aufheitern -- sein tief Dürftigkeit -- euer Güte gerissen -- 
  sehen -- Herr -- 
  sagten -- Frau Kind wäret -- Seligkeit fremd -- gleichsam Glorie offen Himmelreich herabströmt Mann Weib Geburt Kind -- 
  rein Liebe Himmelswonne -- Eltern erfüllen -- Kind schauen -- stumm still Mutter Brust liegend -- beredten Zunge Liebe -- hoch Lebensglück sprechen -- 
  -- -- Herr -- 
  Wohltat -- erzeigen -- wiegen -- Kind wert -- gäbe Schatz Welt -- Besitz gleichzustellen -- 
  Scheltet undankbar -- Herr -- euer Ansinnen abschlagen -- 
  Wäret Vater -- bedürft Entschuldigung -- -- 
  -- -- -- -- -- erwidern Fremde -- finst seitwärts blicken -- -- glauben wohlzutun -- euer Sohn reich glücklich -- 
  zufrieden -- Rede -- -- 
  -- Giorgina küssen herzt Knabe -- Gefahr erretten -- wiedergeben -- 
  Fremde streben sichtlich unbefang heit scheinen -- merken indessen deutlich -- Weigerung Wirtsleute -- Knabe geben -- verdrossen -- 
  Stadt -- -- Abend fortzureisen -- bleiben -- -- Giorgina verweilen -- anderesr Jagd ziehen Gelegenheit Grafe Aloys Vach erzählen lassen -- 
  Folge Ignaz Denner Freund Anderer einsprachn -- dachen Plan -- Knabe nehmen -- 
  Art freundlich vorher -- fahren fort -- Giorgina reichlich beschenken -- überd wiederholt auffordert -- Lust Juwele Kistch -- Anderer Verwahrung geben -- schmücken -- heimlich -- 
  Denner -- -- Knabe spielen -- Sträubt weinen -- fremde -- wissen feindlich Anschlag -- Eltern entführen -- -- 
  hindurch Fremde Wanderung andere besuchen -- Gewohnheit Scheu -- mißtrauen wider Denner überwinden -- Anderer Wohlstand ruhig heit Genoß -- 
  Herbst Jahres -- -- Denner gewöhnlich einzuspreceh pflegen -- vorüber -- pocht stürmisch Nacht hart Andr -- Tür -- mehrere rauh Stimme rufen Name -- 
  erschrocken springen Bette -- Fenster herausfragen -- finster Nacht stör Dogg loslassen -- ungebeten Gast wegzuhetzen -- -- mögen aufmachen -- Freund -- Anderes erkennen Denner Stimme -- 
  Licht Hand Haustür öffnen -- treten Denner entgegen -- 
  Anderes äußern -- vorkommen -- mehrere Stimme Name rufen -- Denner meinen -- Anderer heulen Wind täuschen müssen -- 
  Stube treten -- erstaunen anderes -- Denner nah betrachtet verändert Anzug gewahr -- 
  Stadt grau schlicht Kleidung Mantel tragen dunkelrotes Wam breit ledern Gurt -- Stilett Pistolen staken -- Säbel bewaffnen -- Gesicht scheinen verändern -- glatt Stirn buschig Augenbraue liegen stark schwarz Bart Lippe Wang ziehen -- 
  -- andere -- -- sprechen Denner -- funkelnden Auge anblitzen -- -- anderesr -- beinahe Weib Tod erretten -- wünschtest -- Gott verleihen mögen -- erzeigen Wohltat Blut Leben lohnen -- 
  Wunsch erfüllen -- nunmehr Augenblick kommen -- Dankbarkeit -- Treue beweisen -- 
  Kleide -- nimm Büchse kommen -- Schritt Wohnung sollst übrig erfahren -- -- 
  anderes wissen -- Denner Zumutung halten -- Wort -- vorhieln -- indessen Eingedenk -- versichern -- bereit -- möglich Unternehmen -- sobald Rechtschaffenheit -- Tugend Religion zuwiderlaufen -- 
  -- ruhig -- -- rufen Denner -- lächelnd Schulter klopfen -- bemerken -- Giorgina aufgesprungen -- Angst zitternd bebend Mann umklammert -- arme sprechen -- sanft zurückziehend -- 
  -- lassen euer Mann ziehen -- weniger Stunde gesund -- bringen Schöne -- Hab jemals böse meinen -- -- verkannten -- erzeigen -- 
  Wahrhaftig -- besonderer mißtrauisch Leute -- 
  -- anderesr zauderte anzukleid -- wenden Denner sprechen zornig Blick -- 
  -- hoff Zusage halten -- gelten nunmehr -- beweisen -- sprechen -- -- 
  Schnell anderer angekleiden -- Denner Türe herausschreiten -- sprechen -- -- -- Herr -- -- Unrechtes fordern -- Kleinst -- wider Gewissen liefe -- vollbringen -- -- 
  Denner antworten -- Schritt rasch vorwärts -- 
  Dickicht gedrung ziemlich geräumig Rasenplatz -- Pfiff Denner dreimal -- Ton ringsumh schaurig Klüft widerhalln überall Büschen flackert Windlichter rauscht klirrt dunkel Gänge -- schwarz gräßlich Gestalt gespenstisch hervordrängt Denner Kreis umringen -- 
  Kreis treten hervor sprechen Anderer hindeutend -- 
  -- neu Geselle -- Hauptmann -- -- 
  -- -- -- -- antworten Denner -- -- Bette holen -- Probestück -- vorwärts -- -- 
  anderer erwachen Wort dumpf Betäubung -- kalt Schweiß stehen Stirn -- ermannte rufen heftig -- 
  -- -- schändlich Betrüger -- Kaufmann gabst -- treibst höllisch verrucht Gewerbe -- verworfen Räuber -- 
  Nimmermehr Geselle teilnehmen dein Schandtate -- -- Satan -- künstlich hämisch Weise verlocken wolltest -- -- 
  Laß fort -- frevelhaft Bösewicht -- räum Rotte Gebiet -- verrat Schlupfwinkel Obrigkeit -- bekommsen Lohn Schandtate -- wissen -- schwarz Ignaz -- Bande Grenze gehaust rauben -- morden -- -- 
  lassen fort -- schauen -- -- 
  Denner lachen laut -- 
  -- -- feig Bube -- -- sprechen -- -- unterstehst -- trotzen -- Wille -- Machtwort entziehen -- 
  längst Geselle -- lebst beinahe unser Gelde -- schmücken Weib unser Raube -- 
  stehst arbeiten genießen -- 
  Folgst -- zeigst unser rüstig Kumpan -- lassen binden Höhle werfen Geselle ziehen Wohnung -- zünden ermord Weib deinen Knabe -- 
  Maßregel -- Folge Halsstarrigkeit -- ergreifen -- 
  -- -- wählen -- -- 
  -- fort -- -- 
  -- anderesr -- minde Weigerung geliebten Giorgina Knabe Leben kosten -- verräterisch bübisch Denner innerer Hölle verfluchend -- beschließen -- Wille scheinbar fügen -- rein Diebstahl Mord bleiben tief Eindring Schlupfwinkel Bande benutzen -- günstig Gelegenheit Aufhebung Einziehung bewirken -- 
  still gefaßt Entschluß erklären Denner -- trotz innerer Widerstreben Dankbarkeit Giorgina Rettung verpflichten -- wagen -- wollen Expedition mitmachen -- wobei bitte -- Neuling -- soviel tätig Anteil verschonen -- 
  Denner loben Entschluß -- hinzufügen -- keineswegs verlangen -- förmlich Bande übertreten sollen -- vielmehr müssen Revierjäger bleiben -- Bande groß Nutzen -- künftig Fall -- 
  Geringeres absehen -- Wohnung reich Pachter -- Dorfe abgelegen -- unfern Walde -- stehen -- überfallen auszuplündern -- 
  wissen -- Pachter Gelde Kostbarkeit -- besitzen -- verkauft Getreide bedeutend Summe einnehmen -- bewahrt versprach Räuber reichen Fange -- 
  Windlichter auslöschen still ziehen Räuber eng Schleichweg -- dicht Gebäude stehen -- Bande umringen -- 
  steigen Mauer -- sprengt innen Hoftor -- Wache ausstellen -- befinden Anderes -- 
  hören -- Räuber Tür erbrach Haus stürmen -- vernehmen Fluchen -- Geschrei -- Geheul Mißhandelt -- 
  fallen Schuß -- Pachter -- beherzt Mann -- Wehr setzen -- still -- aufgesprengt Schloß klirren -- Räuber schleppn Kist Hoftor heraus -- 
  Pachter Leute müssen Finsternis entwischen Dorf rannen -- tönt Sturmglocke Nacht -- strömt Haufe hellauflodernd Lichter Straße herauf Pachterwohnung -- 
  fallen Schuß Schuß -- Räuber sammeln Hof strecken nieder -- Mauer nähern -- 
  Windfackel anzünden -- 
  anderesr -- Anhöhe stehen -- übersehen -- 
  entsetzen erblickt Bauer -- Jäger Liverei Herr -- Grafe Vach -- -- 
  -- -- 
  begeben -- unmöglich -- schnell Flucht retten -- festgezaubern stehen hinstarrend Pachterhof -- Gefecht mörderischer -- Pforte Seite Vachsche Jäger gedrung Räuber Handgemein -- 
  Räuber müssen -- drängen fechtend Tor Gegend -- Anderes stehen -- 
  Denner -- unaufhörlich laden Schoß niemals fehlen -- 
  jung reichgekleidet Mann -- vachsch Jäger umgeben -- scheinen Anführer -- legen Denner -- ehe abdrückt -- stürzen Kugel treffen dumpf Schrei nieder -- 
  Räuber fliehen -- stürzt vachsch Jäger herbei -- springen -- unwiderstehlich treiben -- andere herbei rettet Denner -- -- stark -- Schulter werfen schnell forteiln -- 
  verfolgen -- erreichen glücklich Wald -- 
  einzeln Schuß fallen still -- Zeichen -- Räuber -- verwunden Platz liegen bleiben -- geglücken -- Wald entkomm Jäger Bauer ratsam scheinen -- Dickicht einzubrechen -- 
  -- Setze nieder -- Anderer -- 
  -- sprechen Denner -- -- Fuß verwunden verdammen -- umstürzen -- -- unerachten Wunde schmerzen -- glauben -- bedeutend -- -- 
  anderesr -- Denner holen Phiole Tasche öffnen -- strahlen hell Licht heraus -- Anderer Wunde genau untersuchen -- Denner -- stark Streifschuß Fuß treffen -- stark bluten -- 
  Anderes verbinden Wunde Schnupftuch -- Denner lassen Pfeif ertön -- Ferne antworten bitten anderes -- sacht schmal Waldweg heraufzuführen -- Ort Stelle -- 
  dauern -- sehen Schein Windlichter dunkel Gebüsch brech Rasenplatz erreichen -- ausgegang übriggeblieben Räuber versammeln finden -- 
  jauchzn Freude -- Denner treten rühmt andere -- -- tief kehren -- Wort vorbringen vermögen -- 
  finden -- Hälfte Bande tot -- hart verwunden Platz liegen bleiben -- indessen Räuber -- bestimmen -- Raub Sicherheit bringen -- mitten Gefecht mehrere Kist kostbar Gerät -- ansehnlich Summe Geld -- fortzuschaffen wissen -- -- unerachten Unternehmen schlimm ausgehen -- Beute ansehnlich bleiben -- 
  nötige besprechen -- wenden Denner -- unterdessen ordentlich verbinden -- Schmerz fühlen scheinen -- Anderer sprechen -- 
  -- weib Tod erretten -- Nacht Gefangenschaft entziehen folglich gewiß Tod befreien -- Quitt -- 
  Wohnung zurückkehren -- 
  nächster -- -- verlassen Gegend -- ruhig -- Ähnliches -- -- zumuten -- 
  gottesfürchtig Narr brauchbar -- 
  indessen billig -- heutig Raube nehmest überd Rettung belohnen Werdest -- 
  Nimm Beutel Gold behalten gut Andenken -- über Hoffe einsprechen -- -- 
  -- -- Gott Herr behüten -- -- erwidern Anderer heftig -- -- Pfennig Eurem schändlich Raube nehmen -- 
  abscheulichst Drohung zwingen mitzugehen -- ewiglich bereuen -- 
  sünd -- -- schändlich Bösewicht -- gerecht Strafe entziehen -- Gott Himmel Langmut verzeihen -- 
  -- flehen Augenblick Giorgina Leben -- ihrig erretten -- -- Gefahr Leben Ehre -- Weh Weibe Kind auf Spiel setzend -- Gefahr entriß -- 
  sprich -- -- verwunden -- arm Weibe -- Knabe -- erschlag verrucht Mörderband finden -- -- 
  überzeugen -- -- Gegend verläsesen -- einzig geschehen Raub -- Mord kund -- augenblicklich Fulda gehen Obrigkeit Schlupfwinkel verraten -- -- 
  -- Räuber Anderes herfallen -- Rede züchtigen -- Denner verbieten -- -- -- lassen albern Kerl schwatzen -- tun -- -- andere -- -- fahren Denner fort -- -- Gewalt -- Weib Knabe -- 
  sowohl -- -- ungefährdet bleiben -- versprichst -- ruhig Wohnung halten Mitwissenschaft Vorfall Nacht gänzlich schweigen -- 
  letzter rat -- Rache furchtbar treffen überd Obrigkeit Hülfe -- -- Reichtum nossesen -- hingehen lassen -- 
  versprech -- Gegend gänzlich räumen Bande Unternehmen ausführen -- 
  -- anderesr notgedrungen Bedingung Räuberhauptmann eingehen Feierlich versproch schweigen -- Räuber wildverwachsen Fußsteige breit Waldweg führen längst hell -- Haus treten Sorge Angst totenbleich Giorgina umarmen -- 
  -- Denner verruchtester Bösewicht offenbaren -- Gemeinschaft abbrechen -- sollen Schwelle betreten -- 
  -- Juwelenkästchen -- -- unterbrechen Giorgina -- 
  fallen Anderes schwer Last auf Herz -- 
  Kleinodien -- Denner zurückgelassen -- denken -- unerklärlich scheinen -- Denner Wort entfallen -- 
  Rate -- Kästchen anfangen sollen -- 
  denken -- Fulda bringen Obrigkeit übergeben -- Besitz beschönigen -- dringend Gefahr aussetzen -- Denner gegeben Wort brechen -- 
  beschließen -- Schatz getreulich bewahren -- Zufall Gelegenheit darbieten -- Denner zustellen -- -- -- Wort brechen -- Obrigkeit bringen -- 
  Überfall Pachterwohnung geringen Schreck Gegend verursachen -- kühn Wagestück -- Räuber unternehmen sicher Beweis -- Bande -- gemein Diebereie -- Anhalt Beraube einzeln reisend kund -- [ ] bedeutend verstärkt müssen -- 
  Zufall -- Neffe Grafe vach -- mehrere Leute Oheim begleiten -- Dorfe -- Unfer Pachterwohnung liegen -- übernachten Lärm Bauer -- Räuber auszog -- Hülfe eilt -- Pachter Rettung Leben groß Teil Barschaft verdanken -- 
  Räuber -- Platz bleiben -- leben geben Hoffnung -- Wunde genesen -- 
  sorgfältig verbinden Dorfgefängnis sperren -- indessen früh Tag abführen -- finden Stiche ermorden -- errat -- Zugegang -- 
  Hoffnung Gericht -- gefangener näh Aufschluß Bande erhalten -- vereiteln -- 
  anderer schaudert Inneren -- erzählen hören -- vernehmen -- mehrere Bauer Jäger Grafen vach töten -- schwer verwunden -- 
  -- stark Patrouill Fuldaischen Reiter durchstreift Wald -- sprechen öfter -- Augenblick müssen Andere befürchten -- Denner -- Bande einbringen -- Genosse kühn Freveltat erkennen angeben -- 
  erstenmal Leben fühlen folternd Qual böse Gewissen -- lieb Weibe -- Knabe -- zwingen -- frevelhaft Ansinn Denner nachgeben -- 
  Nachforschung bleiben fruchtlos -- unmöglich Räuber Spur -- anderes überzeugen -- Denner Wort gehalt Gegend Bande verlassen -- 
  Geld -- Denner Geschenken übrig behalten -- golden Nadel -- legen Kleinodie Kistchen -- sünd laden geraubt Gelde gütlich -- 
  -- Anderes vorig Dürftigkeit Armut geraten -- erheitert Innere -- lang Verstrich -- ruhig Leben verstören -- 
  gebar weib Knabe -- -- erstemal -- erkranken -- wiewohl herzlich gut Kost Pflege sehnen -- tun -- 
  Anderes sitzen einst Abenddämmerung traulich Weibe -- jüngstgeboren Knabe Brust -- alt Hund herumbalgen -- -- Liebling Herr -- Stube -- 
  Knecht hinein -- Mensch -- verdächtig vorkommen -- beinahe Stunde Haus herumschleichen -- 
  anderesr Begriff Büchse hinauszugehen -- Haus Name rufen hören -- 
  öffnet Fenster erkennen Blick verhaßten Ignaz Denner -- grau Kaufmannshabit werfen -- Felleisen Arm tragen -- 
  -- andere -- -- rufen Denner -- -- mußt Nacht Herberge geben Haus -- ziehen -- -- 
  -- -- -- 
  unverschämt verrucht Bösewicht -- -- rufen andere voll Zorn -- -- wagst sehen lassen -- treulich Wort halten -- Versprechen erfüllen Gegend verlassen Solltest -- 
  Schwelle betreten -- entferne schnell -- schieße mörderisch Bube nieder -- -- 
  wart -- Gold -- Geschmeide -- womit Satan Weib verblend Wolltest -- Hinabwerfen -- schnell forteilen -- 
  lassen -- spür Weise Bande Gegenwart -- eil schnell Fulda entdecken -- wissen -- Obrigkeit -- 
  Drohung Weib erfüllen -- verlaß Beistand Gott -- Bösewicht gut Gewehr treffen wissen -- -- 
  holen andere schnell Kästchen herbei -- hinabzuwerfen -- an Fenster treten -- Denner verschwinden -- unerachten Dogg Gegend ring um Haus durchspüren müssen -- aufzufinden -- 
  anderesr -- -- Denner Bosheit aussetzen -- Gefahr schweben -- allnächtlich Hut -- indessen bleiben ruhig Anderer überzeugen -- Denner Wald durchstrichen -- 
  indessen ängstlich Zustand enden -- Gewisse beruhigen -- Vorwurf quälen -- beschließen lang schweigen -- Rat Fulda unverschuldet Verhältnis Denner bericht Kistch Kleinodie abliefern -- 
  anderes wissen -- Strafe abkommen -- verlassen reuig Bekenntnis Fehltritt -- verruchen Ignaz Denner -- Satan -- verlockt zwingen -- Fürsprach Herr -- Grafe Vach -- treu Diener günstig Zeugnis versagen -- 
  Knecht mehrmals Wald durchstreifen Verdächtige aufgestoßen -- Weib Gefahr vorhanden ungesäumt Fulda -- Vorsatz auszufahren -- 
  -- Reise bereit -- Bote Grafe vach -- augenblicklich Schloß Herr mitgehen heißen -- 
  Stadt Fulda wanderen fort Boten Schloß -- Bangigkeit -- ungewöhnlich Ruf Herr bedeuten -- 
  Schloß ankommen -- müssen Zimmer Grafe treten -- 
  -- Freu -- andere -- -- rufen entgegen -- -- unerwartet Glück treffen -- 
  Erinnerst unser alt mürrisch Hauswirt Neapel -- Pflegevater Giorgina -- 
  sterben -- Sterbebette Gewissen rühren abscheulich Behandlung arm verwaist Kind -- zweitausend Dukat vermachen -- Wechselbriefe Frankfurt ankommen Bankier heben -- 
  Frankfurt aufmachen -- lassen Stelle nötig Zertifikat ausfertigen -- Geld Anstand auszahlen -- -- 
  anderesr Freude sprachlos -- Graf Vach ergötzt Entzück treu Diener -- 
  Anderes beschließen -- fassen -- Weibe unvermutet Freude bereiten -- Herr gnädig Anerbiet -- -- urkund Legitimation erhalten -- Weg Frankfurt -- Weibe lassen sagen -- Graf wichtig Auftrag verschicken -- ausbleiben -- -- 
  Frankfurt ankommen -- weisen Bankier Grafe -- melden -- Kaufmann -- Auszahlung Legat beauftragen -- 
  Anderes finden erhalten ansehnlich Summe auszahlen -- 
  Giorgina denkend -- trachtend -- Freude vollkommen -- kaufen allerlei schön Sache golden Nadel -- -- Denner schenken -- schwer Felleise Fußgänger fortbringen -- verschaffen Pferd -- 
  treten -- abwesend -- wohlgemut Rückreise -- 
  Forst Wohnung erreichen -- 
  finden Haus fest verschließen -- 
  laut rufen Knecht -- Giorgina -- antworten -- Hund winselt Haus einsperren -- 
  ahnt Unglück schlagen heftig Tür schreien laut -- 
  -- Giorgina -- -- Giorgina -- -- -- 
  rauscht Bodenfenster -- Giorgina schauen heraus rufen .- -- Gott -- -- 
  Gott -- 
  anderesr -- -- 
  Gepriesen Himmel -- -- -- 
  anderer geöffnet Tür eintreten -- fallen Weib totenbleich laut heulend Arm -- 
  Regungslos stehen -- fassen Weib -- erschlafft Gliedern Boden sinken -- tragen Stube -- 
  eisig Kralle packen entsetzen gräßlich Anblick -- 
  Stube voll blutfleck Boden -- Wand -- jung Knabe zerschnitten Brust tot Bettchen -- 
  -- -- George -- George -- -- schreien andere wild Verzweiflung -- Augenblick hören -- Knabe Treppe herabtrippelen Vater rufen -- -- 
  Zerbrochene Glas -- Flasche -- Teller liegen umher -- 
  schwer Tisch -- Wand stehend -- Mitte Zimmer rücken -- sonderbar geformt Kohlpfann -- mehrere Phiole Schüssel geronnen Blut stehen -- 
  anderer arm Knäblein Bette -- 
  Giorgina verstehen -- holen Tücher herbei -- Leichnam wickelen Garten begraben -- 
  anderer schneiden Kreuz Eichenholz setzen Grabhügel -- 
  Wort -- laut entfloh Lippe unglücklich Eltern -- 
  dumpfer düsterem schweig Arbeit vollenden sitzen Haus Abenddämmerung -- starr Blick Ferne richten -- 
  Giorgina Verlauf -- Anderer -- Abwesenheit zugetragen -- erzählen -- 
  -- Anderer Haus verlassen -- Knecht Mittagszeit allerlei verdächtig Gestalt Wald wanken sehen -- Giorgina Mann Rückkehr herzlich wünschen -- 
  mitten Nacht laut Tobe Schreie dicht Haus Schlafe wecken -- Knecht stürzen Herein verkünden voller Schreck -- Haus Räubern umringen Gegenwehr denken -- 
  Dogg wüten -- scheinen -- beschwichtigen rufen laut -- 
  -- Anderer -- -- Anderer -- -- 
  -- Knecht fassen Herz -- öffnet Fenster rufen herab -- Revierjäger Anderer Haus -- 
  -- -- tun -- -- antwortet Stimme unten herauf -- -- öffn Tür -- einkehren -- Andere nachfolgen -- -- 
  bleiben Knecht übrig -- Tür öffnen -- strömte hell Haufen Räuber herein begrüßen Giorgina Frau Kamerad -- Hauptmann Freiheit Leben danken -- 
  verlangen -- Giorgina tüchtig Essen bereiten mögen -- nachts schwer Stück Arbeit vollbringen -- herrlich gelingen -- 
  Zitternd bebend Giorgina Küche Feuer bereiten Mal -- wozu Wildbret -- Wein allerlei Ingredienzie Räuber empfangen -- Küchen- Kellermeister Bande scheinen -- 
  Knecht müssen Tisch decken Geschirr herbeibringen -- 
  Augenblick schlich fort Frau Küche -- 
  -- wissen -- -- fing voll Entsetzen -- -- Räuber Nacht verüben -- 
  lang Abwesenheit lang Vorbereitung etlicher Stunde Schloß Herr Grafen vach überfallen -- tapfer Gegenwehr mehrere Leute töten -- Schloß anzünden -- -- 
  Giorgina schreien unaufhörlich -- 
  -- Mann -- Mann Schloß -- 
  -- arm Herr -- -- -- 
  Räuber toben Sange unterdessen Stube lassen Wein schmecken -- Mal auftragen -- 
  fing dämmern verhaßt Denner erscheinen -- Kist Felleise -- Packpferde mitbringen -- öffnen -- 
  Giorgina hören -- vieler Geld zählen Silbergeschirre klirrten -- scheinen verzeichnen -- 
  Licht -- brechen Räuber -- Denner bleiben -- 
  freundlich leutselig Miene -- sprechen Giorgina -- 
  -- erschrecken -- lieb Frau -- euer Mann scheinen -- geraum Kamerad -- 
  tun leid -- Haus kommen -- Weg eingeschlagen verfehlen -- 
  Schloß Bösewicht -- Grafe Vach -- möglich Weise verfolgen vorig Nacht Rache nehmen -- 
  -- fallen -- kämpfend -- Eure Mann Hand -- 
  Beruhigt -- lieb Frau -- anderesr -- sehen -- Bande trennen -- 
  abend verlassen -- 
  -- lauter hübsch Kind -- lieb Frau -- 
  herrlich Knabe -- -- 
  Wort Giorgina Arm wissen freundlich spielen -- Kind lachen jauchzter bleiben -- Mutter zurückgeben -- 
  Abend -- Denner Giorgina -- 
  -- merken -- -- unerachten Weib Kind -- manchmal nahe -- Kind spielen tändle -- 
  Gebt euren weniger Augenblick -- zubringen -- 
  -- Woche alt -- -- 
  Giorgina bejaht -- innerer Widerstrebe -- Knabe Denner -- Haustür setzen Giorgina bitten -- Abendessen bereiten -- Stunde fort müssen -- 
  Giorgina Küche treten -- -- Denner Kind Arm Stube -- 
  verbreiten seltsam riechend Dampf Haus -- Stube quirlen scheinen -- 
  Giorgina unbeschreiblich Angst ergreifen -- laufen schnell Stube finden Tür innen verriegeln -- 
  -- hören Kind leise wimmern -- 
  -- Rette -- rett Kind Klau Bösewicht -- -- schreien -- gräßlich ahnend -- Knecht entgegen -- Haus treten -- 
  Ergriff schnell Axt sprengen Tür -- 
  Dicker stinkend Dampf schlagen entgegen -- 
  sprung Giorgina Zimmer -- Knabe liegen nackt Schüssel -- Blut tröpfelen -- 
  -- Knecht Axt ausholen -- Denner treffen -- Schlag ausweichen -- Knecht unterlief Rang -- 
  -- hören mehrere Stimme dicht Fenster -- bewußtlos sinken Boden -- 
  erwacht -- finster Nacht -- betäuben vermocht erstarrt Glied regen -- 
  entsetzen -- Blut Zimmer schwamm -- 
  Stück Denner Kleid liegen überall umh -- ausgerissen Schopf Knechts Haaren -- Axt blutig -- Knabe Tisch herabgeschleuderen zerschnitten Brust -- 
  aufs Giorgina ohnmächtig -- glauben sterben -- erwachen Todesschlummer -- Mittag -- 
  raffen mühsam -- rufen laut Georg -- antworten -- glauben -- Georg ermorden -- 
  Verzweiflung Kraft -- fliehen Zimmer Hof schreien laut -- -- Georg -- -- 
  Georg -- -- 
  antwortet Matter kläglich Stimme Bodenfenster herab -- 
  -- Mutter -- lieb Mutter -- -- 
  Komme herauf -- 
  hungern -- -- 
  -- schnell springen Giorgina hinauf finden -- Angst Lärm Haus Bodenkammer gekrochen gewagt herauskommen -- 
  Entzück drücken Giorgina Brust -- 
  verschließen Haus wartet Stunde Stunde Bodenkammer andere -- verlieren glauben -- 
  Knabe herab sehen -- mehrere Mann Haus gehen Denner tot Mensch heraustrugen -- 
  -- bemerken Giorgina Geld schön Sache -- andere mitbringen -- 
  -- -- -- -- schreien entsetzt -- -- -- -- 
  Anderer lassen ausreden -- erzählen ausführlich -- Glück betreffen Frankfurt -- Erbschaft auszahlen lassen -- 
  Neff ermordet Grafe vach Besitzer Gut -- anderes melden -- getreulich Geschehen erzählen -- Denner Schlupfwinkel entdecken bitten -- Dienst entlassen -- Not Gefahr bringen -- 
  Giorgina Knabe Haus zurückbleiben -- 
  Anderes beschließen -- fortzuschaffend Sache Leiterwag packen -- Pferd vorzuspann Weibe Kind Gegend verlassen -- schrecklichsen Erinnerung erregen überd niemals Ruhe Sicherheit gewähren -- 
  Abreise bestimmen -- packt Kast -- stark Pferdegetrappel nah nah -- 
  Anderes erkennen Vachsche Förster -- Schloß wohnen -- ritt Kommando Fuldaischer Dragoner -- 
  -- finden Bösewicht Arbeit -- Raub Sicherheit bringen -- -- rufen Kommissarius Gericht -- mitgekommen -- 
  anderer erstarrt Staun Schreck -- 
  Giorgina halb ohnmächtig -- 
  fallen -- banden Weib Strick werfen Leiterwag -- Haus stehen -- 
  Giorgina jammeren laut Knabe fleht Gott Wille -- mitgeben mögen -- 
  -- Brut höllisch verderben bringen -- -- sprechen Kommissarius reißen Knabe Gewalt Giorgina arme -- 
  fortgeh -- treten alt Förster -- rauh bieder Mann -- Wagen -- -- anderesr -- anderes -- Satan verlocken lassen -- Freveltat begehen -- 
  warst fromm -- -- 
  -- -- Herr -- -- schreien Anderer hoch Jammer -- -- Gott Himmel leben -- dereinst selig sterben hoffen -- unschuldig -- 
  Jugend -- -- niemals unrechte tun -- solch abscheulich Bösewicht -- -- 
  wissen -- verrucht Räuber Teilnehmer Freveltat halten -- Schlos geliebt unglücklich Herr verüben -- 
  unschuldig Leben Seligkeit -- -- 
  -- -- -- -- alt Förster -- -- unschuldig -- -- wider sprechen -- 
  deiner Knabe Besitztum -- zurücklassest -- getreulich annehmen -- -- dein Weibe Unschuld erweisen -- Junge frisch munt Sache unversehrt wiederfinden sollst -- -- 
  Geld Kommissarius Gericht Beschlag -- 
  unterwegs fragen Anderer Giorgina -- Kästchen verwahren -- gestehen -- Leid tun -- Denner überliefern -- Obrigkeit übergeben -- 
  Fulda trennt anderesr Weibe werfen tief finsteres Gefängnis -- 
  Verhör führen -- 
  beschuldigt Teilnahme vachsch Schlos verübt Raubmorde ermahnt Wahrheit gestehen -- wider ausgemittelt -- 
  anderer erzählen getreulich -- zugetragen -- Eintritt abscheulichen Denner Haus Augenblick Verhaftung -- 
  klagen voll Reue einzig Vergehen -- -- Weib Kind retten -- Plünderung Pachter zugegen -- Denner Gefangennehmung befreien -- beteuern gänzlich Unschuld rücksichts letzter Dennersch Bande verübt Raubmorde -- ebenderselbe Frankfurt -- 
  öffneen Tür Gerichtssaal abscheulich Denner hereingeführen -- 
  anderer erblicken -- lacht teuflisch Hohn sprechen -- 
  -- -- Kamerad -- erwischen lassen -- 
  dein Weibe Gebet herausgeholfen -- -- 
  Richter fordern Denner -- Bekenntnis rücksichts Anderer wiederholen -- Vachsche Revierjäger anderesr -- stehen -- verbinden Jägerhau gut sicherst Schlupfwinkel -- 
  anderer gebührend Anteil Raube erhalten -- wiewohl zweimal tätig Räubereien mitwirken -- 
  nämlich Beraubung Pachter -- -- Denner -- dringend Gefahr erretten -- Unternehmen Grafe Aloys Vach -- glücklich Schuß Anderes töten -- 
  -- Anderer geraten Wut -- schändlich Lüge hören -- 
  -- -- -- schrie -- -- verrucht teuflisch Bösewicht -- wagst -- Ermordung lieben arm Herr anklagen -- verüben -- -- 
  -- 
  wissen -- fähig -- Rache verfolgen -- Gemeinschaft entsagen -- drohen -- verrucht Räuber Mörder niederzuschießen -- Schwelle betreten Würdest -- 
  Bande Haus überfallen -- abwesend -- armes unschuldig Kind brav Knecht ermorden -- -- 
  schrecklich Strafe gerecht Gott entgehen -- Bosheit unterliegen -- -- 
  wiederholen Anderer vorig Bekenntnis heiligsen Beteuerung Wahrheit -- Denner lachen höhnisch meinen -- allzugroß Furcht Tod Gericht belügen unterfang -- Frömmigkeit -- Aufhebens machen -- vereinbar -- Gott heilig Bekräftigung falsch Aussage anrufen -- 
  Richter wissen -- anderesr -- Miene Sprache Wahrheit Aussage bestätigen scheinen -- Denner kalt Festigkeit denken -- -- 
  Giorgina vorführen -- namenlos Jammer laut weinend Mann zustürzen -- 
  wissen Unzusammenhängende erzählen -- unerachten Denner entsetzlich Mord Knabe anklagen -- scheinen Denner keineswegs entrüsten -- behaupten -- tun -- Giorgina Unternehmung Mann wissen -- unschuldig -- 
  anderesr Gefängnis zurückführen -- 
  nachher ziemlich gutmütig Gefangenewärter -- Weib -- sowohl Denner -- übrig Räuber fortwährend Unschuld behaupten -- wider ausgemittelt -- Haft entlassen -- 
  jung Graf Vach -- edelmütig Herr -- sogar -- anderesr -- Schuld zweifeln scheinen Kaution stellen -- alt Förster Giorgina schön Wagen abholen -- 
  vergebens Giorgina bitten -- Mann sehen -- Gericht gänzlich abschlagen -- 
  arm Anderer tröstet Nachricht -- -- Unglück Weibe elend Zustand Gefängnis Herzen -- 
  Prozeß verschlimmeren indessen -- 
  erweisen -- -- Denner angeben -- anderer gewiß Wohlstand geraten -- Quelle Teilnahme Räubereien -- 
  ferner gestehen anderesr Abwesenheit Haus vachsch Schlos verüben -- Angabe Erbschaft Aufenthalts Frankfurt bleiben verdächtig -- Name Kaufmann -- Geld auszahlen erhalten -- angeben wissen -- 
  Bankier Grafe Vach -- Hauswirt Frankfurt -- andere eingekehren -- versicheren einstimmig -- beschrieben Revierjäger erinnern können -- Gerichtshalter Grafe Vach -- Zertifikat Anderes ausfertigen -- sterben -- vachsch Diener wissen Erbschaft -- Graf äußern -- Anderer geschwiegen -- -- Frankfurt zurückkehrend -- Weib Gelde überraschen -- 
  bleiben -- Anderer vorbrachen -- nachweisen -- Raub Frankfurt Geld erwerben -- unausgemitteln -- 
  Denner bleiben früh Behauptung stimmen sämtlicher Räuber -- eingefang -- -- 
  Richter schuld unglücklich Anderer überzeugen -- Aussage Vachsche Jäger -- Schein Flamme genau andere erkennen sehen -- Graf niedergestrecken -- 
  anderesr Auge Gericht verstockt heuchlerisch Bösewicht stützen Resultat Aussage Beweis Tortur zuerkennen -- starr Sinn beugen -- Geständnis bringen -- 
  schmachtet Anderer Kerker -- Gram Kraft aufgezehrt -- Robuster stark Körper schwach ohnmächtig -- 
  schrecklich -- Pein Geständnis -- niemals begehen -- abdringen -- heran -- 
  führen Folterkammer -- entsetzlich sinnreich Grausamkeit erfunden Instrument liegen -- Henkersknechte bereiten -- Unglücklichen martern -- 
  nochmals andere ermahnen -- -- dringend verdächtig -- Zeugnis Jäger überführen -- gestehen -- 
  beteuern wiederum Unschuld -- wiederholt Umstand Bekanntschaft Denner Wort -- Verhör tun -- 
  ergriff Knecht -- band Strick marterten -- Glied ausrenkt Stachel einbohrt gedehnt Fleisch -- 
  anderer vermögen Qual ertragen -- Schmerz gewaltsam zerrissen -- Tod wünschend -- gestehen -- ohnmächtig Kerker zurückgeschleppen -- 
  stärkt -- erlitten Tortur gewöhnlich -- Wein fallen Wachen schlafen hinbrütend Zustand -- 
  lösen Stein Mauer -- fallen krachend herab Boden Kerker -- 
  blutrot Schimmer Drang treten Gestalt hinein -- -- unerachten Denner Zug -- Denner scheinen -- 
  Glühend funkelt Auge -- schwärz starren struppig Haar Stirn empor tief senkt finster Augenbraue dick Muskel herab -- krummgebogenen Habichtsnase liegen -- 
  gräßlich seltsam Weise Gesicht verschrumpfen verzerren -- Kleidung fremd abenteuerlich -- Denner niemals sehen -- 
  feuerrot Gold stark verbrämt Mantel hing bauschig Falte Gestalt Schulter -- breit niedergekrempt spanisch Hut herabhängend rot Feder sitzen schief kopf -- lang Stoßdegen hing Seite -- linker Arm tragen Gestalt Kistchen -- 
  Schritt gespenstisch Unhold Anderes hohl dumpf Tone sprechend -- 
  -- -- Kamerad -- Folter schmecken -- 
  bloß Eigensinn verdanken -- hättest Bande gehörig -- wärst retten -- 
  Versprichst -- Leitung ergeben -- gewinnst -- Tropfen trinken -- dein Kind Herzblut kochen -- augenblicklich Qual entledigen -- 
  fühlst gesund kräftig -- Rettung sorgen -- 
  -- -- anderesr Schreck -- Angst Ermattung sprechen -- -- Kind Blut Phiole -- Gestalt hinhielt -- rot Flämmche spielen -- inbrünstig betet Gott heilige -- retten möchten Klau Satan -- verfolgen ewig Seligkeit bringen wollen -- erlangen hoffen -- schimpflich Tod sterben -- 
  lacht Gestalt -- Kerker widergelln -- verschwand dick Dampf -- 
  anderer erwachen dumpf Betäubung -- vermögen aufzuricht Lager -- -- -- Stroh -- Haupt liegen -- stark stark rühren beginnen weggeschoben -- 
  gewahren -- Stein Fußboden unten herausgedrängen hören mehrmals Name leise rufen -- 
  erkennen Denner Stimme sprechen -- 
  -- -- 
  Laß ruhen -- schaffen -- -- -- -- andere -- -- sprechen Denner -- -- mehrere Gewölbe dringen -- retten -- -- Richtplatz kommst -- erretten -- verlieren -- 
  bloß dein Weib Wille -- angehören -- denken -- helfen -- 
  mutlos Feigling -- 
  erbärmlich Leugnen fruchten -- 
  bloß -- vachsch Schloß Haus zurückkehrtest Weibe aufhieln -- Schuld -- auffehen -- 
  -- nimm Feil Sag -- befrei künftig Nacht Kette durchsagen Schloß Kerkertüre -- schleich Gang -- 
  äußerer Tür linker Hand stehen -- draußen finden -- leiten -- 
  Halten -- -- 
  anderer Säge Feil -- Denner hineinreichen heben Stein Öffnung -- 
  entschließen -- -- wozu innerer Stimme Gewissen auffordern -- 
  -- Gefangenewärter hineintrat -- -- sehnlich wünsch Richter führen -- Wichtig entdecken -- 
  Vormittage verlangen erfüllen -- glauben -- anderesr -- unbekannt geblieben -- Freveltat Bande gestehen -- 
  anderer überreichen Richter Denner erhalten Instrument -- erzählt Vorgang Nacht -- 
  -- Unerachtet gewiß wahrhaftig unschuldig leiden -- Gott behüten -- tracht -- Freiheit unerlaubt Weise erlangen -- verrucht Denner -- schand Tod stürzen -- Hand liefern sündlich frevelhaft Unternehmen Strafe verdienen -- unschuldig leiden -- -- 
  beschließen Anderer Vortrag -- 
  Richter scheinen erstaunt Mitleid Unglücklichen durchdrungen -- wiewohl mannigfach Tatsache -- wider sprechen -- Schuld überzeugen -- jetzig Benehme zweifelhaft halten -- 
  Aufrichtigkeit Andere vorzüglich Umstand -- Anzeige Denner beabsichtigt Flucht -- Stadt nächster Umgebung Gefängnis Bande ertappen aufgreifen -- wohltätig Einfluß -- unterirdisch Kerker -- sperren -- herausnehmen -- lichen Gefängnisstube Wohnung Gefangenewärters erhalten -- 
  bringen Gedanke treu Weib -- Knabe -- gottselig Betrachtung -- fühln ermutigen -- Leben schmerzlich Weise -- Bürde -- abwerfen -- 
  Gefangenewärter frommen Verbrecher wundern müssen notgedrungen beinahe Unschuld glauben -- 
  -- beinahe verfloss -- schwierig verwickelt Prozeß wider Denner Mitschuldig schließen -- 
  finden -- Bande Grenze Italien ausbreiten Geraumer überall raubt morden -- 
  Denner hängen -- Körper verbrennen -- 
  unglücklich anderesr Strang zuerkannen -- Reue halber -- Bekenntnis Denner geraten Flucht Entdeckung Anschlag Bande -- durchzubrechen -- veranlassen -- Körper herabgenommen -- Gerichtsstätt verscharren -- 
  -- Denner Anderes hinrichten -- angebrochen -- Tür Gefängnis -- jung Graf Vach treten hinein anderes -- Knien liegen still beten -- 
  -- Anderes -- -- sprechen Graf -- -- mußt sterben -- 
  Erleichtere Gewissen offen Geständnis -- 
  Sage -- dein Herr töten -- 
  Mörder Oheim -- -- 
  -- stürzen anderesr Träne Auge -- wiederholen nochmals -- Gericht aussagen -- ehe unleidlich Qual Tortur Lüge auspreßen -- 
  rufen Gott heilige -- Wahrheit Aussage gänzlich Unschuld Tod geliebt Herr bekräftigen -- 
  -- -- -- fahren Graf Vach fort -- -- unerklärlich Geheimnis Spiel -- 
  -- anderes -- Unschuld überzeugen -- unerachten viele wider sprechen -- wissen -- Jugend treusten Diener Oheim -- Neapel Gefahr dein Leben Räuberhände retten -- 
  gestern alt Jäger Oheim Franz Nikolaus Geschwor -- leibhaftig Räuber sehen genau bemerken -- Oheim niederstrecktest -- -- 
  anderesr peinlichsten -- schrecklichst Gefühl durchbohrt -- -- Satan Gestalt annehmen -- verderben -- Denner sogar Kerker sprechen -- Anderer sehen -- scheinen falsch Beschuldigung Gericht inner wahr Überzeugung beruhen -- 
  anderer unverhohlen -- hinzusetzen -- Schickung Himmel ergeben -- schmählichen Tod Verbrecher sterben sollen -- -- nachher -- Unschuld gewiß -- 
  Graf Vach scheinen tief erschüttern -- anderes sagen -- -- Wunsch -- Hinrichtung unglücklich Weibe verschweigen bleiben -- nebst Knabe alt Förster aufhalen -- 
  Rathausglocke erklingen Dumpf schauerlich abgemessen Pulse -- 
  anderer angekleiden Zug gewöhnlich Feierlichkeit Zuströme unzählig Volk Richtstätt -- 
  anderer beten laut Rührte frommes Betragen -- sehen -- 
  Denner Miene trotzigen verstockn Bösewicht -- 
  schaut Munter kräftig -- lacht arm Anderer tückisch schadenfroh -- 
  andere hinrichten -- Bestieg fassen Henker Leiter -- kreischen Weib sinken ohnmächtig alt Mann Arm -- 
  Anderes blicken -- Giorgina -- laut erfleht Himmel Fassung Stärke -- 
  -- -- -- sehen -- arm unglücklich Weib -- sterben unschuldig -- -- rufen -- Blick sehnsuchtsvoll Himmel erheben -- 
  Richter rufen Henker -- mögen fördern -- entstehen murren Volke fliegen Stein Denner -- ebenfalls Leiter bestieg Zuschauer verhöhnte Mitleids frommen Anderer -- 
  Henker legen Anderes Strick Hals -- scholl Ferne -- 
  -- Halt -- halten -- Christus Wille halten -- -- 
  Mann unschuldig -- -- 
  richten Unschuldige -- -- 
  -- -- Halt -- halten -- -- schri tausend Stimme vermögen Wache steuern Volk -- Hinzudrang anderer Leiter herabreißen -- 
  Nah sprengen Mann Pferd -- rufen -- Anderer erkennen Blick fremd Kaufmann -- Frankfurt Giorgina Erbschaft auszahlen -- 
  Brust zerspringen Freude Seligkeit -- aufrecht erhalten Leiter herabgestiegen -- 
  Kaufmann Richter -- -- Raubmord Vachsche Schlos verüben -- Anderer Frankfurt -- Meile entfernen -- -- Gericht unzweifelhafte Weise Urkunden Zeuge dartun wollen -- 
  rufen Richter -- 
  -- Hinrichtung Anderes keineswegs geschehen -- höchstwichtig Umstand beweiset -- ausgemittelt -- völlig Unschuld angeklagter -- 
  führen sogleich Gefängnis -- -- 
  denn Leiter herab ruhig ansehen -- Richter Wort sprechen -- rollt glühend Auge -- knirscht Zähn -- heuln wild Verzweiflung -- gräßlich -- namenlos Jammer wütenden Wahnsinn -- Lüfte halln -- 
  -- Satan -- Satan -- 
  betrügen -- weh -- weh -- 
  -- -- verloren -- -- 
  bringen Leiter herab -- fallen Boden röchelen Dumpf -- 
  -- bekennen -- bekennen -- -- 
  Hinrichtung verschieben Gefängnis zurückgeführen -- jeder entspringen unmöglich -- 
  Haß Wächter gut Schutzwehr Schlauheit verbündeter -- 
  -- Augenblick nachher -- Anderer Gefangenenwärter ankommen -- liegen Giorgina arme -- 
  -- anderesr -- andere -- -- rufen -- -- -- wissen -- unschuldig -- Redlichkeit -- Frömmigkeit zweifeln -- -- 
  -- Unerachtet Giorgina Hinrichtung verschweigen -- unbeschreiblich Angst -- seltsam Ahnung treiben -- Fulda eilen -- Richtstätt kommen -- Mann verhängnisvollen Leiter bestieg -- Tod führen -- 
  Kaufmann Untersuchung Reise Frankreich Italien -- Wien Prag zurückkehren -- 
  Zufall -- vielmehr besonderer Schickung Himmel -- -- entscheidendsen Augenblick Richtplatze ankommen -- arm Anderer schmählichen Tod Verbrecher retten -- 
  Gasthofe erfahren Geschichte Anderes fallen schwer auf Herz -- Anderer Revierjäger können -- Erbschaft -- Weibe Neapel zugefallen -- erheben -- 
  schnell eilt Fort überzeugt -- anderesr -- sogleich Wahrheit Vermutung -- 
  eifrig Bemühung wacker Kaufmann jung Grafe vach Anderes -- Aufenthalt Frankfurt Stunde ausgemittelt -- völlig Unschuld Raubmorde dargetan -- 
  Denner gestehen Richtigkeit Angabe anderer Verhältnis meinen -- Satan müssen blenden -- glauben -- Anderer fecht vachsch Schloß Seite -- 
  erzwungen Teilnahme Ausplünderung Pachterhofe -- gesetzwidrig Rettung Denner -- -- Ausspruch Richter -- andere büßen hart Gefängnis ausgestanden Marter Todesangst -- urtel Strafe freisprechen eilt Giorgina vachsch Schloß -- edle wohltätig Graf Nebengebäude Wohnung einräumen -- gering Jagddienste fordernd -- Grafe persönlich Liebhaberei notwendig -- 
  Gerichtskoste bezahlt Graf -- anderesr Giorgina ungekränkt Besitz Vermögen bleiben -- 
  Prozeß wider verrucht Ignaz Denner Wendung -- 
  Begebenheit Gerichtsstätte scheinen umwandeln -- 
  Höhnender teuflisch Stolz beugen -- zerknirscht innere brechen Geständnis hervor -- Richter Haar sträuben -- 
  Denner klagen Zeichen tief Reue Bündnis Satan -- früh Jugendzeit unterhalten -- vorzüglich hierauf fern Untersuchung Zutritt verordnet Geistlichkeit richten -- 
  früh Lebensverhältnis erzählt Denner Sonderbares -- Erzeugnis wahnsinnig Überspannung halten -- Erkundigung -- Neapel -- angeblich Geburtsort -- einziehen lassen -- bestätigen -- 
  Auszug geistlich Gericht Neapel verhandelt Akte ergeben Denner Herkunft folgend merkwürdig Umstand -- 
  lang lebt Neapel alt wunderlich Doktor -- Trabacchio Name -- Geheimnisvolle stets glücklich Kur insgemein Wunderdoktor nennen pflegen -- 
  scheinen -- Alter vermögen -- Schritt rasch jugendlich -- unerachten mehrere Eingeborene nachrechn -- achtzig alt müssen -- 
  Gesicht seltsam grausig Weise verzerren verschrumpfen -- Blick innerer Schauer ertragen -- wiewohl kranke -- -- bloß scharf kranke geheftet Blick heilen oftmals schwer hartnäckig Übel -- 
  schwarz Anzug werfen gewöhnlich weit rot Mantel golden Tresse Troddel -- bauschig Falte stoßdegen hervorragen -- 
  laufen Kist Arznei -- bereiten -- Straße Neapel kranke -- weichen scheu -- 
  hoch Not wenden -- niemals schlagen kranke besuchen -- sonderlich Gewinn hoffen -- 
  mehrere Weiber sterben schnell -- ausnehmend schön insgemein Landdirn -- 
  sperrt erlaubt -- Begleitung alt ekelhaft häßlich Frau Messe hören -- 
  alte unbestechlich -- listig angelegt Versuch jung Lüstlinge -- schön Frau Doktor Trabacchio nah -- bleiben fruchtlos -- 
  Unerachtet Doktor Trabacchio reiche bezahlen lassen -- stehen Einnahme Reichtum Geld Kleinodien -- Haus aufhäufen verhehlen -- Verhältnis -- 
  Zeit freigebig Verschwendung -- Gewohnheit jedesmal -- Frau sterben -- Gastmahl geben -- Aufwand doppelt soviel betragen -- reich Einnahme -- Praxis hindurch verschaffen -- 
  letzter Frau Sohn erzeugen -- einsperren -- Weiber -- bekommen sehen -- 
  Gastmahl -- Tod Frau -- sitzen dreijährig Knabe Seite -- Gast Schönheit Klugheit Kind [ verwundern ] -- -- verraten körperlich ansehen Alter -- Benehme zwölfjährig halten -- 
  Gastmahl äußern Doktor Trabacchio -- -- nunmehr Wunsch -- Sohn -- erreichen -- heiraten -- 
  übermäßig Reichtum -- geheimnisvoll Wesen -- wunderbar Kur -- Unglaublich gehen -- bloß bereitet eingeflößt Tropfen -- bloß Betastung -- Blick -- hartnäckigst Krankheit wichen -- geben Anlaß allerlei seltsam Gerücht -- Neapel verbreiten -- 
  halten Doktor Trabacchio Alchimist -- Teufelsbeschwörer -- schuld -- Satan Bündnis stehen -- 
  letzter Sage entstehen seltsam Begebenheit -- Edelleut Neapel zutragen -- 
  kehren einst spät Nacht Gastmahl geraten -- Weinrausch Weg verfehlen -- einsam verdächtig Gegend -- 
  rauschen Raschelt Entsetzen gewahr -- leuchtendrot Hahn -- zackig Hirschgeweihe kopfe tragend -- ausgebreitet Flügel -- daherschritt -- menschlich funkelnden Auge anstarren -- 
  drängt Ecke -- Hahn schreiten vorüber -- folgen Figur glänzend goldverbrämt Mantel -- 
  Gestalt vorüber -- Edelleut leise -- 
  -- Wunderdoktor Trabacchio -- -- 
  -- nüchtern entsetzlich Spuk -- ermutigten folgen angeblich Doktor Hahn -- Leucht genommen Weg zeigen -- 
  sehen -- Gestalt Haus Doktor -- fern leer öd Platze stehen -- zuschriten -- 
  Haus ankommen -- rauschen Hahn Höhe -- schlagen Flügel Fenster Balkon -- klirrend öffnet -- Stimme alt Weibe meckeren -- 
  -- -- Haus -- Haus -- warm Bett -- Liebchen warten -- -- -- 
  -- stieg Doktor unsichtbaren Leiter empor -- rausch Hahn Fenster -- zugeschlag -- einsam Straße entlang Klirrte dröhnter -- 
  schwarz Dunkel Nacht verschwinden Edelleute stehen stumm starr Grausen entsetzen -- 
  Spuk -- Überzeugung Edelleute -- Gestalt -- teuflisch Hahn vorleuchten -- -- verrufen Doktor Trabacchio -- geistlich Gericht -- Ohr -- -- satanisch Wundermann sorglich Stille nachzuspüren -- 
  bringen heraus -- Zimmern Doktor rot Hahn befinden -- wunderlich Weise sprechen disputieren scheinen -- spräch Gelehrt zweifelhaft Gegenstand wissen -- 
  geistlich Gericht Begriff Doktor Trabacchio einzuzieh verrucht Hexenmeister -- weltlich Gericht geistlichen zuvor lassen Doktor Sbirr aufheben Gefängnis schleppen -- Besuch kranke heimkehren -- 
  alt Haus holen -- Knabe finden -- 
  Tür Zimmer verschließen versiegeln -- Wachen ring Haus stellen -- 
  -- Folgend Grund gerichtlich Verfahren -- 
  sterben mehrere angesehen Person Neapel umliegend Gegend Arzt einstimmig Urteil Gift -- 
  Untersuchung veranlassen -- fruchtlos bleiben -- jung Mann Neapel -- bekannt Lüstling Verschwender -- Oheim vergiften -- gräßlich Zusatz eingestehen -- Gift alt Weibe -- Haushälterin Trabacchio -- kaufen -- 
  spürt alte -- ertappen -- festverschlossen kistch forttragen -- Phiole finden -- Name allerlei Arzneimittel versehen -- unerachten flüssig Gift enthalten -- 
  alte eingestehen -- indessen Tortur drohen -- bekennen -- Doktor Trabacchio künstlich Gift -- Name Aqua Toffana -- bereiten -- geheim verkauf Gift -- bewirken -- beständig reich Erwerbsquelle -- 
  ferner gewiß -- Satan Bündnis stehen -- verschieden Gestalt einkehren -- 
  jeder Weiber Kind gebären -- Haus ahnen -- 
  Kind allemal -- Woche -- Monat alt -- besonderer Zurüstung Feierlichkeit unmenschlich Weise schlachten -- Brust aufgeschnitt Herz herausnehmen -- 
  jedesmal Satan Operation -- -- Gestalt -- meistens Fledermaus menschlich Larve -- erscheinen -- breit Flügel Kohlfeuer anfachen -- Trabacchio Kinde Herzblut köstlich Tropfen bereiten -- Siechheit kräftig widerständen -- 
  Weiber Trabacchio nachh -- heimlich Weise töten -- scharf Blick Arzt klein Spur Ermordung auffinden -- 
  Trabacchio letzter Weib -- Sohn gebären -- leben -- natürlich Tod sterben -- 
  Doktor Trabacchio gestehen unverhohlen scheinen Freude finden -- Gericht schauerlich Erzählung Untat vorzüglich nähern Umstand entsetzlich Bündnis Satan Verwirrung setzen -- Geistliche -- Gericht beiwohnen -- geben ersinnlich Mühe -- Doktor Reue Erkenntnis Sünde bringen -- bleiben vergebens -- Trabacchio verhöhnte verlachen -- 
  -- alt Trabacchio -- Scheiterhauf verurteilen -- -- 
  unterdessen Haus Doktor untersuchen Reichtum hervorholen -- -- Abzug Gerichtskoste -- Hospitäler verteilen -- 
  Trabacchio Bibliothek finden einzig verdächtig Buch Gerätschaft -- satanisch Kunst -- Doktor treiben -- hindeuen -- 
  verschlossen Gewölbe -- Mauer herausragend Röhr Laboratorium verrien -- Widerstand -- öffnen -- Kunst Gewalt -- 
  -- Schlosser Maurer Aufsicht Gericht eifrig bemüht -- durchzubrech -- Zweck erreichen -- kreischt innere Gewölbe entsetzlich Stimme -- rauschen nieder -- eiskalt Flügel schlagen Gesicht Arbeiter schneidend Zugwind Pfiff gellend gräßlich Tön Gang -- Grausen entsetzen ergriffen fliehen -- Tür Gewölbe wagen -- Furcht wahnsinnig Angst Schrecken -- 
  Geistliche -- Tür nahen -- bleiben übrig -- Ankunft alt Dominikaner Palermo erwarten -- Standhaftigkeit Frömmigkeit Kunst Satan weichen müssen -- 
  Mönch Neapel befinden -- bereit teuflisch Spuk Trabacchios Gewölbe bekämpfen -- verfügen -- ausrüsten Kreuz Weihwasser -- begleiten mehrere geistlich Gerichtspersonen -- Tür entfernen bleiben -- 
  alt Dominikaner betend Tür -- erheben heftig Rauschen Brausen -- entsetzlich Stimme verworfen Geist lacht gellend heraus -- 
  geistliche lassen Irre -- betet kräftig Kruzifix emporhaltend Tür Weihwasser besprengend -- 
  -- geben Brecheise -- -- rufen laut -- zitternd reicht Maurerbursch -- setzen alt Mönch Türe -- furchtbar erschütternd Knall Aufsprang -- 
  blau Flamme leckn überall Wänden Gewölbe herauf betäubend erstickend Hitze strömt innere -- 
  Demunerachtet Dominikaner hineintreten -- stürzt Boden Gewölbe -- Haus erdröhnt Flamme prasselten Abgrunde hervor -- wütend greifen rings umher erfaßten -- 
  schnell müssen Dominikaner Begleitung fliehen -- verbrenn -- verschütten -- 
  Straße -- Haus Doktor Trabacchio Flamme stehen -- 
  Volk laufen jauchzt jubelt -- verrucht Hexenmeister Wohnung brennen -- minde Rettung -- 
  Dach eingestürzen -- inwendig Holzwerk flammt Wände heraus stark Balken oberer Stock widerstand Gewalt Feuer -- 
  entsetzen schreien Volk -- Trabacchio zwölfjährig Sohn Kistch Arm glimmend Balken entlang schreiten -- 
  Moment dauert Erscheinung -- verschwinden plötzlich hochaufschlagend Flamme -- 
  -- Doktor Trabacchio scheinen herzinniglich freuen -- Begebenheit erfahren verwegen Frechheit Tod -- 
  Pfahl Band -- lachen hell Henker -- mordlustig fest anschnüren -- 
  -- Sieh -- Geselle -- Stricke deinen Fäuste brennen -- -- 
  Mönch -- zuletzt nahen -- rufen fürchterlich Stimme -- -- Fort -- -- -- 
  Glaubst -- dumm -- Gefallen schmerzlich Tod leiden -- -- 
  Stunde kommen -- -- 
  -- fing angezündet Holz prasseln -- erreicht Flamm Trabacchio -- hell auflodert -- Strohfeuer fern Anhöhe gellend Hohngelächter hören lassen -- 
  schaut Grausen ergriff Volk -- [ ] Doktor Trabacchio leibhaftig schwarz Kleide -- goldverbrämt Mantel -- Stoßdegen Seite -- niedergekrempt spanisch Hut rot Feder kopf -- Kistch Arm -- Straße Neapel laufen pflegen -- erblicken -- 
  Reiter -- Sbirr -- hundert Volk stürzen Hügel -- Trabacchio bleiben verschwinden -- 
  alt Geist entsetzlichst Quale -- gräßlichst Verwünschung verrucht Herr -- unzählig Verbrechen teilen -- 
  sogenannter Ignaz Denner anderer -- Sohn Doktor -- höllisch Kunst Vater kistch seltensen geheimnisvollst Kostbarkeit Flamme retten -- 
  frühest Jugend unterrichtet Vater geheim Wissenschaft Seele Teufel verschreiben -- ehe volle Bewußtsein erlangen -- 
  Doktor Trabacchio Gefängnis werfen -- bleiben Knabe geheimnisvoll verschlossen Gewölbe verworfen Geister -- Vater höllisch Zauber hineingebannen -- Zauber Dominikaner weichen müssen -- lassen Knabe verborgen mechanisch Kraft wirken -- Flamme entzünden -- weniger Minute Haus Brand stecken -- Knabe unversehrt Feuer fort Tor hinaus Wald eilen -- Vater bezeichnen -- 
  dauern -- erscheinen Doktor Trabacchio -- fliehen schnell Sohne -- Tagereisen Neapel Ruine alt römisch Gebäude kommen -- Eingang weit geräumig Höhle verstecken liegen -- 
  Doktor Trabacchio zahlreich Räuberbande -- längst Verbindung gestehen -- geheim Wissenschaft wesentlichst Dienst leisten -- laut Jubel empfangen -- 
  Räuber Geringerem lohnen -- Krönung Räuberkönige -- wodurch Oberhaupt Bande -- Italien südlich Deutschland verbreiten -- aufgeschwungen -- 
  Doktor Trabacchio erklären -- annehmen -- besonderer Konstellation -- walen -- nunmehr unstet Leben führen müssen -- Verhältnis binden können -- Räubern Kunst Wissenschaft beistehn -- sehen lassen -- 
  beschließen Räuber -- zwölfjährigen Trabacchio Räuberkönige wählen Doktor höchlich zufrieden -- Knabe Stunde Räuber bleiben -- -- fünfzehn alt -- wirklich Oberhaupt ausziehen -- 
  Leben Gewebe Greueltat Teufelskünste -- Vater -- oftmals blicken lassen zuweilen wochenlang einsam Sohne Höhle bleiben -- einweihen -- 
  kräftig Maßregel Königs Neapel Räuberbanden -- keck verwegen -- entstanden Zwistigkeit Räuber heben gefährlich Bündnis Oberhaupte Trabacchio -- Stolz Grausamkeit verhassen -- Vater erlernt Teufelskünst dolch untergebene schützen -- 
  floh Schweiz -- Name Ignaz Denner -- besuchen reisend Kaufmann Messe Jahrmärkt Deutschland -- zerstreut Glieder Bande klein bildet -- vormalig Räuberkönig Oberhaupt wählen -- 
  Trabacchio versichern -- Vater Stunde leben -- Gefängnis besuchen -- Rettung Gerichtsstätte versprechen -- 
  -- -- einsehen -- göttlich Schickung anderesr Tod erretten -- Vater entkräften -- wollen reuig Sünder Teufelskünste abschwören geduldig gerecht Todesstrafe erleiden -- 
  anderesr -- Mund Grafe vach erfahren -- zweifeln Augenblick -- Trabacchio Bande -- ehemals neapolitanisch Herr anfiel -- überzeugen -- alt Doktor Trabacchio Gefängnis leibhaftig Satan erscheinen verlocken böse Beginn -- 
  -- welcher Gefahr schweben -- Trabacchio Haus treten -- wiewohl begreifen -- Verrucht Weib münzen -- Vorteil -- Aufenthalt Jägerhause ziehen -- bedeutend -- 
  Anderes befinden entsetzlich Stürme ruhig glücklich Lage -- erschütternd Stürme toben -- Leben Dumpf nachzuhallen -- 
  -- anderesr -- stark kräftig Mann -- Gram -- Gefängnis -- unsäglich Schmerz Tortur körperlich zugrunde richten -- siech krank daherschwankt Jagd treiben -- welken Giorgina -- südlich Natur Grame -- Angst -- entsetzen brennend Glut aufgezehrt -- zusehends -- 
  Hülfe vorhanden -- sterben Monat Mann Rückkehr -- 
  anderesr verzweifeln wunderschön klug Knabe -- Mutter getreu Ebenbild -- vermögen trösten -- 
  Wille -- Leben erhalten -- soviel kräftig -- Verlauf beinahe Gesundheit zunehmen lustig Jägergang Forst unternehmen -- 
  -- Prozeß wider Trabacchio erreichen -- alt Vater -- Tod durch Feuer verdammen -- erleiden -- 
  anderer Tag -- Abenddämmerung einbrechen -- Knabe Forst -- Schlos nah -- kläglich Gewimmer vernehmen -- nahen ausgetrockneen feldgraben scheinen -- 
  eilt nah erblickt Mensch -- elend schmutzig Lump hüllen -- Graben liegen Schmerz Geist aufgeben scheinen -- 
  Anderes werfen Flinte Büchsensack -- ziehen Mühe Unglücklichen heraus -- Mensch Gesicht blicken -- erkennen entsetzen Trabacchio -- 
  Zurückschaudernd lassen -- wimmeren Trabacchio Dumpf -- 
  -- anderesr -- anderes -- -- Barmherzigkeit Gott Wille -- Seele empfehlen -- Mitleid -- 
  Rettest -- Rettest Seele ewig Verdammnis -- ereilen Tod -- vollenden Buße -- -- 
  -- -- Verdammter Heuchler -- -- schreien Anderes -- -- Mörder Kind -- Weibe -- Satan hergeführen -- verderbesen -- 
  schaffen -- 
  stirb vermoder Aas -- Verruchter -- -- 
  anderesr zurückstoßen Graben -- heuln Trabacchio wilder Jammer -- 
  -- anderer -- rettest Vater dein Weibe -- Giorgina -- beten Throne Höchsten -- -- 
  Anderes schauderen -- Giorgina Name fühlen schmerzlich Wehmut ergreifen -- 
  Mitleid Mörder Ruhe -- Glück -- Durchdrang -- fassen Trabacchio -- laden Mühe tragen Wohnung -- stärkend Mittel erquicken -- 
  erwachen Trabacchio Ohnmacht -- versinken -- 
  Nacht Hinrichtung ergreifen Trabacchio entsetzlichst Todesangst -- überzeugen -- namenlosen Marter Feuertode retten -- 
  fassen rüttelt wahnsinnig Verzweiflung Eisenstäbe Gitterfenster zerbröckeln bleiben Hand -- 
  Strahl Hoffnung fallen Seele -- 
  Turm dicht trocken Stadtgrabe sperren -- schaut tief Entschluß hinabzustürzen -- retten -- sterben -- Stelle fassen -- 
  Kette gering Anstrengung entledigen -- 
  hinauswerfen -- verging Sinn -- erwachen -- Sonne hell strahlen -- 
  -- Strauchwerk hoch Gras fallen -- Gliedern verstaucht verrenken -- vermögen Regen rühren -- 
  Schmeißfliegen anderer Ungeziefer setzen halbnackt Körper stachen leckt Blut -- abwehren -- 
  bringen martervollen -- 
  nachts gelingen kriechen glücklich -- Stelle -- Regenwasser sammeln -- begierig einschlürfen -- 
  fühlen stärken vermögen mühsam hinaufzuklimmen fortzuschleichen -- Forst erreichen -- unfern Fulda anhieben beinahe Vachsch Schloß erstrecken -- 
  Gegend kommen -- Anderer Tod ringend finden -- 
  entsetzlich Anstrengung letzter Kraft erschöpfen Minute andere sicherlich tot finden -- 
  denken -- künftig Trabacchio -- Obrigkeit entflohen -- -- bringen anderer einsam Zimmer pflegen möglich Weise -- behutsam Werk -- Anwesenheit fremde ahnen -- Knabe -- gewohnen Vater Blindling gehorch -- verschweigen getreulich Geheimnis -- 
  anderer fragen Trabacchio -- gewiß wahrhaftig Giorgina Vater -- 
  -- -- -- erwidern Trabacchio -- 
  -- Gegend Neapel entführen einst bildschön Mädchen -- Tochter gebar -- 
  weißen -- anderesr -- groß Kunststücke Vater Bereitung köstlichen wundersam Liquor -- wozu Hauptingredienz Herzblut Kind -- Woche -- Monat -- alt Eltern Laborante freiwillig anvertrauen -- 
  näh Kind Laboranten Beziehung stehen -- desto wirkungsvoll entstehen Herzblut Lebenskraft -- stet Verjüngung -- Bereitung künstlich Gold -- 
  schlachtet Vater Kind froh -- Töchterlein -- Weib gebären -- verrucht Weise hoch Zweck opfern -- 
  begreifen -- Weise Weib böse Absicht ahnen -- Ablauf Woche verschwinden mehrere Erfuhr -- Neapel sterben Tochter Giorgina grämlich geizhalsig Gastwirt erziehen -- 
  Verheiratung Aufenthalt -- 
  erklären -- anderesr -- Weibe gewogen -- erfüllen verrucht Teufelskünste -- dein Kind nachstellen -- -- 
  -- anderes -- wunderbar Rettung Gott Allmacht verdanke tief Reue -- innerer Zerknirschung -- 
  Kistch Kleinodie -- Weibe -- dasjenig -- Vater Geheiß Flamme retten -- getrost aufbewahren deinen Knabe -- -- 
  -- -- kistch -- -- fallen andere -- -- Giorgina wiedergegeben schrecklich -- gräßlich Mord verübten -- -- 
  -- -- -- erwidern Trabacchio -- -- Giorgina wissen -- euer Besitz -- 
  Seht schwarz Truhe -- Euerem Hausflur stehen -- Kistch Boden finden -- -- 
  anderer suchen Truhe finden kistch Zustande -- erstenmal Trabacchio Verwahrung erhalten -- 
  anderer fühlt unheimlich Unmut -- wunsche erwehren -- Trabacchio tot mögen -- Graben finden -- 
  freilich scheinen Trabacchios Reue Buße wahrhaft -- klause verlassen -- bringen -- andächtig Buch lesen einzig Ergötzlichkeit Unterhaltung Georg -- lieben scheinen -- 
  Anderes beschließen indessen Hut eröffnet Gelegenheit Geheimnis Graf vach -- selten Spiel Schicksals verwundern -- 
  verging Monat -- Spätherbst eingetret anderer Jagd -- -- 
  bleiben gewöhnlich Großvater alt Jäger -- Geheimnis wissen -- 
  Abends anderesr Jagd zurückkehren -- alt Jäger hineintrat treuherzig Weise anfehen -- 
  -- Herr -- böse Kumpan Haus -- 
  Gottseibeiuns -- durch Fenster Rauch Dampf -- -- 
  anderesr Rede zumute -- Blitzstrahl treffen -- 
  wissen genau -- bedeuten -- alt Jäger erzählen -- mehrere hintereinander Abenddämmerung Trabacchio Zimmer seltsam Stimme gehören -- Zank durcheinander plappern -- zweitenmal -- Trabacchio Türe schnell öffnen -- geschien -- rausch Gestalt rot goldverbrämt Mantel Fenster hinaus -- 
  voll Zorn eilt Anderes herauf Trabacchio -- halten -- Jäger aussagen kündigen -- sich_es gefallen lassen müssen -- Schloßgefängnis sperren -- böse Tritt entsagen -- 
  Trabacchio bleiben ruhig -- erwidern wehmütig Ton -- -- -- Anderer -- -- Vater -- Stündlein kommen -- unerhört Weise peinigen qualten -- 
  -- zuwend -- Frömmigkeit -- Heil Seele entsagen -- standhaft bleiben -- glauben -- wiederkehren -- sehen -- -- 
  Bleibe ruhig -- Sohn Anderer -- laß fromm Christ versöhnen Gott sterben -- -- 
  scheinen feindlich Gestalt auszubleiben -- indessen -- Trabacchio Auge glühend -- lächelen zuweilen seltsam höhnisch -- -- 
  Betstunde -- Anderer Abend halten pflegen -- scheinen Krampfhaft erzittern -- zuweilen streichen seltsam pfeifend Zugluft Zimmer -- Blatt Gebetbücher raschelnd umschlagen -- Buch Andeer Hand werfen -- 
  -- Gottloser Trabacchio -- verrucht Satan -- 
  -- höllisch Spuk treiben -- 
  -- heben weg -- -- -- heben weg -- -- 
  -- rufen Anderes stark Stimme -- 
  lachen höhnisch Zimmer -- schlagen schwarz Fittiche Fenster -- 
  Regen -- Fenster schlagen -- Herbstwind -- Zimmer heulen -- Trabacchio meinen -- Unwesen arg Georg Angst weinen -- 
  -- -- -- rufen Anderes -- 
  -- euer gottlos Vater herumspuken -- Gemeinschaft entsagen hätten -- 
  müßt fort -- 
  euer Wohnung längst bereiten -- 
  müßt fort Schloßgefängnis -- möget euer Spuk treiben -- -- 
  Trabacchio weinen heftig -- bitten heilig Wille Haus duld Georg -- begreifen -- bedeuten -- stimmt Bitte -- 
  -- bleiben -- -- anderesr -- -- sehen -- Betstund -- heimkommen Jagd -- -- 
  herrlich Herbstwetter -- Anderer versprechen reich Beute -- 
  Anstand zurückkehren -- finster -- 
  fühlen innerst Gemüt bewegen -- merkwürdig Schicksal -- Giorgina Bild -- ermordet Knabe treten lebendig Auge -- tief kehren -- langsam langsam Jäger nachschlenderen -- unversehens Nebenweg Forst befinden -- 
  Begriff zurückkehren breit Waldweg -- blendend Licht gewahr -- dick Gebüsch flackeren -- 
  Ergriff wunderbar verworren Ahnung Greueltat -- verüben -- drang Dickicht -- Feuer nahe -- stehen alt Trabacchio Gestalt goldverbrämt Mantel -- Stoßdegen Seite -- niedergekrempt Hut rot Feder kopfe -- arzneikistchen unter Arm -- 
  glühend Auge blickt Gestalt Feuer -- rot blau flammend Schlang Retort hervorloderen -- 
  Feuer liegen Georg nackt ausbreiten Art Rost verruchen Sohn satanisch Doktor funkelnd Messer erheben Todesstoß -- 
  anderer schreien entsetzen -- Mörder umblicken -- sau Kugel Anderer -- Büchse Trabacchio stürzen zerschmettert Gehirn Feuer -- Augenblick erlosch -- 
  Gestalt Doktor verschwinden -- 
  Anderes springen hinzu -- stoßen Leichnam beiseite -- behen arm Georg tragen schnell fort Haus -- 
  Knabe fehlen -- Todesangst ohnmächtig -- 
  Anderes treiben heraus Wald -- Trabacchio Tod überzeug Leichnam verscharren -- weckt alt Jäger -- tiefen -- wahrscheinlich Trabacchio bewirkt Schlaf sinken -- gehen Laterne -- Hacke Spat entlegen Stelle -- 
  liegen blutig Trabacchio -- Anderes nähern -- richten halb Leib -- starren gräßlich röchelt Dumpf -- 
  -- Mörder -- Mörder Vater dein Weib -- Teufel quälen -- -- 
  -- -- Fahre Hölle -- satanisch Bösewicht -- -- schreien Anderes -- entsetzen -- übermann -- Widerstand -- -- fahr Hölle -- -- Tod hundertfältig verdienen -- Tod -- versuchen Mord Kind -- Kind Tochter verüben -- 
  Buße Frömmigkeit geheuchelt schändlich Verrat Wille -- bereiten Satan Qual Seele -- verkaufen -- -- 
  sinken Trabacchio Heulend Dumpfer Dumpfer wimmernd Geist -- 
  graben Mann tief Loch -- Trabacchio Körper werfen -- 
  -- Blut kommen -- -- sprechen andere -- -- -- auserseh Gott -- Georg retten hundertfältig Frevel rächen -- 
  Seele bet Kreuz Grab stellen -- -- 
  Tag Anderer Vorhaben ausfahren -- finden Erde aufgewühlen -- Leichnam verschwinden -- 
  wild Tier -- bewirken -- bleiben Zweifel -- 
  anderer Knabe alt Jäger Graf Vach -- berichten treulich Begebenheit -- 
  Graf Vach billigen Anderes -- Rettung Sohn Räuber Mörder niedergestrecken lassen Verlauf Sache niederschreiben Archiv Schlosses aufbewahren -- 
  schrecklich Begebenheit Anderes tief Innerst erschüttern -- -- Nacht einbrechen -- schlaflos Lager wälzen -- 
  wachen Träumen hinbrüten -- hört Zimmer knistern rausch -- rot Schein fahren hindurch Verschwand -- 
  Anfing horchen schauen -- murmeln Dumpf -- 
  -- Meister -- Schatz -- Schatz -- gebieten Kraft -- -- -- 
  -- anderesr -- wollen unbekannt Gefühl Wohlbehaglichkeit Lebenslust aufgehen -- Morgenröte Fenster brechen -- ermannt Anderer beten -- gewohnt -- kräftig inbrünstig Herr -- Seele erleuchten -- 
  -- wissen Amts Beruf -- Versucher bann sünd abzuwend Haus -- -- -- 
  sprechen andere -- Trabacchio Kistchen werfen -- öffnen -- tief Bergschlucht -- 
  Genoß anderesr ruhig heiter Alter -- feindlich zerstören vermögen -- 