1. Herr Soller Rittergut ansehnlich Haus Stadt -- erwerben Julie -- einzig Kind -- Drittteil Verehrer -- ausgezeichnet Wuch reizend Gesicht artig Mädchen verbürgen -- 
  Alter siebzehn Gelegenheit -- Heiratsanträg zweideutig Antwort auszuweichen -- gerade Weg zurückweisen -- 
  Vater -- Grund angeben -- freut -- verständig Tochter -- 
  -- kenn Juli -- -- zuversichtlich -- besonderer Freundlichkeit Doktor Heß aufmerksam -- 
  glauben -- Mädchen Hoffnung Kreis still -- bequem Haus überschreiten -- 
  -- leidlich Gesundheit Ruhe zufriedenen -- vergessen -- wünsch Jugend gestalten -- Sehnsucht Erfüllung wohlgepflegn -- sorglos Leben eher aufgereizt besänftigen -- 
  überraschen Brief Doktor -- Julien bestimmen -- Abwesenheit Einfalt Überbringer Herr Soller ausgehändigt -- 
  Aufschrift zeugt männlich Feder warten Ungeduld Rückkehr Tochter -- 
  erschrecken -- Brief übergeben -- -- sogleich reißen -- eröffnet -- unwandelbar Liebe ansehen -- Gustav Heß darinn wiederholt Male berufen -- 
  scharf Examen folgen scharf Verbot -- 
  müssen Julie Atem versprechen -- Augenblick Ruhe erhalten -- 
  unterbrochen Postlauf -- Ursache Mädchen verweint Auge geliebter Fenster Nachricht geben -- veranlaßn ungestüm Herz Doktor Gespräch Herr Soller -- 
  Gustav halten Julien Hand förmlich -- Vater förmlich abschlagen -- 
  rätselhafter -- Heß unabhängig -- Vermögen -- gut Ruf -- angenehm Betrag -- besitzen -- Bitte Wort reden -- 
  Ehrenzeiche -- akademisch Duell Wange beigebrachen -- ziehen bedächtigst Leute Vorwurf -- allgemein -- Streit veranlassen -- 
  vergebens hoffen Julie -- -- Meinung ziemlich biegsam Vater -- Liebkosung ewig widerstehen -- 
  vergebens Doktor Seite anwenden -- sehnlich gewünscht Verbindung gewinnen -- 
  Menge fruchtlos Versuch scheinen Mädchen Ursache Halsstarrigkeit denkbar -- irren -- Hoffnung vorhanden -- einzig Wunsch Vater Lebzeiten erreichen -- 
  Herr Soller nämlich -- Kränklichkeit -- vermocht -- Geschäft ausgebreitet Handlung begeben -- Leidwesen Besitz Geisterseherei -- 
  -- trotz Doktor Jung -- System Geisterwelt bilden -- Person -- Leben -- sehen lassen -- -- allezeit höchst zweideutig Charakter müssen -- 
  Julie besorgen -- Geist geliebter Vater erscheinen -- lassen Schlauheit Ruhe -- wissen -- Sache verhieln -- 
  Grade Nacht Auffang Brief -- Doktor Heß gewöhnlich Anzug Herr Soller Bette vorübergegangen -- 
  Verzweifelt -- wogeg Schamhaftigkeit auflehnen -- fallen Julien -- Liebe rasten -- anwenden -- 
  nämlich Vater falsch Geständnis -- Zorn -- Herz verleiten -- Doktor Nacht Tore öffnen -- folglich Herr Soller -- Gespenst sehen -- 
  erzählen -- Schlüssel Haus Vorsaal bemächtigen -- Detail vieler Wahrscheinlichkeit -- Zweifel übrig bleiben -- 
  Folge zeigen -- Julie wählen verstehen -- 
  hart Geständnis angelassen -- mildert väterlich Widerwille Doktor zusehends -- 
  Julie wissen geliebter benachrichtigen -- 
  wiederholen Bitte Hand -- Herr Soller -- bedenklich scheinen -- Tochter lang hüen -- Liebhaber Notfalle Nacht Zimmer öffnen -- lassen Gehör finden -- 
  erscheinen Vater Gespenst festgesetzen Hochzeit -- 
  diesmal Geisterseh genau Tür -- Julie früh Selbstanklage Glück wiederholen -- 
  Herr Soller bestehen rückgang Heirat -- 
  förmlich Prophezeiung -- Tochter künftig Unglück -- bleiben Eindruck -- 
  Geliebte wissen Prophezeiung liebend Seele reden -- 
  öffentlich Verlobung geschehen -- Paar halten Vater gegeben Wort -- 
  wissen -- Ursache Zurücknehmen Hirngespinst erklären gültiger auffinden lassen -- willigen -- weigern standhaft -- Zeuge Hochzeit abgeben -- 
  indessen vorbei -- lassen Wiederherstellung natürlichen Verhältnis Vater Kind bereit finden -- erwidern Paares besuch -- jung Frau -- -- Besorgniß Gatten -- bestätiget sehen -- -- -- 
  Doktor Heß entsagt medizinisch Praxis -- widmen -- beschränkt Freund -- besonder Wohlwollen dienen -- 
  gemächlich Neuvermählt Laun Liebe überlassen -- tun selten Ausschweifung -- 
  heiß Begier hing Traum -- jetzig Existenz verändern -- verewigen -- Soller Geisterseherei Gelegenheit ebenfalls Sprache -- 
  wünsch Liebende verwendet Möglichkeit Wiedererscheinung Tod -- 
  Paar abgeneigen -- Geister -- Herr Soller zuweilen besuchen -- Wesen zugestehen -- Resultat -- ziehen selbsterschaffen System verwerflich finden -- 
  Gustav wissen Geschichte zwei liebend -- Versprechen geben -- Tod weichen -- verstorben Gatt -- Wort eingedenk -- zurückkehren -- klein -- Überzeugung überaus günstig Umstand -- 
  Äußerung -- ebenfalls vergönnen -- Julie tun Gustav Wärme wiederholen -- 
  lassen seltsamst Meinung -- jemals Geisterwelt drucken -- zusammentragen -- merkwürdig Handschrift vollendet Erbauung betrieben Lektüre Art -- 
  Unvermerkt Paar Vermutung Möglich Glaube Gewißheit Sache führen -- Hülfe verschieden -- ungefähr entstanden Hypothese -- gelangen -- Herr Soller -- Theorie -- 
  Paar aufrichtig liebend Tod keineswegs trennen -- vielmehr gestorben Hälfte schönen -- künftig Wiedervereine -- zurückgeblieben Schutzengel umschweben -- 
  Glück Schwärmerei Leben allmählich abgenutzen -- 
  menschlich Schwäche -- Hälfte entdecken -- zerstören Idee Vollkommenheit -- -- -- Julien erst Wochenbett -- Projekt Rückkehr Schattenreiche -- gänzlich Vergessenheit geraten -- 
  unwandelbar Liebe Monat wandelbar -- 
  obschon Knabe -- worauf Lebenszweck Mutter nunmehr hinzugehen scheinen -- Grab tragen -- scheinen Gustav nah rücken -- 
  glücklich vereinen gewesen Hälft fangen -- Selbstständigkeit behaupten -- förmlich Untreue anklagen -- entschieden Zweifler Gesinnung Gegenteil Rücksicht -- 
  Verlauf Dreier scheinen innerer Band gänzlich auflösen -- 
  äußere halten beisammen -- 
  väterlich Prophezeiung Lüge strafen -- Freund -- beispiellos Liebe Hochzeitstage vergessen -- Stoff lachen geben -- unfriede -- manchmal Haus ausbrechen -- Türschwelle lassen -- merklich Veränderung gegenseitig Betrag Kenner nirgends verbergen -- 
  Doktor Heß -- -- erwähnen -- Liebe ruhig -- genußreich Leben medizinisch Kenntnis erwerbszweige nutzen -- Sommer berühmt Bade Julien zubringen -- 
  Sommer Bade bestimmen -- 
  Julie schlagen Begleitung vorwand verunglückt Niederkunft zurückgeblieben Kränklichkeit -- 
  gleichgültig -- Gatte -- lächeln beweisen -- Nichtigkeit Vorwand durchschaute -- 
  Abreise fallen Unpäßlichkeit -- worüber Monat klagen -- bloß Vermäntelung Mißmut halten -- 
  -- 
  fremd Mensch erkranken -- 
  fehlen -- Gedanke Bestellung Postpferde angetrieben -- 
  fröhlich Gesellschaft verjagen indessen Wolke jugendlich Stirn -- schalt Törin -- Mann Sorge denken können -- Anstalt -- Langeweile -- womit Umgang peinigen -- arme Freude erholen -- 
  jetzig Einsamkeit Behag -- 
  Menge Rücksichte -- Gatte beobachten -- wegfallen -- 
  stehen einzig Gesetz Anstand -- dachen Angst nahe Änderung Lage -- Brief Doktor Rückkehr Woche hinausschieben -- 
  willkommen Sache -- verdroß -- Gustav Grund lang Abwesenheit angeben bemühen -- 
  Fluß Woche erhalten schreiben Mann Bruder -- ansehnlich Staatsamt entfernt Land verwalten -- -- Mal hören -- geliebt -- einzig Bruder lang Entbehrung sehen -- weit Reise Bad unternehmen -- 
  äußerst gefährlich Krankheit Gatten -- schreiben verkündigen -- wirken erschütternd -- Julie schleunig Abreise bereit -- Schreiben ersehen -- Vorbereitung Todespost abgeben -- 
  plötzlich Schlag Ursache früh Lebensend -- 
  Bade -- hauptsächlich gesellschaftlich Talent -- Freund besitzen -- Beerdigung äußerst rührend feierlich -- 
  Bruder -- schreiben -- eröffnet Witwe -- Begriff gestehen -- persönlich melden -- Dienstverhältnisse unvermutet abgerufen -- 
  erinnre verstorben zuvor zufällig Gespräch gehören -- Zugebracht hinterlassen gänzlich Vermögen weit erreichen -- Anstalt treffen -- sicher Dokument bare Gelde übergeben sollen -- 
  Julie fühlt Hauptereignis tief verletzen -- ökonomisch Sorgfalt Höchstunglückseligen Augenblickes unwürdig erscheinen -- 
  unwillkürlich fassen Briefsteller stark Widerwille -- dergleich Trauer berücksichtigen wert finden -- 
  Vorwurf -- unmittelbar verstorben Abreise -- fallen zermalmend Gewalt -- 
  schön Moment Liebe treten verborgener hervor -- längstvergessen feierlich Szene -- wechselseitig erschein Tod zusagen -- 
  fieberhaft Grauen Abend Vater düstre Einsamkeit -- 
  ausgekleiden Mädchen Fortgehen begreifen -- rufen -- 
  Entschluß -- Wächterin behalten -- sogleich verwerfen -- Dienerin fortgeschicken -- erfahren -- umkehren -- 
  Julie Geist gatter Zeuge Fessel anlegen -- Zittern Bette erreichen -- 
  wünschen Schutz -- Schlaf -- 
  fest Auge verschließen Bettvorhang -- gewöhnlich bleiben -- zugezogen -- stellen Schlummer -- 
  vielmehr rauschen herum -- seltsam -- Einsamkeit Zimmer gestatten scheinen -- 
  -- voll entsetzen -- Gesicht Wand herüberwandte -- fassen -- Vorhäng öffnet aufblickt -- Lampe abenteuerlich ungleich Schimmer -- bildet Seite Zimmer dunkel -- rätselhaften Schatten -- Bebende niemals vorkommen -- 
  Stelle verdächtigsten -- 
  lang hinsehen -- desto beweglich Schatten -- 
  prasselt Flamm -- außen wirken müssen -- 
  Julie fast Angriff -- Gang Stutzuhr -- Bette -- Einförmigkeit ungewöhnlich Ereignis mindest stören -- 
  Angstvolle Mut fassen -- still stehen lassen -- 
  richtet Höhe -- Ton Aushebens Mitternachtstunde Geisterruf zurückwarf -- 
  -- hell erfolgend Glockenschlag festzugehalten Auge aufrissen -- -- wahrnehmen -- gefürchtet Schatten krank Gestalt Gemahl deutlich hervorheben -- Lautlose Schritt Bette richten -- 
  -- Moment letzter Bewußtsein folgend liegen überaus heftig Fieber -- 
  mehrere Monat völlig herstellen -- zeigen Vater äußerst begierig -- Geist erfahren -- erschein Hitze Krankheit bisweilen denken -- 
  Julie wissen Äußerung -- Nacht -- Einleitung Krankheit -- vermeiden absichtlich erwähnen -- 
  Gedanke Wiederherstellung Besuch Grabe Gemahl -- Sinn fromm Wallfahrt -- 
  finden unpäßlich Freundin -- Arzt Bad schicken -- Gesellschaft Trauernde -- 
  Julie freuen -- Verstorbener Ort letzter Andenke stehen -- 
  betrachtet Rührung Dankbarkeit Stein -- Freund Hügel setzen lassen -- 
  Gatte -- erfahren -- gewissermaßen Beruf sterben -- 
  hülflosen kranke -- Mitleid Wohnung nehmen -- Krankheit empfangen -- Grab stürzen -- 
  verschweigen Umstand -- Tod Fall Bette unstreitig beschleunigen -- Leute gehören -- -- Mensch Gespräch verstorbener bringen -- verbergen bleiben -- 
  Bad -- Begräbnisplatze erträglich Ort Traurede aufweisen -- zufrieden -- Gesellschafterin -- Umstand hiesig Wasser zusagen -- abzureisen finden -- 
  Zurückkunft bringen Julien Zerstreuung -- Zustande anpassend entgegen -- 
  kränkelnd Vater bettlägerig -- Arzt verhehln -- Übel Tod gänzlich heben -- 
  angelegener lassen Pflege -- 
  Gewißheit nahen Einbuße geliebt Person -- Liebe zuvor geahndet Kraft -- 
  Julie wich Zimmer Vater -- 
  sehen -- müssen kranke besuchen -- erhalten Mann Grund mehrere Besuch jung Mann -- ausgehen -- unstet Leben Ehelosigkeit zweckmäßigerer verwandeln -- 
  leise rege Aufmerksamkeit reizend Witwe Zustand unverlautet Wunsch kranke müssen unfehlbar Interesse Zeuge ansehnlich erhöhen -- 
  Wesen -- Anspruch Genüs Jugend gänzlich zurückzieht -- Monat -- zuweilen fühlbar Laun hoffnungslos kranke aussetzen -- Wesen Gatt Stande -- 
  nah Absicht legen -- annehmlich Partien nennen -- Wahl ankommen -- wählen -- beinahe zehnmonatlich leiden Vater entschlummeren beerdiget -- 
  Folge schließen gesellig Familie -- keineswegs Gelegenheit Austret Witwenstand finden -- 
  Erinnerung Woche Ehe stehen hellsten -- kräftigst Farbe -- 
  gegenseitig Liebe Paares -- trauen -- ähnlich -- künftig Hoffnung fassen -- Schattenbild Glückes scheut Leben rufen -- Verlust Unabhängigkeit hoch Preis dünken -- 
  gestehen mehrere Bewerber Rückhalt -- Entschluß Witwenstande bleiben Epigramm Interessent Veranlassung -- 
  Aufopferung Ruhe Schlaf -- väterlich Krankheit -- niedergebeugt gewesen Reiz vollkommen aufgeblühen -- Geist allmählich früh Anmut Heiterkeit zurückgelangen -- 
  Vorwurf beunruhigen indessen zuweilen -- Gatte Bad reisen lassen -- Geist Mal erscheinen -- 
  zweifeln sogar -- Geist -- halten vielmehr bloß Folge Gewissen Keim Krankheit beunruhigt Phantasie -- 
  mißbilligen Fall Furcht außerordentlich -- 
  setzen -- Geist -- -- glaublich -- -- früh Versprechen eingedenk -- zurückkehren -- fürchterlich Erscheinung -- 
  Leben -- geräuschvoll Freude geflissen zurückziehen -- verlieren Heirat Mädchen -- sorgsam -- treue Dienerin -- viele zeitig Gemächlichkeit Haus -- 
  Dienerin Julie aufwachsen -- sogar Bildung nossen -- 
  verbinden Mensch -- weder Stand -- Erziehung Verhältnis Emporragende -- Anspruch -- 
  Julie lassen gewähren -- veranstalten sogar Hochzeit -- 
  Umgang -- erniedrigen -- fortsetzen -- Julie ungebildet Kreis herabzuziehen drohen -- 
  einsam fühlen -- desto sorglich pflegt Einbildungskraft Bild Liebestage -- 
  -- einigemal verstorbener Geistergestalt zurückgewünscht -- sehen -- glühend Briefe Freude schöpfen -- Bild -- Andenken Herz drücken -- Leben selbstständig -- bloß Beziehung geführter nennen -- 
  Gedanke schlafen gehen -- Wagen Maskenballe rasselten -- dringend Einladung ablehnen -- 
  mehrere Stunde schlummern -- Auge öffnen -- 
  Moment erblickt Gestalt Hintergrunde Nebenzimmer -- äußerer Langsamkeit nähern -- 
  sehnlich gewünscht Schatten -- unverkennbar -- 
  Vorwurf -- Gatte unbefugt Wunsch Wiedersehen Ruhe stören -- Julien mächtig befiel -- berauben Freude Erscheinung -- 
  Vorsatz Anrede denken -- 
  vielmehr benehmen Furcht Atem verschließen Auge -- Schatten Nebenzimmer -- 
  heben ebenfalls Furcht Augenlid verschieden Male unmerklich -- sehen -- Erscheinung dicht Bette stehen bleiben -- 
  bangst Erwartung Julie liegen -- Gestalt schlich -- 
  halb Stunde fassen Erschrockene Mut -- reg Klingel ziehen -- 
  ziehen dreimal -- zuletzt äußerst starr -- Mädchen laut -- 
  schlagen -- -- Dienerin suchen -- 
  finden leer Bett -- 
  Köchin Bedient schlafen ober Stockwerk -- wohin Klingel leiten -- 
  stubenmädchen unordentlich Leben führen -- Juli -- 
  unfehlbar dirn Hoffnung vermissen -- Haus stehlen -- 
  finden Witwe äußerer Tür verschließen -- 
  Mädchen schlafbedürftig Auge folgend voraus -- späterhin Julien Frage bekennen -- Maskenballe -- Mäßigung beigewohnen -- 
  Julie mehrere Mal nächtlich verschwinden ernstlich verbieten -- schlecht Dienerin sogleich abgelohnen Haus schicken -- 
  gelingen Juli bekommen -- einschlagen -- -- Verheiratung vergebens versuchen -- 
  nächt Witwe Furcht -- böse Fieber befallen -- 
  Ton jeder Lüftchen -- Knistern Strohhalm -- Körper -- 
  Auge weigern -- Gestalt verstorbener anerkennen -- Ohr hört Bewegung -- 
  bitten Vater Man Zweifel -- vormals Erscheinung -- 
  verhehlt Sache -- ereifern -- Gestalt -- Bette treten -- Zweifel ziehen -- 
  -- Julie empfindlich -- Kraft Auge Ohr Mensch abstreien lassen -- 
  erwähnt früh Erscheinung Gatten Tod -- Wort -- zuweilen Folge fieberhaft Zustand bezweifeln -- 
  fragen -- Spur Verstandesschwäche gewahr -- 
  natürlich Erklärung -- häufig gewagt -- Verdruß -- 
  meinen -- Liebhaber damalig hübschen -- Punkt Liebe gastfreeinen Mädchen -- Zimmer verfehlen können -- 
  -- wahrscheinlich -- sogenannter Geist gewöhnlich Modekleider erscheinen -- Geisterkostüm sonderlich anpassen mögen -- 
  erst entgegnet Julie -- Liebhaber Dirne -- vertraut sein -- Nachschlüssel Haus Wohnung erhalten -- unfehlbar Seite gelegen Gemach finden -- 
  äußerer Tür verschließen -- abstreien lassen -- 
  Einwendung Kostüms suchen Frage niederschlagen -- 
  -- körperlos Wesen -- Körperwelt erkennen geben wollen -- kenntlich Gestalt annehmen nötigen -- 
  -- fügen Leidenschaft hinzu -- Glaube verdien -- versichr -- gut Gewissen Eid ablegen -- Erscheinung Gestalt verstorbener Unterschied -- geistig Wesen -- finden -- scharf Auge Schramm backen deutlich wahrnehmen -- 
  Julie sprechen verständig überzeugend Begebenheit -- Menge Anhänger finden -- Geisterseherei häufig Gegenstand Gespräch -- Wunder -- Sache -- jetziger ergreifend -- Druckerpres entgehen -- 
  obschon Schriftchen -- unbekannte Publikum fördern -- Unrichtigkeite wimmelen -- finden Heldin -- Name verschwieg -- Geschichte übrig Beleidigung vortragen -- öffentlich Berichtigung auffordern -- 
  spöttern -- vernehmen lassen -- fest Glaube wankend -- 
  zufrieden -- -- jetzig Mädchen Zimmer schliefr -- häuslich Beunruhigung hören -- 
  kurz Sommernächt sogar Mut Grade -- mind Besorgnis Nacht zubrachten -- 
  alled Glaube Wirklichkeit Erscheinung weder erschüttern -- schwächen -- 
  Sommer treffen unvermutet Haus -- Umgang gehören -- verstorben Gatte geschätzt Freund -- letzter Tod vorkommen -- 
  freut Mann sehen -- inner äußer Liebenswürdigkeit -- einzig Fehler -- unstät Leben gefallen -- Heirat wissen -- 
  Julien Eintritt Raube Gesellschaft -- lebendig Geist Mann gewandt Erzählung bewundern -- 
  Herr Rose geraten Witwe Freund besonderer Gespräch -- selten Unterhaltung unterbrechen -- Abschied munt erhalten -- folgend Wohnung Witwe fortsetzen -- 
  Gegenstand Julien Geisterseherei -- 
  Herr Rose hartnäckig Zweifler Feld Erfahrung zeigen -- Lebzeiten Mann mehrere Geistergeschicht groß Geschick erklären -- 
  widersprechen Erscheinung verstorben Freund -- Beweis Gegenbeweis Seite Wärme führen -- Entscheidung -- 
  Herr Rose vergebens behaupten -- Julie Sinn -- Mensch hierin täuschen -- rufen Mal -- 
  -- -- erklären lassen -- -- 
  -- -- -- sprechen Gegnerin -- -- -- -- 
  -- wissen -- 
  besonderer Umstand Tod Gatte erzählen -- -- 
  sterben Bade -- Abwesenheit -- plötzlich -- -- 
  -- schütteln zweifelhaft Kopf -- 
  überreden -- sterben -- -- 
  -- -- Erklärung versuchen -- verwerfen -- zusagen -- -- 
  -- -- -- sprechen Julie empfindlich -- -- bitten -- dergleich Experiment Asche teuerst Person Welt -- -- 
  nunmehr bestehen Herr Rosen Ernst -- -- vertrautest Freund Verewigt -- Detail Tod -- erheben -- Julie erklären -- einig Unwille -- werfen suchend Blick Hute -- 
  -- -- -- Julie hierauf -- -- -- -- einräume -- -- Mißbrauch warnen -- -- 
  Träne Witwe Geschichte Umstand -- sprechen -- Beendigung ernst Gesicht erklären vermögen -- 
  -- sagen -- -- 
  -- mindeste -- hören -- -- 
  -- Achselzuck beleidigen -- Herr Rose -- 
  glauben -- unverwerflich Zeugnis Tode Versuch Erklärung gewagt können -- -- 
  -- verbieten -- Glaube stören -- -- 
  -- Herr Rose -- -- Feierlich -- Miene Fortgehen -- -- -- anhören -- -- 
  -- erlauben früh Umstand erwähnen -- -- 
  -- Erwähn -- Zweck gemäß erachten -- -- 
  -- bereit -- 
  -- Mund -- Verhältnis Manne Tod -- früh Harmonie entwohnen -- besorg -- beiderseits ehelich Trennung zuweilen ingeheim abneigen -- 
  wünsch Gatt weit Reise richten -- 
  Wünsche nachh Liebe Glück Besitz verdrängen -- 
  abermals verändert Umstand -- annehmen -- alt Reiselust erwecken -- Weg Ziel -- reisen -- -- 
  zuviel zumuten -- allerlei Reise Weltteil verknüpft Beschwerde teilen -- -- aufrichtig sprechen -- Umgang -- 
  Reise -- Langenweil -- ewig Besorgnis -- Rückkehr Vergnügen stören -- Preis geben heißen -- 
  einschlagen -- -- 
  -- -- Radikalheilung versprechen -- wovon -- Scheidung heißen -- 
  häßlich Wort empört Gatte -- 
  gered Leute aussetzen -- zuvor ungewöhnlich Zärtlichkeit Paar -- ärgern -- 
  Vorwurf Vater -- Verbindung Anfang abneigen -- überdies unfehlbar Leben verbittern -- 
  verwerfen -- 
  letzter -- auseinander setzen -- freilich sonderbar abenteuerlich -- versprechen Freund Freiheit -- kurz Witwenstand -- Wunsch gemäßen Gatten -- -- 
  -- Herr Rose -- -- brechen Witwe -- -- Anwalt schlecht Prozeß -- 
  Gegner ermüden -- ziehen Sache zwecklosen Ding Länge -- 
  Wort verlieren -- unterließen -- Punkt Leben -- meister bereu -- Sait Gefühl -- schmerzlich Ton angeben -- Schonung berühren -- -- 
  -- teuer Freundin -- -- fallen Erklärer -- -- Vorwurf bangen Erinnerung -- 
  müssen gedenken -- notwendig Grund Gebäude -- Hälfte beenden -- -- 
  -- wozu Kartenhaus -- Totenschein -- sogleich vorzeig -- hauche niederwirfen -- -- 
  -- Totenschein -- 
  Grund ausstellen -- 
  schwierig Stelle hinaus -- erlauben Hypothese verfolgen -- 
  Gemahl reiset Bad -- Bruder vorfinden -- 
  entdecken häuslich Unbehaglichkeit -- 
  -- Vermögen entbehren -- Freiheit erlangen -- 
  -- Umstand -- mehrere Dürftigkeit besorgt kranke -- Gatte Mitleid ärztlich Beistand zuwenden -- unvermeidlich Tod Seite stehen -- Kauf Freiheit Preis Hand -- 
  schlecht Wohnung Patient Vorwand -- Zimmer Haus einräumen -- Mann Bruder bewohnen -- 
  voraus sehen -- sterben kranke trotz Pflege -- Gatt -- indessen Nacht -- Bruder überlassen -- 
  Finde Wagesatz natürlich -- -- 
  -- keineswegs -- bitte nah Auseinandersetzung selber übernehmen -- -- 
  -- ermüde -- -- 
  -- Gatt -- Plan Woche zuvor scheinbar kränkeln -- Hauskleidung zurückgelassen -- verstorbener anlegen -- Besserung mehrere erwähnen -- -- heißen -- Heimat zurückkehren -- -- 
  verstorbener Mann ausgeben begraben -- 
  -- -- dächen -- Rätsel ziemlich auflösen -- -- 
  -- Kleinigkeit -- hinwegschlüpfen -- Berücksichtigung verlangen -- 
  -- wichtig Geheimnis niemals verteilen -- Wesen verlieren -- zugeben -- 
  müssen Interesse ziehen -- -- 
  -- Mensch alt Diener Mann Bruder -- selten Treue -- erinneren -- mehrere Mal Zimmer rühmen -- 
  Mann Bruder Bade einzig Mensch Bedienung -- Geheimnis befürchten -- -- 
  -- Einwendung -- unwahrscheinlich falsch Erklärung befreien -- 
  vergessen -- Herr Rose -- 
  Mann -- Freund Bade -- Verewigter -- unfehlbar Tod Besuch erhalten -- 
  Freundschaft wünschen geliebt Rest sehen -- Freund selber hinübergegangen -- fremd -- zufällig aufgerafft Leiche gewiß bekannt Zug vermissen -- -- 
  -- -- wert Freundin -- überzeugen -- Mann Bruder Besuch erhalten vorfalls vielfältig Rede stehen -- 
  letzterer scheinen sogar schwierig Unternehmen -- 
  indessen geschickt Weltmann gelingen -- 
  Zuverlässig Leichnam sehen -- -- Gesicht -- vorgeblichen Fall Bette entstellen -- Tuch verhüllen -- -- 
  -- Leichenfrau -- Herr Rose -- 
  berühmt Bade Person Art -- Pflicht verstorbener natürlich Tod überzeugen -- -- 
  -- Unstreitig Person Pflicht -- 
  allgemein rechtlich anerkannt Mann Unternehmung Bruder Leben fähig halten -- 
  Leichenwäscherin -- bitten -- Wunde Gesicht verstorbener aufreißen mögen -- Umstand Goldstück Pflicht losgesprochen fühlen -- 
  brauchen annehmen -- verstorben arm Bette fallen -- Gesicht unkenntlich -- Tod Gewaltsamer bedienen -- Kenntliche benehmen -- -- 
  -- Rose -- lang -- künstlich Erklärung -- -- vielmehr Verdrehung Ereignisses bewirken -- -- 
  -- Gedanke Möglichkeit -- Gatt leben -- -- 
  -- Gewißheit Trost verschaffen -- seltsam Deutung geben -- 
  verfolgen Sache -- ziehen Zeitig Schluß -- Erscheinung -- verstorben Geglaubter -- Zimmer sehen -- -- 
  -- aufgeregen kränklich Einbildungskraft -- Betrug außen annehmen -- unfehlbar -- -- 
  -- wozu -- Rose -- verleiten diesmal Hang scharfsinnig erscheinen -- 
  Mann -- -- -- Erklärung -- Drittteil Vermögen loskaufen -- Mann Wohnung geschlichen -- -- Gefahr Anspruch exponieren -- 
  gestehen -- gering Scharfsinn ausreichen -- Zusammenhäng zwiefach Seltsamkeit auszumitteln -- -- 
  -- wahrlich überaus nahe liegen -- 
  sehen gewiß Unwahrscheinlich -- Gatte unbezwinglich Vorliebe Weltteil leben -- huldigen -- Vergnügen -- befriedigen sehen -- Gedanke Seele Platz lassen -- 
  schieben sogar Reue Erreichung wunsche hinaus -- 
  -- müssen Reue -- zumal tief Gefühl -- 
  sehen -- schwer vergang -- berechnen lassen -- Folge angeblich Tod -- Zwiespalt zuvor herrschen -- äußern -- 
  Betrachtung erneuern Bild Herz -- voll Glorie früheren -- 
  Sehnsucht treiben -- 
  hierher -- wünschen sehnlich -- Wohlsein überzeugen -- 
  finden Wohnung gelang Gespenst halten -- -- 
  -- Gott -- -- rufen Witwe -- -- reden -- 
  -- -- Deutung unwahrscheinlich -- Auslegung Tod -- 
  -- Rückkehr annehmen -- müssen abenteuerlich Nachtbesuch Zuflucht nehmen -- -- 
  -- -- 
  minde Gesinnung wissen -- -- Totgeglaubter -- Stadt -- jeder Kind kennen -- sehen lassen -- -- 
  -- verschlossen Tür herein hinausgehen -- erklären -- -- 
  -- -- -- sittlich -- hübsch Mädchen Nacht Maskenballe befinden -- 
  Abend ankommen -- Maskenball gehen -- sehen -- Verlarvung Nachricht einzuziehen -- -- 
  Zufall hübsch Mädchen zusammenführen -- ziemlich ausgedehnt Begriff Maskenfreiheit nah Bekanntschaft Reiz übrig Umstand Nachtschwärmerin verschaffen -- 
  dürfen Gesellschafterin Gläser Wein eingeschenken -- bewirken Zustande Schlüssel heimlich weggenommen -- bedienen -- 
  -- Winkel Haus auswendig wissen -- allzuschwer -- Finster Bette finden -- -- 
  Julie hierauf empfindlich -- 
  -- aushöhlen -- Herr Rose -- -- gering Scherz endigen -- 
  Verstorbener -- überzeugen -- besitzen jederzeit Stolz -- unwürdig Abenteuer -- Dienstmädchen -- aufsuchen verfolgen -- 
  kränken -- Tod dergestalt Preis geben sehen -- -- 
  -- -- gut Freundin -- -- versetzt Rose -- -- nehmen Sache falsch Seite -- 
  setzen Fall zeigen -- Schlüssel finden -- Gewicht legen -- 
  Eile ungeschickten -- Charakter Gatten angemessen Fall ergreifen -- sehen ebenfalls -- 
  wahrscheinlich Doktor vertrauen Freund Begleiter zugesellen -- Abenteuer Maskenbälle zuwider -- 
  Gatt überall -- Nachricht suchen -- vertraute -- Mädchen -- zufällig Dienerin entdecken -- Doktor Wink geben -- Schlüssel verschaffen -- gemacht Gebrauche -- Trunkenheit halb Bewußtlosen zustecken -- Vorgange mindesen ahnden -- -- 
  -- Breche -- Herr Rose -- 
  Umsonst Erwähnung letzter Mann Tod schuld schreiend Farbe wund Auge rücken -- 
  Umsonst Menge Möglichkeit setzen -- Kunst Erklärung Geistererscheinungen zeigen -- 
  Zweck annehmen -- Bemühung völlig zwecklos schelten -- 
  -- ähnlich Gestalt -- wovon Rede -- Manne -- Mensch überzeugen -- sehen -- 
  Gang ätherisch -- erschüttern -- bestimmen -- hoch Welt angehören -- -- 
  -- Bangigkeit -- gut Freundin -- unstreitig ätherisch Gestalt hineingetragen -- -- 
  Julie widersprechen -- bleiben -- Erscheinung Bestimmtheit menschlich Umriss -- 
  -- -- -- fahren Geisterleugner fort -- -- Zweifel Betrug spielen -- -- 
  -- Still -- -- erwidern Julie -- 
  -- Betrug höchstens Farbe -- niemals Wesen Wahrheit aneignen -- -- 
  -- kenn Kunststücke -- -- sprechen Herr Rose -- 
  -- wissen Geisterblendwerke umgehen -- -- 
  Julie lehnen Probe -- Erbot -- Lebhaftigkeit -- 
  scheinen Gewalt Glaube überirdisch Erscheinung bekehren -- hierin zudringlich -- 
  -- Witwe -- Bedingung -- nachh Versuch Geisterglaube wagen -- gewähren lassen wollen -- 
  verbergen Verdruß -- eins Zimmer -- abgesondert Ausgang -- nötig Vorbereitung abtreten müssen -- Schlösser Zimmer legen -- 
  geheim Vorwurf -- Sache verursachen -- besänftigt Gedanke -- Veranlassung Vorwitz -- sehnlich Wunsch -- Vorwitz entfernen -- 
  dessenungeachtet schwarz Kleidung außerordentlich Feierlichkeit -- womit Geisterbeschwörer festgesetzt Abend Zimmer treten -- sichtbar überraschen -- auffiel -- 
  -- sehen -- sogar -- wissen -- bloß Täuschung -- ungewöhnlich Stimmung erwehren -- 
  erhieln Geist -- erscheinen -- ätherisch Hülle -- Auge bewußt Erscheinung liehn -- vorbeugen -- Eindruck zerstören -- Gravität ablegen -- nochmals versichern -- lauter natürlich Zauberei -- 
  Voraus zeigen -- Kostüm Gestalt nähern -- -- 
  Julie erstaunen -- Mignaturgemälde vorhieln -- beweint Gatte -- Mantel darstelln -- zuletzt Bette treten -- wovon -- 
  -- sprechen -- teuer Freundin -- -- fing Herr Rose -- -- versprochen Täuschung -- Wahrheit -- Gatte Zimmer kommen -- Fall -- neulich Meinung zwecklos unnütz setzen -- letzter Maskenballe ausnehmen -- Verdruß meister erregt -- treu Erzählung wirklich Vorgang enthalten -- -- 
  Julien erstaunen Rosen zuversichtlichen Ton Entzück auflösen -- langsam Türe öffnen -- überzeugendst Beweis Sache führen -- 
  Liebende sinken schweigend Arm -- 
  Rose vertraute Doktor Maskenballe -- Mann -- Gesinnung vermeint Witwe prüfen -- 
  Heß Sache wagen -- Druckschrift -- Geistergeschicht Anlaß geben -- Falschheit Angabe -- Gattin kenntlich -- Anhänglichkeit vermeint tote schildern -- Hand geraten -- 
  erklärbar Ursache Vorgang Stadt -- Zutrug -- verlauten lassen -- 
  -- Julie verkauft Besitzung entfernen -- wissen eigentlich wohin -- 
  Welschland fröhlich Himmel -- Doktor krank Bruder Genesung hoffen -- Paares Aufenthalt -- 
  leben Name -- Heß vorgeblichen Tod führen -- glücklich Paar sehen -- Geschichte wissen -- hoch Erwartung tödlich erkrankt Ehe dergleichen Salto mortal Heilmittel wünschen -- * * * Stoff vorhergehend Geschichte -- Tatsache -- Freund mitteilen -- Titel -- 
  Reise Pyrmont -- herausgegeben Erzählung lesen -- scheinen -- ungeachtet zufällig Ähnlichkeit Umstand erschienen Erzählung -- Bearbeiten unweren -- 
  Entschuldigung -- hierin geirren -- 
  F. L. * * * 